uuid,name,createDate,lastOpDate,status,startTime,endTime,gpu_name,gpu_num,worker_num,cpu_num,mem(GB),schedule_time,exec_duration
d95f1f4f-a068-4df8-84a8-ea06f2b32cf6,geogpt-table-qwen2-72b-datav05-lora-1e-4,1718643343,1718710037,finished,1718645047,1718710037,A100-SXM4-80GB,8,4,64,896,1704,64990
9dacfae5-8e37-443e-9a67-f74aef94c2fd,geogpt-qwen2-chat-0612dpo-dare-ties-p51,1718645010,1718681783,finished,1718645029,1718681783,A100-SXM4-80GB,8,1,64,448,19,36754
1a26a41b-86d2-4292-849f-a10636ecf748,geogpt-qwen2-chat-0612dpo-dare-ties-p53,1718645031,1718690727,finished,1718645051,1718690727,A100-SXM4-80GB,8,1,64,448,20,45676
59415a19-4b09-4775-b32a-eaca2f568f04,geogpt-qwen2-chat-0612dpo-dare-ties-p55,1718645033,1718690728,finished,1718645051,1718690728,A100-SXM4-80GB,8,1,64,448,18,45677
3c0f3f69-8b79-47a5-8994-4d4a01612ffe,geogpt-qwen2-chat-0612dpo-dare-ties-p57,1718645053,1718690762,finished,1718645073,1718690762,A100-SXM4-80GB,8,1,64,448,20,45689
fe1dc616-f997-4032-9e79-2d4f495ced7f,geogpt-qwen2-chat-0612dpo-dare-ties-p59,1718645055,1718690780,finished,1718645073,1718690780,A100-SXM4-80GB,8,1,64,448,18,45707
fea17d0c-734d-409e-89d1-aea40b9c6081,stf-test-asrto-guoguo,1718672974,1718673042,finished,1718672991,1718673042,A100-SXM4-80GB,8,1,64,448,17,51
9f202779-9c69-4e8a-80c4-fb7fc0623087,opencompass-test-fumingxiang,1718673093,1718676952,finished,1718673113,1718676952,A100-SXM4-80GB,8,1,64,448,20,3839
9011364d-e5de-4b42-adaa-374bbd000554,llama-factory-test,1718673115,1718673327,finished,1718673152,1718673327,A100-SXM4-80GB,8,2,64,896,37,175
364a0df4-d5e8-4ef6-a58b-7ad5ae18135d,stf-test-asrto-guoguo,1718673379,1718673518,finished,1718673396,1718673518,A100-SXM4-80GB,8,1,64,448,17,122
adc6fc47-8dcb-4747-83f1-1e0389c77757,llama-factory-test,1718673397,1718675183,finished,1718673450,1718675183,A100-SXM4-80GB,8,2,64,896,53,1733
b0d7c64e-dc7d-4c4b-b133-0a1423d73b27,qwen2-72b-0617-dpo,1718673547,1718711376,finished,1718673564,1718711376,A100-SXM4-80GB,8,1,64,448,17,37812
fb35273e-3df6-4456-be58-2dc18be1a023,sfr-ft-4,1718674532,1718675085,finished,1718674550,1718675085,A100-SXM4-80GB,8,1,64,448,18,535
37934ab4-0542-4b89-b386-cc970d83028b,easycontext-llama3,1718674657,1718690238,finished,1718685949,1718690238,A100-SXM4-80GB,8,40,64,448,11292,4289
c4917f4a-0f3d-4021-8cc8-d8927617a508,sft-txy-v2,1718674692,1718870739,finished,1718674710,1718870739,A100-SXM4-80GB,8,1,64,448,18,196029
294544e9-a3ca-4ef9-9b02-730da88b0704,stf-test-asrto-guoguo,1718674710,1718675083,finished,1718674728,1718675083,A100-SXM4-80GB,8,1,64,448,18,355
fbd9ab05-3f70-4e95-bfbc-201edde038b2,helloworld,1718674749,1718675135,finished,1718674766,1718675135,A100-SXM4-80GB,8,1,64,448,17,369
5c073baa-4787-48f9-8053-086f031438d4,qwen2-72b-chat-sft-dpo,1718675042,1718676704,finished,1718675060,1718676704,A100-SXM4-40GB,8,1,32,320,18,1644
9edba196-5ccc-4c17-b405-a3ba96be76fd,sft-test-guoguo,1718675083,1718675481,finished,1718675099,1718675481,A100-SXM4-80GB,8,1,64,448,16,382
782ec14d-8e3a-4d9c-931e-3ef3ee0dff56,sleep-xiaodian,1718675116,1718719882,finished,1718675734,1718719882,A100-SXM4-80GB,8,1,64,448,618,44148
968917a6-8aeb-4197-97b8-08e9094f2a8d,llama-factory-test,1718675183,1718676260,finished,1718675250,1718676260,A100-SXM4-80GB,8,2,64,896,67,1010
b727b115-3e47-4982-9540-3d1065afc3e4,helloworld,1718675413,1718675550,finished,1718675431,1718675550,A100-SXM4-80GB,8,1,64,448,18,119
73c581b7-b016-4ea5-a53f-6a39d1898519,sft-test-guoguo,1718675481,1718675717,finished,1718675499,1718675717,A100-SXM4-80GB,8,1,64,896,18,218
37ddc8e4-3f3a-4aa2-8fd8-e1ba668c7e0c,Qwen2-72B-Instruct,1718675811,1718676481,finished,1718675828,1718676481,A100-SXM4-80GB,8,1,64,448,17,653
a7db3698-69f0-4a94-882f-e3f4527c3dd0,sfr-ft-4,1718675833,1718676308,finished,1718675850,1718676308,A100-SXM4-80GB,8,1,64,448,17,458
b4790f46-9a7e-4c0c-a553-f5208516874d,qwen1-5-7b-chat,1718676253,1718849744,finished,1718676272,1718849744,A100-SXM4-40GB,4,1,32,320,19,173472
6adad843-66e6-473f-8b41-325ef851aeba,llama-factory-test,1718676260,1718677946,finished,1718676308,1718677946,A100-SXM4-80GB,8,2,64,896,48,1638
d7149eba-0096-48f9-a003-50944ececa9c,qwen2-72b-chat-sft-dpo,1718676823,1718764504,finished,1718676842,1718764504,A100-SXM4-40GB,8,1,32,320,19,87662
d6c06b8c-e0e6-4555-b28a-8aaf4f9ac16b,geo-slim-gxy-general3,1718676995,1718692241,finished,1718677049,1718692241,A100-SXM4-80GB,8,2,64,448,54,15192
614d15c1-b1a6-4d56-aedb-0ba9c1f6ed59,geo-slim-gxy-general4,1718676995,1718696923,finished,1718677031,1718696923,A100-SXM4-80GB,8,2,64,448,36,19892
15108d8f-50f5-4a82-a35c-7a3746053dcc,sft-radio,1718677094,1718678583,finished,1718677110,1718678583,A100-SXM4-80GB,8,1,64,448,16,1473
7ef92faf-09f6-4246-896b-67dd3b48911d,longbench-infer,1718677358,1718677839,finished,1718677376,1718677839,A100-SXM4-40GB,4,1,32,320,18,463
08ec7c06-862e-4b18-aa58-1af70462263e,qwen2-72b-instruct,1718677644,1718681506,finished,1718677661,1718681506,A100-SXM4-40GB,8,1,32,320,17,3845
d8f9c5e3-37e4-46cb-9a83-b3b8782f11fd,longbench-infer,1718677839,1718677992,finished,1718677859,1718677992,A100-SXM4-40GB,4,1,32,320,20,133
3bba8df3-b2c0-4ebe-a636-90e1404a6000,intent-test,1718677881,1718678031,finished,1718677898,1718678031,A100-SXM4-40GB,8,1,32,320,17,133
8c7ff293-c950-46e5-a3f7-06f098411893,llama-factory-test,1718677946,1718686038,finished,1718685889,1718686038,A100-SXM4-80GB,8,2,64,896,7943,149
acfc0b0d-d831-4aca-bd9a-aea65da40187,teval-infer,1718677957,1718678064,finished,1718677975,1718678064,A100-SXM4-40GB,4,1,32,320,18,89
baf56e85-bdf8-472f-9c29-da93a8cde19b,geogpt-qwen2-chat-0612dpo-slerp1,1718678003,1718690762,finished,1718678019,1718690762,A100-SXM4-80GB,8,1,64,448,16,12743
55d36a0b-17f7-414c-850a-4b1b470c16df,geogpt-qwen2-chat-0612dpo-slerp3,1718678037,1718709527,finished,1718678055,1718709527,A100-SXM4-80GB,8,1,64,448,18,31472
beb87de6-9025-4cd3-a022-382d0b8a674e,geogpt-qwen2-chat-0612dpo-slerp5,1718678039,1718709527,finished,1718678056,1718709527,A100-SXM4-80GB,8,1,64,448,17,31471
8f296de0-d41d-43fc-9711-84ac7ccee16f,geogpt-qwen2-chat-0612dpo-slerp7,1718678057,1718709528,finished,1718678075,1718709528,A100-SXM4-80GB,8,1,64,448,18,31453
73158d45-5518-4dd8-9a03-e39f848a503d,geogpt-qwen2-chat-0612dpo-slerp9,1718678077,1718692285,finished,1718678093,1718692285,A100-SXM4-80GB,8,1,64,448,16,14192
7970ace0-724e-4ac7-86eb-67ea84288554,teval-infer,1718678234,1718678304,finished,1718678253,1718678304,A100-SXM4-40GB,4,1,32,320,19,51
d7877bbb-50da-4672-a190-97fa950e22b6,sft-hengxing-vf,1718678458,1718694175,finished,1718686203,1718694175,A100-SXM4-80GB,8,1,64,448,7745,7972
e51aaf75-78fc-45e1-908f-df3000a8c0a5,teval-infer,1718678470,1718678925,finished,1718678490,1718678925,A100-SXM4-40GB,4,1,32,320,20,435
9dcab218-f4a7-4598-9750-e771e5981afa,sleep-txy,1718678475,1718692996,finished,1718678602,1718692996,A100-SXM4-80GB,8,1,64,448,127,14394
10cd8b52-1561-4fbe-9897-28a7b99529fa,llama3-rag,1718678515,1718850295,finished,1718678534,1718850295,A100-SXM4-80GB,8,1,64,448,19,171761
1e4454eb-17b4-4ca5-b620-40d4c7383f2e,teval-infer,1718678926,1718763633,finished,1718678943,1718763633,A100-SXM4-40GB,4,1,32,320,17,84690
47906969-3248-4eeb-8c8a-c4f11baf86e5,ls,1718679061,1718693104,finished,1718679080,1718693104,A100-SXM4-80GB,8,1,64,896,19,14024
82cc5768-638b-476b-9336-82a8f9f3daa9,geogpt-lxz-sft-slimorca-geo-mtm1-mt-wild-14b,1718679139,1718758381,finished,1718685912,1718758381,A100-SXM4-80GB,8,16,64,448,6773,72469
83209aa1-17d0-44db-93d0-12787bb80c44,geo-base-debug,1718679929,1718686002,finished,1718679947,1718686002,A100-SXM4-80GB,8,1,64,448,18,6055
a2f797c3-7228-4e63-a709-fd917a8489d0,qwen2-72b-instruct,1718681836,1718681994,finished,1718681856,1718681994,A100-SXM4-40GB,8,1,32,320,20,138
da209a74-89b6-4c07-a74b-bacd6c856520,geo-slim-gxy-data5,1718681837,1718692695,finished,1718681856,1718692695,A100-SXM4-40GB,4,1,32,320,19,10839
44d80a84-5477-48bb-b015-6055650e31ad,geo-slim-gxy-data4,1718681927,1718683304,finished,1718681943,1718683304,A100-SXM4-40GB,4,1,32,320,16,1361
f9a57530-3a24-4783-b3d2-7fd772232a5d,qwen2-72b-instruct,1718682275,1718692221,finished,1718682293,1718692221,A100-SXM4-40GB,8,1,32,320,18,9928
ce2e1e3a-f24f-4113-9c90-6232668a54eb,geo-slim-gxy-data4,1718683733,1718692713,finished,1718683753,1718692713,A100-SXM4-40GB,4,1,32,320,20,8960
4904c8a9-c6cb-4412-a082-dafc2edb57f9,llama-pro-test,1718684239,1718691730,finished,1718691612,1718691730,A100-SXM4-80GB,8,1,64,448,7373,118
cdda18e6-a6ba-4e97-a781-00b4473c2f83,slimorca-geo-mtm1-14b,1718684244,1718689675,finished,1718684263,1718689675,A100-SXM4-80GB,8,1,64,448,19,5412
9fb9f1df-f4cf-42ac-8e93-a4d78f624e3f,intent-train,1718684295,1718686078,finished,1718684314,1718686078,A100-SXM4-80GB,8,1,64,448,19,1764
e253b2d3-58e5-4761-a0ee-dca44316b421,geo-base-debug,1718686526,1718689995,finished,1718686547,1718689995,A100-SXM4-80GB,8,1,64,448,21,3448
31ff640b-5bb5-41ff-bbec-2de439d5d523,qwen2-72b-instruct,1718686937,1718850281,finished,1718686961,1718850281,A100-SXM4-80GB,8,1,64,896,24,163320
f1da27d5-e21d-494c-8867-1679db991c5e,intent-train,1718689285,1718689505,finished,1718689306,1718689505,A100-SXM4-80GB,8,1,64,448,21,199
0d1dfc68-e3c6-4064-a811-7344a858b446,intent-train,1718689559,1718689779,finished,1718689578,1718689779,A100-SXM4-80GB,8,1,64,448,19,201
663ef5b1-ebc5-4a0a-97c6-b23a940baac7,geogpt-upcycling-qwen14b-resume,1718690018,1718690418,finished,1718690288,1718690418,A100-SXM4-80GB,8,16,64,896,270,130
8051e835-8bc8-41f3-ad2e-252be51cee4f,geogpt-upcycle-4x14b,1718690070,1718690382,finished,1718690263,1718690382,A100-SXM4-80GB,8,16,64,448,193,119
b34eda31-d7a1-4e85-97b3-55586c9a857b,geo-base-debug,1718690106,1718690559,finished,1718690124,1718690559,A100-SXM4-80GB,8,1,64,448,18,435
4cf98723-aae9-468e-935c-4a2441db97db,intent-test,1718690307,1718690879,finished,1718690325,1718690879,A100-SXM4-40GB,8,1,32,320,18,554
05680ff5-4073-45c0-bf6a-c9df32fa2bcb,geogpt-upcycling-qwen14b-resume,1718690481,1718825358,finished,1718690516,1718825358,A100-SXM4-80GB,8,16,64,896,35,134842
5279435a-3757-42a2-96fd-232a6baba38c,intent-test,1718690555,1718690669,finished,1718690575,1718690669,A100-SXM4-80GB,8,1,64,448,20,94
595961ae-5cc2-45d8-8178-b277ba5f2fec,geogpt-smoe-eval,1718690655,1718713347,finished,1718690673,1718713347,A100-SXM4-80GB,8,1,64,448,18,22674
6214ac93-bddd-4251-8b02-ee7043642748,intent-test,1718690846,1718690995,finished,1718690863,1718690995,A100-SXM4-80GB,8,1,64,448,17,132
c569e3d2-68ba-4a5a-b92c-2919de9e4249,sfr-embedding-test,1718691725,1718692297,finished,1718691743,1718692297,A100-SXM4-40GB,1,16,8,32,18,554
b16b2afe-1916-4cd9-b3fb-cd14cef82819,geo-moe-pretrain-mh,1718691915,1718692101,finished,1718691967,1718692101,A100-SXM4-80GB,8,4,64,448,52,134
71177766-627c-43e6-bb73-b0c2bfb5d3b6,llama3-70b-instruct,1718692014,1718692217,finished,1718692032,1718692217,A100-SXM4-80GB,8,1,64,896,18,185
2c83c662-72e2-4a7a-8a1a-56b279d1a76a,geo-moe-pretrain-mh,1718692182,1718692373,finished,1718692242,1718692373,A100-SXM4-80GB,8,4,64,448,60,131
673ea9c7-9290-43a7-9ddc-e6808dc9a6ef,llama3-70b-instruct,1718692217,1718759112,finished,1718692238,1718759112,A100-SXM4-80GB,8,1,64,896,21,66874
aeb95f3f-50de-41ab-b349-10910c6186c0,reranker2-inference,1718692218,1718850882,finished,1718692239,1718850882,A100-SXM4-40GB,1,1,8,32,21,158643
c629967e-94c8-444c-a7ac-f5c5390a6d47,qwen2-72b-instruct,1718692221,1718735350,finished,1718692241,1718735350,A100-SXM4-40GB,8,1,32,320,20,43109
df70bfbd-4d9f-43b0-93cd-66a45ba414da,geogpt-14b-5bgeo-35bkg,1718692229,1718781687,finished,1718695109,1718781687,A100-SXM4-80GB,8,50,64,448,2880,86578
036680d7-0bb5-40bf-9c46-b8ad994d109d,sfr-embedding-test,1718692297,1718705883,finished,1718692315,1718705883,A100-SXM4-40GB,1,16,8,32,18,13568
c13d371e-7608-402f-a462-a0e02f28dc60,llama-pro-test,1718692928,1718695163,finished,1718695026,1718695163,A100-SXM4-80GB,8,1,64,448,2098,137
eb5ee959-6f81-4a06-b5e7-8f7a75da6888,xuzenghui-test,1718692996,1718695421,finished,1718694191,1718695421,A100-SXM4-80GB,8,1,64,896,1195,1230
0cd12c58-8cab-4ce4-9908-e13d55ffbee5,sleep-txy,1718692996,1718694451,finished,1718693015,1718694451,A100-SXM4-80GB,8,1,64,448,19,1436
967465ce-aac0-4922-a9a0-4cbe65f5b81f,geogpt-llm-moe-expand-tag-loss,1718693560,1718695008,finished,1718693579,1718695008,A100-SXM4-80GB,8,1,64,896,19,1429
8548bfe4-ac08-4743-ab12-1fa44f8b45b2,qwen1-5-14b-40bcpt-1ep,1718693585,1718762499,finished,1718693603,1718762499,A100-SXM4-80GB,8,1,64,448,18,68896
a058d2fb-bd35-4afa-967d-394847a072ff,sleep-txy,1718694451,1718697915,finished,1718694469,1718697915,A100-SXM4-80GB,8,1,64,448,18,3446
bc2b8731-6177-4c2c-9a74-e4aa218631da,intent-train-llm-gpt,1718694472,1718694576,finished,1718694490,1718694576,A100-SXM4-80GB,8,1,64,448,18,86
aded76ec-6390-4530-9fbf-beddea70c42e,intent-train-llm-gpt,1718694645,1718695572,finished,1718694727,1718695572,A100-SXM4-80GB,8,1,64,448,82,845
96ae366a-fe22-4b68-aa2d-cb164bcde006,geogpt-llm-moe-expand-tag-loss-only,1718695044,1718778468,finished,1718695063,1718778468,A100-SXM4-80GB,8,1,64,896,19,83405
4fc7e4d6-fa97-4c0a-a14b-999d1481a3e3,geogpt-llm-moe-expand-2,1718695062,1718778484,finished,1718695083,1718778484,A100-SXM4-80GB,8,1,64,896,21,83401
65bf5f2c-d217-4d09-96c4-d32ade70e917,geogpt-llm-moe-expand-tag-loss,1718695063,1718778484,finished,1718695182,1718778484,A100-SXM4-80GB,8,1,64,896,119,83302
3225c2bd-5fa8-4556-b7a7-ea86f4d3ad20,geo-slim-gxy-general3,1718695102,1718719414,finished,1718695143,1718719414,A100-SXM4-40GB,4,1,32,320,41,24271
8097ede4-96de-47c2-8529-e8557af22339,planet-opencompass,1718695138,1718799825,finished,1718697263,1718799825,A100-SXM4-80GB,8,1,64,448,2125,102562
444f2cf8-7dde-4677-ace9-10592c4b606c,geogpt-qwen-benchmark-cw-03,1718695297,1718701814,finished,1718699664,1718701814,A100-SXM4-80GB,8,1,64,896,4367,2150
7b65f465-96eb-4abf-80d1-cd898e257676,cosmology-opencompass-fumingxiang,1718695403,1718697246,finished,1718695439,1718697246,A100-SXM4-80GB,8,1,64,448,36,1807
26755667-a7d3-4c9b-b4d3-eec0b5940549,rag-tq-embedding-mistral,1718696307,1718850261,finished,1718696326,1718850261,A100-SXM4-80GB,8,1,64,448,19,153935
36e2384b-7f56-4d73-8455-a10c13d8c38d,intent-train-llm-gpt,1718696308,1718697120,finished,1718696327,1718697120,A100-SXM4-80GB,8,1,64,448,19,793
83ecee4a-f443-4c4d-b7c4-1791e47f9dc7,xuzenghui-test,1718696539,1718783697,finished,1718696557,1718783697,A100-SXM4-80GB,8,1,64,896,18,87140
28d43993-4733-459c-b982-20e023183f15,sfr-ft-4,1718696595,1718697371,finished,1718696612,1718697371,A100-SXM4-80GB,8,1,64,448,17,759
8bfac559-b67a-4b8b-a6c1-2df7b617652d,slimorca-geo-mtm1-fcv2-14b,1718697036,1718767347,finished,1718697054,1718767347,A100-SXM4-80GB,8,1,64,448,18,70293
ecaf38fe-9934-4a10-9f9d-2a25ab91f879,sfr-ft-4,1718697497,1718698113,finished,1718697515,1718698113,A100-SXM4-80GB,8,1,64,448,18,598
b9ac064c-bfdc-4c9b-8a26-43caf0278353,intent-train-llm-gpt,1718697588,1718699513,finished,1718697607,1718699513,A100-SXM4-80GB,8,1,64,448,19,1906
eb7fc51f-6bae-4fe0-9c36-fe0f4baaff42,sleep-txy,1718697915,1718704184,finished,1718697932,1718704184,A100-SXM4-80GB,8,1,64,448,17,6252
c7861728-6107-49ca-93be-cf5f260ff1df,llama3-instruct-70b,1718698211,1718699370,finished,1718698228,1718699370,A100-SXM4-80GB,8,1,64,448,17,1142
c39ab910-6bcc-4830-80bf-9e2f4aef2a80,geo-moe-pretrain-mh,1718698284,1718700387,finished,1718698576,1718700387,A100-SXM4-80GB,8,4,64,448,292,1811
6fe7662b-f45e-4b2c-b4f9-9e395a34f44f,sleeping-buhaili,1718698648,1718703756,finished,1718698668,1718703756,A100-SXM4-80GB,8,1,64,448,20,5088
d5202f93-f334-4f53-a72c-14bbc08361fd,geogpt-dairui-model-merge-exp-2,1718698712,1718778868,finished,1718754056,1718778868,A100-SXM4-80GB,8,1,64,896,55344,24812
968e9f58-92ad-4bda-b0e0-b13b5214fca8,geogpt-lxz-sft-slimorca-geo-mtm1-geotable-nt-14b,1718698958,1718756557,finished,1718702851,1718756557,A100-SXM4-80GB,8,16,64,448,3893,53706
cd484abe-bdae-4ff3-8c10-10c4e3e59a62,llama3-instruct-70b,1718699410,1718767658,finished,1718699426,1718767658,A100-SXM4-80GB,8,1,64,448,16,68232
5aa0c770-c7b5-4493-98b2-443dd55d5e29,sfr-ft-4,1718699457,1718700280,finished,1718699475,1718700280,A100-SXM4-80GB,8,1,64,448,18,805
1b975644-16c5-44ba-83fc-f8a5e417bdc4,intent-train-llm-gpt,1718699659,1718700369,finished,1718699680,1718700369,A100-SXM4-80GB,8,1,64,448,21,689
7f7c2116-34d9-4827-9044-f22273d1ee80,geogpt-dairui-eval-code,1718699683,1718753936,finished,1718701833,1718753936,A100-SXM4-80GB,8,1,64,896,2150,52103
22302d37-fae3-4119-b8da-512d24cd5675,intent-train-llm-gpt,1718700439,1718701176,finished,1718700456,1718701176,A100-SXM4-80GB,8,1,64,448,17,720
6f74b88d-be5a-4b9d-9a64-354d7c37848b,geo-moe-pretrain-mh,1718700547,1718709771,finished,1718700599,1718709771,A100-SXM4-80GB,8,4,64,448,52,9172
d5849bdc-1393-4add-be25-49d42335c7d3,geogpt-eval-latest,1718700934,1718709321,finished,1718700951,1718709321,A100-SXM4-80GB,8,1,64,896,17,8370
96defafa-a529-409b-867b-83fc11f4fe5f,intent-train-llm-gpt,1718701318,1718702812,finished,1718701335,1718702812,A100-SXM4-80GB,8,1,64,448,17,1477
9f8a35fa-c6a5-47e1-acef-1c6fa8bf9ed4,geo-slim-gxy-mixdata,1718702256,1718703743,finished,1718702275,1718703743,A100-SXM4-80GB,8,1,64,448,19,1468
f00331a2-e706-436e-8975-8e1058265bca,intent-train-llm-gpt,1718702909,1718703177,finished,1718702926,1718703177,A100-SXM4-80GB,8,1,64,448,17,251
1509d82c-2287-406c-b00f-f7c73e06bf72,intent-train-llm-gpt,1718703196,1718705013,finished,1718703214,1718705013,A100-SXM4-80GB,8,1,64,448,18,1799
ec0e318a-5253-495b-b686-e55e78555d98,sleeping-buhaili,1718703756,1718761112,finished,1718703773,1718761112,A100-SXM4-80GB,8,1,64,448,17,57339
3b4e68e9-abed-4441-b8bd-a1aa063872de,geo-slim-gxy-mixdata,1718703814,1718736856,finished,1718705157,1718736856,A100-SXM4-80GB,8,2,64,448,1343,31699
be253257-056a-418b-8b35-d913ddfbf904,sleep-txy,1718704184,1718762542,finished,1718704201,1718762542,A100-SXM4-80GB,8,1,64,448,17,58341
49e5d48c-f286-406a-b660-bac8ac003205,geogpt-qwen2-chat-0612dpo-ties-p17,1718704511,1718711005,finished,1718704530,1718711005,A100-SXM4-80GB,8,1,64,448,19,6475
4dbecad8-e482-4cb2-8c4e-66d9ce59b693,sfr-ft-4,1718705489,1718706132,finished,1718705506,1718706132,A100-SXM4-80GB,8,1,64,448,17,626
f28dcade-74a3-40d0-b2b2-13bdbdd83d58,sfr-embedding-test,1718706131,1718708739,finished,1718706150,1718708739,A100-SXM4-40GB,1,16,8,32,19,2589
f335dbfc-cf81-4016-a322-d2818df9c396,easycontext-zj-test,1718706628,1718707142,finished,1718706666,1718707142,A100-SXM4-80GB,8,2,64,896,38,476
8f83982f-9a58-444d-863c-da30a3c87346,sfr-ft-4,1718706736,1718706966,finished,1718706755,1718706966,A100-SXM4-80GB,8,1,64,448,19,211
5a572cbf-2bf2-4264-a7bf-90738aec467f,easycontext-zj-test,1718707388,1718708303,finished,1718707425,1718708303,A100-SXM4-80GB,8,2,64,896,37,878
affbd49a-5d0d-4f0d-87f5-faccd0d51a94,sfr-ft-2,1718707496,1718832087,finished,1718707515,1718832087,A100-SXM4-80GB,8,1,64,448,19,124572
e1a0b614-3464-488c-bded-ff87503bb01b,sfr-ft-4,1718707515,1718709114,finished,1718707533,1718709114,A100-SXM4-80GB,8,1,64,448,18,1581
da031a21-7fe9-433d-a9e4-e55c8f5d0633,llama-factory-zj-test,1718708373,1718708531,finished,1718708409,1718708531,A100-SXM4-80GB,8,2,64,896,36,122
ce22f949-0154-4442-9b8e-6e4e8f24be2d,sfr-ft-4,1718709114,1718709297,finished,1718709134,1718709297,A100-SXM4-80GB,8,1,64,448,20,163
fff6025e-b6e9-44df-9af0-31055fc1fc83,cft-mt-lr5e-6-14b,1718709123,1718767330,finished,1718709140,1718767330,A100-SXM4-80GB,8,1,64,448,17,58190
71a81887-b1b2-4798-a6ae-e7ad93582225,cft-mt-lr1e-5-14b,1718709197,1718767330,finished,1718709215,1718767330,A100-SXM4-80GB,8,1,64,448,18,58115
73dd4241-c500-4818-8900-f2f57d8b359b,geogpt-eval-latest,1718709703,1718710986,finished,1718709718,1718710986,A100-SXM4-80GB,8,1,64,896,15,1268
6ee16840-89a4-4086-8787-3befea32dc35,llama-factory-zj-test,1718709804,1718709984,finished,1718709857,1718709984,A100-SXM4-80GB,8,2,64,896,53,127
46cf953f-69bd-4670-99dc-1b4d153b76f0,geo-llamapro-1,1718709914,1718728732,finished,1718725992,1718728732,A100-SXM4-80GB,8,1,64,448,16078,2740
4e91ad07-4f1d-476a-ad3d-5623a30579fb,geo-llamapro-2,1718709951,1718785134,finished,1718728749,1718785134,A100-SXM4-80GB,8,1,64,448,18798,56385
57b40c95-1cd6-4521-bec0-782ea444b479,geo-llamapro-3,1718710040,1718785046,finished,1718743248,1718785046,A100-SXM4-80GB,8,1,64,448,33208,41798
48e3c736-5213-496c-951d-8b9f36a6c9d6,llama-factory-zj-test,1718710122,1718710472,finished,1718710159,1718710472,A100-SXM4-80GB,8,2,64,896,37,313
05db6875-b268-4132-9040-e7cbe2009ceb,geo-llamapro-4,1718710144,1718769078,finished,1718712465,1718769078,A100-SXM4-80GB,8,1,64,448,2321,56613
1997f148-305c-4e1f-8778-4458b215d6e6,geo-llamapro-5,1718710233,1718782124,finished,1718725105,1718782124,A100-SXM4-80GB,8,1,64,448,14872,57019
6c3ae315-cc7a-4d4e-b91a-9c0fa96ad096,geo-base-debug,1718711001,1718711478,finished,1718711019,1718711478,A100-SXM4-80GB,8,1,64,448,18,459
ebca34c7-6c64-4036-9018-513ae820371c,geogpt-qwen2-chat-0612dpoe2-dare-ties-p17,1718711024,1718765466,finished,1718711043,1718765466,A100-SXM4-80GB,8,1,64,448,19,54423
f6415329-b6e6-451f-90e5-de93a765ff18,citysora-modelv4-webvid-humanface-65-256,1718711041,1718711353,finished,1718711129,1718711353,A100-SXM4-80GB,8,4,64,896,88,224
6c8071d5-83de-4445-a65c-0144eec08625,citysora-modelv4-webvid-humanface-65-256,1718711408,1719285056,finished,1718711460,1719285056,A100-SXM4-80GB,8,4,64,896,52,573596
d52b6cfd-0ba1-46ca-bdf8-300fbc32b0a6,geo-base-debug,1718711651,1718716153,finished,1718711669,1718716153,A100-SXM4-80GB,8,1,64,448,18,4484
06b32aa6-b53f-496e-b6ac-a34d1f379132,geogpt-eval-latest,1718711725,1718719779,finished,1718711743,1718719779,A100-SXM4-80GB,8,1,64,896,18,8036
93bf4a9a-c39e-4fa5-9972-e6b888244fcd,citysora-modelv4-webvid-humanface-65-128,1718712067,1718712409,finished,1718712176,1718712409,A100-SXM4-80GB,8,4,64,896,109,233
b7553895-ed37-4500-86b5-098c0368243f,geogpt-lxz-sft-slimorca-geo-mtm1-funcfil2-14b,1718712125,1718764400,finished,1718712179,1718764400,A100-SXM4-80GB,8,16,64,448,54,52221
89268b38-b8f9-45fb-bdac-2faf4963f7c7,qwen2-72b-sft-dpo,1718712415,1718712610,finished,1718712471,1718712610,A100-SXM4-80GB,8,4,64,896,56,139
360504d0-03a0-492e-9082-9c7cf2728727,citysora-modelv4-webvid-humanface-65-128,1718712447,1718961364,finished,1718712500,1718961364,A100-SXM4-80GB,8,4,64,896,53,248864
02029ea4-f0e6-494b-89a5-c5a96c44bc64,geo-table-merge,1718712655,1718719925,finished,1718712674,1718719925,A100-SXM4-80GB,8,1,64,896,19,7251
8601dd85-8c43-417a-8d98-b8bc355d5c8e,llama-factory-zj-test,1718713395,1718713569,finished,1718713447,1718713569,A100-SXM4-80GB,8,2,64,896,52,122
46bc1dda-8d55-4c0f-93f8-0eb3754b1c35,ls2,1718714217,1718718234,finished,1718714235,1718718234,A100-SXM4-80GB,8,1,64,896,18,3999
5a48fdcb-08f7-46b3-b54c-9bd96b46266c,qwen2-72b-sft-dpo,1718714467,1718718386,finished,1718714519,1718718386,A100-SXM4-80GB,8,4,64,896,52,3867
279e9f99-4a94-48cb-8e26-2e8a1a2dd529,qwen2-72b-v12-0618-dpo,1718714604,1718735755,finished,1718718422,1718735755,A100-SXM4-80GB,8,8,64,896,3818,17333
f14c25f2-a189-47cc-b30f-b1d428169ed0,geo-table-datav05-lora-1e-5,1718715026,1718716134,finished,1718715044,1718716134,A100-SXM4-40GB,8,1,32,320,18,1090
e7a56538-4c51-4126-8865-2a5df81ca6cb,opencompass-buhaili,1718715141,1718764579,finished,1718762592,1718764579,A100-SXM4-80GB,8,1,64,448,47451,1987
0de586a5-4804-4366-a89d-bbe012d5f65c,llama2-5bcpt-0527,1718715185,1718715448,finished,1718715237,1718715448,A100-SXM4-80GB,8,4,64,448,52,211
2df8bcb2-3884-4b41-b2f3-45e5564f801d,llama2-5bcpt-0527,1718715482,1718716271,finished,1718715517,1718716271,A100-SXM4-80GB,8,2,64,448,35,754
114d4c1c-cf23-4de2-b2da-177b9752a0ad,geo-table-datav05-lora-1e-4,1718716065,1718716190,finished,1718716083,1718716190,A100-SXM4-40GB,8,1,32,320,18,107
99de485e-ed3f-46c2-8dea-56ab8f82ad2e,geo-table-datav05-lora-1e-5,1718716135,1718729153,finished,1718716152,1718729153,A100-SXM4-80GB,8,1,64,896,17,13001
9719b4ad-f9ee-40fb-afaf-af9d8c0492a4,llama3-70b-instruct,1718716180,1718762503,finished,1718716200,1718762503,A100-SXM4-40GB,8,1,32,320,20,46303
c9fb7ace-7df2-45d9-a96b-6efb68a2175c,geo-table-datav05-lora-1e-4,1718716191,1718728619,finished,1718716210,1718728619,A100-SXM4-80GB,8,1,64,896,19,12409
48c59a04-cfdc-4cef-981b-8670f48c04f1,llama3-70b-base,1718716200,1718814724,finished,1718716219,1718814724,A100-SXM4-40GB,8,1,32,320,19,98505
1dccaef0-8917-4d6e-a0e4-0539bc9dc638,llama3-8b-instruct,1718716220,1718762468,finished,1718716238,1718762468,A100-SXM4-40GB,8,1,32,320,18,46230
97ac9084-ee48-42e9-af73-61df6ac0ad67,llama3-8b-base,1718716238,1718762468,finished,1718716257,1718762468,A100-SXM4-40GB,8,1,32,320,19,46211
38d93f89-69ba-43c3-93bc-925ea3c7165a,llama-factory-zj-test,1718718161,1718718450,finished,1718718251,1718718450,A100-SXM4-80GB,8,2,64,896,90,199
2642c650-8423-4d82-9a33-779b5aac30db,opencompass-gaoneng-mashuguo,1718718358,1718725571,finished,1718719902,1718725571,A100-SXM4-80GB,8,1,64,448,1544,5669
2ddfb0a5-952c-43f2-88f1-811717d1e872,llama-factory-zj-test,1718718580,1718720476,finished,1718719771,1718720476,A100-SXM4-80GB,8,2,64,896,1191,705
52c1b36f-8ee3-4ee4-a022-33f06e348593,geo-slim-gxy-data07,1718719222,1718721973,finished,1718719242,1718721973,A100-SXM4-80GB,8,2,64,448,20,2731
96fcc44e-7d89-4f92-9647-c2791d21edaa,sleep-xiaodian,1718719882,1718767872,finished,1718725589,1718767872,A100-SXM4-80GB,8,1,64,448,5707,42283
555809bf-925c-4a85-ae32-4b832e749b26,lzk-qwen15-7b-scihub-abstract-cpt,1718720248,1718743238,finished,1718742874,1718743238,A100-SXM4-80GB,8,1,64,448,22626,364
96f2cc26-588e-4842-8baa-b2293e61e7b1,geo-slim-gxy-data07,1718722045,1718724485,finished,1718722063,1718724485,A100-SXM4-80GB,8,1,64,448,18,2422
adb4a465-6515-4f51-8ff3-ae00453eef6c,ls2,1718722294,1718722644,finished,1718722313,1718722644,A100-SXM4-80GB,8,1,64,896,19,331
5f7d16de-cc66-4602-99ec-5615ec591810,llama-factory-zj-test,1718722644,1718734242,finished,1718728707,1718734242,A100-SXM4-80GB,8,2,64,896,6063,5535
655616e5-347f-44ba-9035-940402a94a9c,geogpt-lxz-qwen-chat-cft-lr5e-6-14b,1718724321,1718787549,finished,1718756574,1718787549,A100-SXM4-80GB,8,16,64,448,32253,30975
039a52ab-5d50-4839-b1da-0d0399d8ccad,geo-slim-gxy-data07,1718724613,1718743436,finished,1718733773,1718743436,A100-SXM4-80GB,8,2,64,448,9160,9663
96b90cab-60e0-43ee-b7af-dad83b36cbfd,lzk-qwen15-7b-scihub-abstract-read-compre-cpt,1718727339,1718754047,finished,1718753961,1718754047,A100-SXM4-80GB,8,1,64,448,26622,86
7106643c-e675-4410-b346-3ee96e4cbaaf,geogpt-table-qwen2-72b-datav05-lora-5e-5,1718728711,1718800744,finished,1718733773,1718800744,A100-SXM4-80GB,8,4,64,896,5062,66971
f73099e2-42dd-4b90-a2aa-f02a779d9efc,geogpt-table-qwen2-72b-datav041,1718729078,1718786563,finished,1718729152,1718786563,A100-SXM4-80GB,8,4,64,896,74,57411
706a9289-7a4c-48f7-8e42-8040f18ca61e,llama-factory-zj-test,1718735008,1718743175,finished,1718735764,1718743175,A100-SXM4-80GB,8,2,64,896,756,7411
364c156d-f93d-4054-9d77-bba46f673dc0,geogpt-tableqa-sft-qwen2-72b-0612-datav081,1718735162,1718877625,finished,1718735747,1718877625,A100-SXM4-80GB,8,4,64,896,585,141878
69a24630-6bb9-489c-a594-37951499b25b,geo-llamapro-1,1718757949,1718789965,finished,1718778485,1718789965,A100-SXM4-80GB,8,1,64,448,20536,11480
936686ab-eaf0-41dc-b184-804edf3683ac,qwen2-72b-0618-dpo,1718759343,1718850106,finished,1718759361,1718850106,A100-SXM4-80GB,8,1,64,448,18,90745
2516f4c9-ff07-447f-b015-8f97cd5ec400,llama3-70b-instruct,1718759576,1718764478,finished,1718759594,1718764478,A100-SXM4-80GB,8,1,64,896,18,4884
935ef0b4-2be0-479e-a41d-3ec5cbed6e1e,sfr-ft-4,1718760144,1718761359,finished,1718760162,1718761359,A100-SXM4-80GB,8,1,64,448,18,1197
ff0df598-a076-4963-99bd-17f274ee882e,llama-factory-zj-test,1718760234,1718760749,finished,1718760268,1718760749,A100-SXM4-80GB,8,2,64,896,34,481
7cd7c756-dd13-4550-82f8-3ff51ef19838,sleeping-buhaili,1718761112,1718877715,finished,1718761130,1718877715,A100-SXM4-80GB,8,1,64,448,18,116585
8d1d684e-f3c9-4d48-942f-dadb98900f83,sfr-ft-4,1718761360,1718764633,finished,1718761377,1718764633,A100-SXM4-80GB,8,1,64,448,17,3256
46d61d59-aa53-4503-8637-055cdce531ed,intent-train-llm-gpt-desc,1718761395,1718761741,finished,1718761414,1718761741,A100-SXM4-80GB,8,1,64,448,19,327
6cff10f2-fd0e-4996-896e-23ead0dfa912,test,1718761464,1718762019,finished,1718761481,1718762019,A100-SXM4-80GB,8,1,64,448,17,538
fec32f82-fbe2-45b9-ba59-1f4d232c0620,opencompass-gaoneng-mashuguo,1718761654,1718885497,finished,1718764596,1718885497,A100-SXM4-80GB,8,1,64,448,2942,120901
0cf215e8-fec0-4c12-ac60-6f010810dc18,intent-train-llm-gpt-desc,1718761880,1718762869,finished,1718761898,1718762869,A100-SXM4-80GB,8,1,64,448,18,971
adcbeadb-48d0-4dbb-8c51-3b2401ff508f,llama-factory-zj-test,1718761934,1718762492,finished,1718761986,1718762492,A100-SXM4-80GB,8,2,64,896,52,506
ec031d83-9b77-4808-80ea-92cc2687d944,reranker-inference11,1718762175,1718762331,finished,1718762193,1718762331,A100-SXM4-40GB,1,1,8,32,18,138
2a2ee882-6f85-4549-8bae-704591a05c39,reranker-inference11,1718762420,1718762509,finished,1718762438,1718762509,A100-SXM4-80GB,8,1,64,448,18,71
75051763-9052-4d93-bdfe-a22029478900,sleep-txy,1718762643,1718766909,finished,1718762662,1718766909,A100-SXM4-80GB,8,1,64,448,19,4247
422ff953-0ce8-45fb-933c-6dba12ed4e4c,llama3-70b-instruct,1718762657,1718850235,finished,1718762676,1718850235,A100-SXM4-40GB,8,1,32,320,19,87559
2072112f-4fd6-4010-bc7e-1b0ad947b506,llama3-8b-instruct,1718762777,1718814664,finished,1718762795,1718814664,A100-SXM4-40GB,8,1,32,320,18,51869
26acd8de-e03d-4faa-8204-ae2a02d4a6bb,rag-rank,1718762850,1718762919,finished,1718762868,1718762919,A100-SXM4-80GB,8,1,64,448,18,51
ec401654-165a-4fb5-b100-6c2c346a3cb1,planet-opencompass-lyj,1718762883,1718764477,finished,1718762901,1718764477,A100-SXM4-80GB,8,1,64,448,18,1576
80df5962-af5c-4ab3-b465-b09f2b7f84a2,llama-factory-zj-test,1718762938,1718763604,finished,1718762989,1718763604,A100-SXM4-80GB,8,2,64,896,51,615
927ccebf-6d0d-4e62-87bf-30f3807c0747,rag-rank,1718763006,1718763091,finished,1718763025,1718763091,A100-SXM4-80GB,8,1,64,448,19,66
353447c3-f7f9-47d8-a940-4bce875d2c6a,intent-train-llm-gpt-le2e-6,1718763008,1718763691,finished,1718763026,1718763691,A100-SXM4-80GB,8,1,64,448,18,665
d35d85a3-9e77-4a04-8b46-3ef685a3a7c7,rag-rank,1718763414,1718765461,finished,1718763432,1718765461,A100-SXM4-80GB,8,1,64,448,18,2029
84c271e9-87ec-4679-abea-cb52af1042d5,qwen2-72b-instruct,1718763545,1718850410,finished,1718763563,1718850410,A100-SXM4-80GB,8,1,64,448,18,86847
2923f69e-6672-49dc-ad30-9fdddea551d6,rag-rank,1718763603,1718765514,finished,1718763622,1718765514,A100-SXM4-80GB,8,1,64,448,19,1892
b2043036-2874-4b88-8ff7-bcd7f514ad8a,eval-cosmology-fumingxiang,1718763790,1718846199,finished,1718764494,1718846199,A100-SXM4-80GB,8,1,64,448,704,81705
84f0a793-f0e8-4dc5-8edc-83283257695b,llama-factory-zj-test,1718764026,1718765550,finished,1718764077,1718765550,A100-SXM4-80GB,8,2,64,896,51,1473
a2198076-18dc-4474-a6cd-e8f54ad40b60,geogpt-upcycle-4x14b-sf4,1718764235,1718764761,finished,1718764287,1718764761,A100-SXM4-80GB,8,16,64,896,52,474
aedba9f8-577a-43cb-a590-2760410eb8c7,citysora-modelv4-webvid-cele-laion-joint-65-256,1718764326,1718765782,finished,1718764378,1718765782,A100-SXM4-80GB,8,5,64,896,52,1404
77f2dfb4-93aa-4ad0-836a-632c8c7de439,qwen2-72b-chat-sft-dpo,1718764556,1718765522,finished,1718764573,1718765522,A100-SXM4-40GB,8,1,32,320,17,949
1f912ff8-864a-401b-9520-20bad2641ef3,sfr-ft-4,1718764633,1718814189,finished,1718764650,1718814189,A100-SXM4-80GB,8,1,64,448,17,49539
de5ab44c-793f-4aff-ba34-3973128cb440,geo-slim-gxy-data07,1718764653,1718765177,finished,1718764671,1718765177,A100-SXM4-80GB,8,1,64,896,18,506
f1438361-987a-4739-9140-371afe54b5e5,geo-slim-gxy-mix,1718764691,1718765177,finished,1718764707,1718765177,A100-SXM4-80GB,8,1,64,896,16,470
f4ec8b05-8114-43aa-9d86-8b6d2231e946,geogpt-upcycle-4x14b-sf4,1718764816,1718765334,finished,1718764867,1718765334,A100-SXM4-80GB,8,16,64,896,51,467
9ec43075-eb9e-4916-845e-e7e8e67027c0,qwen1-5-14b-40bcpt-2ep,1718765285,1718778525,finished,1718765303,1718778525,A100-SXM4-80GB,8,1,64,448,18,13222
f1f9ae9a-6402-44b2-852d-f79aed94c49f,geogpt-upcycle-4x14b-sf4,1718765389,1718765785,finished,1718765443,1718765785,A100-SXM4-80GB,8,16,64,896,54,342
7687bd38-4020-45de-b496-ce6f6ccac01d,geogpt-eval-latest,1718765554,1718773531,finished,1718765573,1718773531,A100-SXM4-80GB,8,1,64,896,19,7958
daac6709-af45-40fc-944a-18eb57e1f17f,llama-factory-zj-test,1718765604,1718765712,finished,1718765639,1718765712,A100-SXM4-80GB,8,2,64,896,35,73
566a074d-7516-48f4-aa0d-d15785e8d6c9,geo-slim-gxy-data07,1718765643,1718766612,finished,1718765663,1718766612,A100-SXM4-40GB,4,1,32,320,20,949
470da051-3a77-45b7-9c06-ed48461b7c4d,geo-slim-gxy-mix,1718765644,1718778827,finished,1718765663,1718778827,A100-SXM4-40GB,4,1,32,320,19,13164
af7dece5-9ff4-4dff-84d2-1fee119e7833,ls2,1718765838,1718766574,finished,1718765858,1718766574,A100-SXM4-80GB,8,1,64,896,20,716
b4a6b977-7819-4bc1-b694-5dbae8aa4072,citysora-modelv4-webvid-cele-laion-joint-65-256,1718765843,1718765974,finished,1718765895,1718765974,A100-SXM4-80GB,8,5,64,896,52,79
6af1b012-3076-4d22-b5c1-b2399bc6a897,geogpt-upcycle-4x14b-sf4,1718765846,1718766001,finished,1718765899,1718766001,A100-SXM4-80GB,8,16,64,896,53,102
1c6cdd20-8f1b-4834-babb-b9545243c069,geogpt-smoe-eval,1718765978,1718781284,finished,1718766000,1718781284,A100-SXM4-80GB,8,1,64,448,22,15284
85f04f9e-9c61-43ce-b6aa-d847be6051b2,citysora-modelv4-webvid-cele-laion-joint-65-256,1718766034,1718766142,finished,1718766070,1718766142,A100-SXM4-80GB,8,5,64,896,36,72
2d911ceb-5d6f-44ba-b269-d8f9fd89be33,intent-test-llm,1718766050,1718766752,finished,1718766068,1718766752,A100-SXM4-80GB,8,1,64,448,18,684
ce226623-2066-45cd-8820-a64c7923a418,citysora-modelv4-webvid-cele-laion-joint-65-256,1718766215,1718766360,finished,1718766270,1718766360,A100-SXM4-80GB,8,5,64,896,55,90
54581393-11b1-43ac-931d-8e226da88f67,qwen2-72b-chat-sft-dpo,1718766237,1718767209,finished,1718766258,1718767208,A100-SXM4-40GB,8,1,32,320,21,950
48e180dd-ac86-4ca7-9d98-4e08ad275051,llama3-8b-base,1718766242,1718850235,finished,1718766261,1718850235,A100-SXM4-40GB,8,1,32,320,19,83974
d4cb690f-446e-4009-9613-4ec2aca2d7a3,citysora-modelv4-webvid-cele-laion-joint-65-256,1718766431,1718850581,finished,1718766485,1718850581,A100-SXM4-80GB,8,5,64,896,54,84096
887e40e3-2034-4755-8a0b-7033cd9f8fc6,llama-factory-zj-test,1718766555,1718767235,finished,1718766609,1718767235,A100-SXM4-80GB,8,2,64,896,54,626
33e86b35-40d3-43f1-b482-cfde746a3514,llama2-5bcpt-0527,1718766795,1718766974,finished,1718766850,1718766974,A100-SXM4-80GB,8,2,64,448,55,124
e1168711-9ea2-48ca-93a3-0628a4c1451e,geo-slim-gxy-data07,1718766826,1718772417,finished,1718766844,1718772417,A100-SXM4-40GB,4,1,32,320,18,5573
00d43932-f2c4-4c8f-b470-7415bb35dba8,sleep-txy,1718766909,1718854302,finished,1718766928,1718854302,A100-SXM4-80GB,8,1,64,448,19,87374
1f17bfe7-bd40-4319-a754-27b87856c482,lzk-qwen15-7b-scihub-abstract-cpt,1718766978,1718778494,finished,1718769102,1718778494,A100-SXM4-80GB,8,1,64,448,2124,9392
2c74e850-fb5a-4706-9832-a97a4f09914f,lzk-qwen15-7b-scihub-abstract-read-compre-cpt,1718766979,1718778475,finished,1718775201,1718778475,A100-SXM4-80GB,8,1,64,448,8222,3274
d86ea250-bc0e-4293-92ca-8c55a959397a,llama2-5bcpt-0527,1718767135,1718767315,finished,1718767190,1718767315,A100-SXM4-80GB,8,2,64,448,55,125
7a0e8ade-f38a-427e-8266-a5751877561e,qwen2-72b-chat-sft-dpo,1718767298,1718767729,finished,1718767316,1718767729,A100-SXM4-80GB,8,1,64,448,18,413
52518953-78c7-44cc-8037-ed4b452b1a94,slimorca-geo-mtm1-funcfil2-14b,1718767350,1718767759,finished,1718767367,1718767759,A100-SXM4-80GB,8,1,64,448,17,392
e7b275e0-6173-47c3-bbac-f2565b67c7ac,slimorca-geo-mtm1-geotable-nt-14b,1718767402,1718850066,finished,1718767420,1718850066,A100-SXM4-80GB,8,1,64,448,18,82646
353bbc73-a9e7-4524-98b2-f0127d7753cc,geogpt-qwen2-chat-0612dpo-dare-p1,1718767489,1718774206,finished,1718767506,1718774206,A100-SXM4-80GB,8,1,64,448,17,6700
0636e29d-d977-4d84-bcd8-320452b541c4,llama2-5bcpt-0527,1718767508,1718782592,finished,1718767559,1718782592,A100-SXM4-80GB,8,2,64,448,51,15033
9704fa26-0f22-4116-81ee-b57505a53b50,slimorca-geo-mtm1-funcfil2-14b,1718767760,1718776668,finished,1718767778,1718776668,A100-SXM4-80GB,8,1,64,448,18,8890
4aec634b-0b9c-4039-b9be-3729c4d10701,sleep-hengxing,1718767974,1718893020,finished,1718767992,1718893020,A100-SXM4-80GB,8,1,64,896,18,125028
44a203be-3930-472a-b427-f5d281d46d05,qwen2-72b-chat-sft-dpo,1718768019,1718850515,finished,1718768036,1718850515,A100-SXM4-80GB,8,1,64,448,17,82479
a9011327-4e80-4b19-a36f-18adcd769de0,llama-factory-zj-test,1718768081,1718769266,finished,1718768147,1718769266,A100-SXM4-80GB,8,2,64,896,66,1119
388f988f-9574-4349-86c8-826614f04e87,geogpt-upcycle-4x14b-sf4,1718768154,1718768369,finished,1718768204,1718768369,A100-SXM4-80GB,8,16,64,896,50,165
49766f5f-7f56-48bf-8220-99bca8c2fd39,geogpt-upcycle-4x14b-sf4,1718768764,1718769777,finished,1718768833,1718769777,A100-SXM4-80GB,8,16,64,896,69,944
0a04081d-6ebd-4371-9d61-8745e2185896,llama2-add8-del2,1718768859,1718779325,finished,1718768893,1718779325,A100-SXM4-80GB,8,2,64,448,34,10432
bd9fe79b-8ee4-424c-b2f9-b0fc77b1ca81,geogpt-lxz-qwen2-cft-lr1e-6-72b,1718769219,1718778557,finished,1718771509,1718778557,A100-SXM4-80GB,8,32,64,448,2290,7048
103ea58c-9711-448e-a65b-a1bf462c0cf7,geogpt-14b-cpt,1718769256,1718769506,finished,1718769283,1718769506,A100-SXM4-80GB,8,1,64,448,27,223
18e81cf6-0b22-471b-9206-4312ca20ae01,llama-factory-zj-test,1718769684,1718770827,finished,1718769734,1718770827,A100-SXM4-80GB,8,2,64,896,50,1093
1e3ca677-79f9-4ee9-9474-fa13a613c575,geogpt-upcycle-4x14b-sf4,1718769777,1718771539,finished,1718769829,1718771539,A100-SXM4-80GB,8,16,64,896,52,1710
c476ec30-24e5-4b86-bf43-262debe7d9e7,geogept-gate-eval,1718771373,1718771444,finished,1718771391,1718771444,A100-SXM4-80GB,8,1,64,448,18,53
99f7137b-0650-4f59-8ac2-9e9b6dc5e6d8,geogpt-upcycle-4x14b-sf4,1718771539,1718784887,finished,1718778609,1718784887,A100-SXM4-80GB,8,16,64,896,7070,6278
57f72314-c39c-4dd8-9873-0fadd6a27034,llm-trainer,1718773985,1718783983,finished,1718783717,1718783983,A100-SXM4-80GB,8,1,64,448,9732,266
36a7a14e-9c97-40c3-9bba-e640784e4215,geogpt-eval-latest,1718774447,1718783077,finished,1718774466,1718783077,A100-SXM4-80GB,8,1,64,896,19,8611
2684652a-ca29-42e9-875a-13bae7d81f03,geo-base-offline-eval,1718775977,1718777313,finished,1718775994,1718777313,A100-SXM4-80GB,8,1,64,448,17,1319
56f09b39-4d02-4594-90d0-f92d270e4e59,slimorca-geo-mtm1-mt-wild-14b,1718776229,1718850010,finished,1718776248,1718850010,A100-SXM4-80GB,8,1,64,448,19,73762
92d5acd0-55dd-4a59-925b-fad82b256d57,geogept-gate-eval,1718776486,1718777065,finished,1718776504,1718777065,A100-SXM4-80GB,8,1,64,448,18,561
6be3fffd-84d3-40c0-a43b-7aa878bbd2f0,geo-llamapro-5-lr-1e-3,1718777058,1718780095,finished,1718778485,1718780095,A100-SXM4-80GB,8,1,64,448,1427,1610
b4e8dba8-7ebd-4c3e-a20c-50137a4ffb0c,geo-llamapro-3-lr-1e-3,1718777079,1718783623,finished,1718778485,1718783623,A100-SXM4-80GB,8,1,64,448,1406,5138
660fef4c-9a25-4fcb-b3d4-3c2459733ec4,geogept-gate-eval,1718777175,1718778559,finished,1718777194,1718778559,A100-SXM4-80GB,8,1,64,448,19,1365
7a72054d-9eee-4b95-9aab-643e4e4105d3,intent-test-llm,1718777521,1718779124,finished,1718777539,1718779124,A100-SXM4-80GB,8,1,64,448,18,1585
00eddd7b-4a07-42b8-bc26-28f43342c305,geogpt-sft-qwen2-72b-datav08-ep1,1718778313,1718850081,finished,1718778330,1718850081,A100-SXM4-80GB,8,1,64,448,17,71751
b2e58abd-55ec-44dc-874f-3d6a5d5d98f1,sfr-embedding-test,1718778696,1718778766,finished,1718778713,1718778766,A100-SXM4-40GB,1,16,8,32,17,53
63249995-2b84-4baf-be73-ffd7627f9964,geogpt-tableqa-dpo-qwen2-72b-0619-datav0,1718779709,1718779918,finished,1718779780,1718779918,A100-SXM4-80GB,8,4,64,896,71,138
1122c9fc-63fe-4653-9dd9-a11cd24b7bee,sfr-embedding-test,1718779796,1718850784,finished,1718779813,1718850784,A100-SXM4-40GB,1,16,8,32,17,70971
36f9eaab-e7d4-44c2-a6c6-ac380163bc3c,geogpt-tableqa-dpo-qwen2-72b-0619-datav0,1718780093,1718780738,finished,1718780144,1718780738,A100-SXM4-80GB,8,4,64,896,51,594
7d492efb-8514-4060-899c-26cdbef406a0,geogept-gate-eval,1718780402,1718813425,finished,1718780419,1718813425,A100-SXM4-80GB,8,1,64,448,17,33006
4e89d079-916b-448f-926d-aba38f6d727c,geogpt-qwen2-72b-11bcpt-2ep,1718780609,1718781945,finished,1718781737,1718781945,A100-SXM4-80GB,8,50,64,448,1128,208
6ff27e24-e686-45e1-a0d0-d4946b4b5e99,geo-slim-gxy-data07,1718780775,1718797910,finished,1718792735,1718797910,A100-SXM4-40GB,4,1,32,320,11960,5175
6398c1cf-89a1-4d14-b855-e31e70476fb8,geogpt-tableqa-dpo-qwen2-72b-0619-datav0,1718781140,1718781804,finished,1718781192,1718781804,A100-SXM4-80GB,8,4,64,896,52,612
a1024cd5-6a91-402a-bc96-d5eb92af6785,geogpt-smoe-eval,1718781284,1718842605,finished,1718781303,1718842605,A100-SXM4-80GB,8,1,64,448,19,61302
d63ac88a-674f-4702-b419-c42f350b764d,intent-test-llm-all,1718781333,1718782050,finished,1718781351,1718782050,A100-SXM4-80GB,8,1,64,448,18,699
7f1a1303-f277-43ef-8424-bbb062106058,geogpt-qwen2-72b-11bcpt-2ep,1718782023,1718786700,finished,1718782073,1718786700,A100-SXM4-80GB,8,50,64,448,50,4627
dd159a55-588a-4103-b367-1e6c4dfda6bd,geogpt-lxz-qwen2-cft-lr1e-6-72b,1718782144,1718797158,finished,1718784060,1718797158,A100-SXM4-80GB,8,32,64,448,1916,13098
45a56c85-ef36-4d64-a9de-28a2f6e02911,geo-llamapro-5-lr-1e-3,1718782279,1718782417,finished,1718782296,1718782417,A100-SXM4-80GB,8,1,64,448,17,121
5131cccd-a33e-40f5-8a9c-2153117e3819,geogpt-qwen2-chat-0612dpo-dare-p7,1718782555,1718849991,finished,1718782573,1718849991,A100-SXM4-80GB,8,1,64,448,18,67418
f2cd7003-a393-48e9-af56-1d8a13ef4452,lzk-qwen15-7b-scihub-abstract-cpt,1718782614,1718812594,finished,1718782632,1718812594,A100-SXM4-80GB,8,1,64,448,18,29962
a117d0d5-025b-457a-86b2-67eed8c1e233,lzk-qwen15-7b-scihub-abstract-read-compre-cpt,1718782632,1718782736,finished,1718782651,1718782736,A100-SXM4-80GB,8,1,64,448,19,85
d787bac9-ec97-4bd3-a232-71bd27279a31,intent-train,1718782794,1718783056,finished,1718782811,1718783056,A100-SXM4-80GB,8,1,64,448,17,245
6f14fbd5-19f2-4f6f-80b8-ba37ccb2f61f,opencompass-zhongling,1718782911,1718801916,finished,1718799843,1718801916,A100-SXM4-80GB,8,1,64,448,16932,2073
8cecc618-0950-4dee-a46f-02915380f7c0,geogpt-tableqa-dpo-qwen2-72b-0619-datav0,1718782935,1718787868,finished,1718782970,1718787868,A100-SXM4-80GB,8,8,64,896,35,4898
3f560589-69a8-43e4-9625-23c322523318,lzk-qwen15-7b-scihub-abstract-read-compre-cpt,1718783171,1718813295,finished,1718783189,1718813295,A100-SXM4-80GB,8,1,64,448,18,30106
e079b7ec-1bdb-48f1-b4c2-9563ccdf1a24,intent-train,1718783425,1718783680,finished,1718783444,1718783680,A100-SXM4-80GB,8,1,64,448,19,236
0411dde7-98ce-404c-bb3a-43134e8fb0e0,geo-llamapro-5-lr-1e-3,1718783584,1718784850,finished,1718783605,1718784850,A100-SXM4-80GB,8,1,64,448,21,1245
801c1f33-2ff1-4653-b677-615aa686c8bf,geogpt-qwen-benchmark-cw-03,1718783823,1718784261,finished,1718783843,1718784261,A100-SXM4-80GB,8,1,64,896,20,418
83923b8f-decb-4036-bb5e-a0d72cab7261,intent-train,1718783935,1718784207,finished,1718783952,1718784206,A100-SXM4-80GB,8,1,64,448,17,254
7a1ecfc1-f1a0-4d13-9b3f-f8c347042718,qwen2-72b-chat-2,1718784050,1718787880,finished,1718785659,1718787880,A100-SXM4-80GB,8,6,64,448,1609,2221
294a4d17-a0bf-44c8-8824-7860a8510dd6,qwen2-72b-chat,1718784080,1718785641,finished,1718784910,1718785641,A100-SXM4-80GB,8,12,64,448,830,731
b6e8ac17-d7df-4694-a402-6428e8f25e1b,geo-seesaw-sft-code-alpaca-ultra-eval-test,1718784174,1718788000,finished,1718784192,1718788000,A100-SXM4-80GB,8,1,64,896,18,3808
6cb397c9-c4a9-4299-ad63-bf5914401ee5,geo-base-offline-eval,1718784623,1718788164,finished,1718784640,1718788164,A100-SXM4-80GB,8,1,64,448,17,3524
0429f3c9-b9a4-480e-a796-e79e9ba6441d,geo-llamapro-5-lr-1e-3,1718784851,1718784976,finished,1718784868,1718784976,A100-SXM4-80GB,8,1,64,448,17,108
2a3d98a4-4406-43ac-8f3c-82b177646069,geo-llamapro-3,1718785047,1718785186,finished,1718785065,1718785186,A100-SXM4-80GB,8,1,64,448,18,121
26695a7f-f720-4bc8-8120-8e9980ce8e99,geo-llamapro-2,1718785134,1718785276,finished,1718785152,1718785276,A100-SXM4-80GB,8,1,64,448,18,124
c962fee2-82ef-4f39-87f4-c23142583941,geogpt-qwen-benchmark-cw-03,1718785223,1718785543,finished,1718785240,1718785543,A100-SXM4-80GB,8,1,64,896,17,303
f8a812c6-366d-4d02-b2c7-702665a9520c,geogpt-eval-latest,1718785316,1718864692,finished,1718785335,1718864692,A100-SXM4-80GB,8,1,64,896,19,79357
9c1322b7-caeb-465f-84fc-49879b524544,geo-llamapro-4,1718785368,1718785439,finished,1718785386,1718785439,A100-SXM4-80GB,8,1,64,448,18,53
a56d9c4b-b47f-4b98-bc67-5cdb38465c2c,rag-rank,1718785418,1718785539,finished,1718785435,1718785539,A100-SXM4-80GB,8,1,64,448,17,104
ae614d76-9684-4031-ae3a-d807f3b61fd9,geogpt-qwen-benchmark-cw-03,1718785544,1718785685,finished,1718785563,1718785685,A100-SXM4-80GB,8,1,64,896,19,122
07f7ae11-9293-42f7-bdd4-a75965e3ee12,llama-factory-zj-test,1718785559,1718786264,finished,1718785596,1718786264,A100-SXM4-80GB,8,2,64,896,37,668
17e889c5-602f-475d-8bc0-cf105218a038,geo-llamapro-4,1718785563,1718785633,finished,1718785581,1718785633,A100-SXM4-80GB,8,1,64,448,18,52
1648b449-7108-42f0-92b3-00c6a79e4eed,qwen2-72b-chat,1718785710,1718787859,finished,1718785730,1718787859,A100-SXM4-80GB,8,2,64,448,20,2129
66aed167-509f-4e26-99d4-b3a12a984684,rag-rank,1718785752,1718785841,finished,1718785771,1718785841,A100-SXM4-80GB,8,1,64,448,19,70
41d94dbd-38cf-40cc-ab85-7a2bc4a2ffa6,geogpt-qwen-benchmark-cw-03,1718785775,1718785931,finished,1718785793,1718785931,A100-SXM4-80GB,8,1,64,896,18,138
5c24628b-0980-4e54-a2b8-3f5f212d705b,geo-slim-gxy-data07-1,1718785948,1718850025,finished,1718792735,1718850025,A100-SXM4-40GB,1,1,8,32,6787,57290
39e574ba-1b87-4c3a-ae73-d34175d04651,geogpt-qwen-benchmark-cw-03,1718786107,1718786372,finished,1718786125,1718786372,A100-SXM4-80GB,8,1,64,896,18,247
99aa8418-425b-442d-8132-d924cf710dca,intent-train,1718786123,1718786835,finished,1718786141,1718786835,A100-SXM4-80GB,8,1,64,448,18,694
a74ce6f9-d6c3-43ba-b776-3bafd519ba2a,geogpt-llm-moe-expand-tag-loss-only,1718786179,1718786319,finished,1718786198,1718786319,A100-SXM4-80GB,8,1,64,896,19,121
f9a4c0ba-2e83-45b3-ad94-fc7069560a3f,geogpt-qwen-benchmark-cw-03,1718786372,1718786696,finished,1718786390,1718786696,A100-SXM4-80GB,8,1,64,896,18,306
2c6dd5d3-10a2-4d1f-abba-64059adbdfde,llama-factory-zj-test,1718786457,1718788837,finished,1718786509,1718788837,A100-SXM4-80GB,8,2,64,896,52,2328
f4e0b1db-c906-46ff-940a-9929f4a2f231,geogpt-sft-qwen2-72b-datav081-ep1,1718786665,1718849987,finished,1718786695,1718849987,A100-SXM4-80GB,8,1,64,448,30,63292
50d579c7-a0f3-429d-9dca-ede350b2c436,geogpt-qwen-benchmark-cw-03,1718786696,1718788256,finished,1718786713,1718788256,A100-SXM4-80GB,8,1,64,896,17,1543
e7fa08a9-289c-47d9-94b2-4255c7a808db,geogpt-qwen2-72b-11bcpt-2ep,1718786734,1718786989,finished,1718786786,1718786989,A100-SXM4-80GB,8,50,64,448,52,203
606a844b-e0d1-41e9-a722-01789b7a5fb8,geogpt-llm-moe-expand-tag-loss-only,1718786873,1718787669,finished,1718786890,1718787669,A100-SXM4-80GB,8,1,64,896,17,779
154d1b19-5e43-4875-970f-08c89a06dcf5,geogpt-upcycle-4x14b-sf4,1718786914,1718787367,finished,1718786967,1718787367,A100-SXM4-80GB,8,6,64,896,53,400
f22a3459-d9bb-4605-bc15-5ac92b41b294,geogpt-qwen2-72b-11bcpt-2ep,1718787069,1718787316,finished,1718787102,1718787316,A100-SXM4-80GB,8,50,64,448,33,214
60d018cc-6c75-4288-85ef-a7b2714d7904,geogpt-qwen2-72b-11bcpt-2ep,1718787395,1718787471,finished,1718787416,1718787471,A100-SXM4-80GB,8,50,64,448,21,55
1db6c5e0-4c59-453a-ba93-9bf4b0e19738,geogpt-llm-moe-expand-0-5B-baseline,1718787431,1718791293,finished,1718787449,1718791293,A100-SXM4-80GB,8,1,64,896,18,3844
9a4af91e-ec52-4479-97a9-b551a5ce7c6f,geogpt-upcycle-4x14b-sf4,1718787433,1718788750,finished,1718787490,1718788750,A100-SXM4-80GB,8,6,64,896,57,1260
95c9a34f-0355-4bdc-ae17-d2e16d6f9579,geogpt-qwen2-72b-11bcpt-2ep,1718787472,1718929859,finished,1718787513,1718929859,A100-SXM4-80GB,8,50,64,448,41,142346
bee2ab73-6250-4f0b-825c-80bfeb3aec3b,lzk-structllm,1718787589,1718789236,finished,1718787607,1718789236,A100-SXM4-80GB,8,1,64,448,18,1629
1216ccf4-907a-449a-96c3-0c5a04618f45,geogpt-llm-moe-expand-0-5B-soft-routing-5,1718787705,1718792046,finished,1718787722,1718792046,A100-SXM4-80GB,8,1,64,896,17,4324
2ff121c0-ecfb-4e10-a3ed-5ca6b68c729d,geogpt-llm-moe-expand-0-5B-aux-0-1,1718787829,1718792087,finished,1718787848,1718792087,A100-SXM4-80GB,8,1,64,896,19,4239
4e6e19bd-ff19-4966-9fba-10c3f5b8e80d,geogpt-llm-moe-expand-0-5B-tag-0-1,1718787849,1718792067,finished,1718787869,1718792067,A100-SXM4-80GB,8,1,64,896,20,4198
bdbb7dc7-5b26-4828-bb88-92f20a582f13,geogpt-llm-moe-expand-0-5B-aux-0-1-tag-0-1,1718787870,1718792087,finished,1718788018,1718792087,A100-SXM4-80GB,8,1,64,896,148,4069
636776d7-b8fc-4843-a2d2-4703dfd846fc,qwen2-72b-chat,1718787916,1718850378,finished,1718787936,1718850378,A100-SXM4-80GB,8,2,64,448,20,62442
4300c97b-89bc-4a5e-ba0f-b0fdbcaa6caa,qwen2-72b-chat-2,1718787955,1718850464,finished,1718787973,1718850464,A100-SXM4-80GB,8,6,64,448,18,62491
5eab3a82-0054-4014-a1a0-26f23515c621,geo-seesaw-sft-code-alpaca-ultra-eval-test,1718788056,1718788361,finished,1718788274,1718788361,A100-SXM4-80GB,8,1,64,896,218,87
748778af-6ebe-4525-bf2c-5f3a883d79ac,geogpt-llm-moe-expand-0-5B-soft-aux-tag,1718788092,1718792088,finished,1718788379,1718792088,A100-SXM4-80GB,8,1,64,896,287,3709
9528d782-c867-4e27-98b3-eabadf1c4afb,online-doc-extract,1718788160,1718859353,finished,1718788178,1718859353,A100-SXM4-80GB,8,1,64,448,18,71175
0a2dc9df-8031-4910-b3f2-1fabd0875562,geo-slim-try4,1718788218,1718788378,finished,1718788237,1718788378,A100-SXM4-80GB,8,1,64,448,19,141
ae83ebd8-d991-437b-af78-b2d489e09887,geogpt-72b-0326-qa-pre,1718788686,1718859335,finished,1718788705,1718859335,A100-SXM4-80GB,8,1,64,448,19,70630
50d2740a-9cbb-44ab-bba0-4a78aa7d6e3c,opencompass-vllm,1718788737,1718792906,finished,1718792744,1718792906,A100-SXM4-40GB,4,1,32,320,4007,162
7f547baa-dbc7-4637-870f-c86e049124e6,geo-seesaw-sft-code-alpaca-ultra-eval-test,1718788804,1718819702,finished,1718789982,1718819702,A100-SXM4-80GB,8,1,64,896,1178,29720
268d9e5b-de46-4ecb-adca-0562bd45d294,geogpt-qwen2-72b-0612,1718788821,1718850545,finished,1718788840,1718850545,A100-SXM4-80GB,8,1,64,448,19,61705
1a3867a1-8e4a-4f07-a511-c7391349cb7f,llama-factory-zj-test,1718788837,1718791564,finished,1718788889,1718791564,A100-SXM4-80GB,8,2,64,896,52,2675
d318a283-96e9-4fd6-aa3e-54f75f53017e,sun-opencompass,1718788939,1718938404,finished,1718802256,1718938404,A100-SXM4-80GB,8,1,64,896,13317,136148
1e213087-b857-4a3a-81f8-de9e77af346f,rag-rank,1718789153,1718790262,finished,1718789170,1718790262,A100-SXM4-80GB,8,1,64,448,17,1092
2dcb43c7-57c5-47ed-bb19-1ce8c9f5994e,lzk-structllm,1718789236,1718801248,finished,1718789254,1718801248,A100-SXM4-80GB,8,1,64,448,18,11994
e39c80a7-2054-4105-adb3-4a4e44591ca8,rag-rank,1718789680,1718790779,finished,1718789699,1718790779,A100-SXM4-80GB,8,1,64,448,19,1080
85ad5bd6-6a3e-4b08-936f-525d2c5dd795,geogpt-qwen2-chat-dare-p1,1718789879,1718849971,finished,1718789896,1718849971,A100-SXM4-80GB,8,1,64,448,17,60075
6efc6f12-6773-4620-944a-b14dfc244fd6,geo-table-datav041,1718790018,1718885856,finished,1718798708,1718885856,A100-SXM4-40GB,8,1,32,320,8690,87148
4f5134e1-41dc-462b-ad01-9a75bb821d0d,geo-llamapro-4,1718790673,1718791640,finished,1718791568,1718791640,A100-SXM4-80GB,8,1,64,448,895,72
d9d2e56f-216c-43b7-a21f-529e31558f2d,geogpt-btx-eval-latest,1718791255,1718864692,finished,1718791276,1718864692,A100-SXM4-80GB,8,1,64,896,21,73416
19bab055-2b99-41c3-9d83-7fcd6556e0db,geo-router-weight-lr-1e-3,1718791274,1718791385,finished,1718791311,1718791385,A100-SXM4-80GB,8,1,64,448,37,74
746616c7-ecd7-4a51-aae3-335d92bfd1bf,geogpt-llm-moe-expand-0-5B-baseline,1718791293,1718920770,finished,1718791658,1718920770,A100-SXM4-80GB,8,1,64,896,365,129112
157d8fa3-0270-49fb-9fc7-d3bc40262ba4,geo-router-weight-lr-1e-3,1718791385,1718791550,finished,1718791404,1718791550,A100-SXM4-80GB,8,1,64,448,19,146
4e2eb619-edbb-4611-b06a-0b286c38d2b5,llama-factory-zj-test,1718791564,1718792805,finished,1718791601,1718792805,A100-SXM4-80GB,8,2,64,896,37,1204
768a0f26-d1aa-479e-bef2-1116c5ee3fc4,llama3-ntk-91,1718791781,1718791870,finished,1718791799,1718791870,A100-SXM4-80GB,8,1,64,448,18,71
60b1bb14-012b-4b97-b071-9918bc48c7f4,geo-router-weight-lr-1e-3,1718792027,1718792245,finished,1718792088,1718792245,A100-SXM4-80GB,8,1,64,448,61,157
2e4f5098-ee9b-4e21-b970-50a6488e9fe6,geogpt-llm-moe-expand-0-5B-soft-routing-5,1718792046,1718858497,finished,1718792067,1718858497,A100-SXM4-80GB,8,1,64,896,21,66430
cbd6c1b2-4258-401a-985f-574c208f0273,geogpt-llm-moe-expand-0-5B-tag-0-1,1718792068,1718876579,finished,1718792263,1718876579,A100-SXM4-80GB,8,1,64,896,195,84316
801e00a1-a528-4ab3-9ff1-e073e4fe8cf2,geogpt-llm-moe-expand-0-5B-aux-0-1,1718792087,1718916764,finished,1718792109,1718916764,A100-SXM4-80GB,8,1,64,896,22,124655
16c3f3c5-1e5b-4e66-9db3-63924c0d756d,geogpt-llm-moe-expand-0-5B-aux-0-1-tag-0-1,1718792088,1718876876,finished,1718792109,1718876876,A100-SXM4-80GB,8,1,64,896,21,84767
ad671a77-0885-49a4-81b9-0ddd68457412,geogpt-llm-moe-expand-0-5B-soft-aux-tag,1718792088,1718851239,finished,1718792110,1718851239,A100-SXM4-80GB,8,1,64,896,22,59129
539f683a-11f7-4256-b5d6-a12d72b5b5b1,geogpt-upcycling-qwen14b-geoseed-bsexp,1718792092,1718851180,finished,1718792151,1718851180,A100-SXM4-80GB,8,8,64,896,59,59029
fcf18dfa-b4a3-439f-8954-6174de4afeea,llama3-ntk-91,1718792372,1718793374,finished,1718792391,1718793374,A100-SXM4-80GB,8,1,64,448,19,983
04d08d9a-579a-49a5-96d3-2f04800ebddf,llama-factory-zj-test,1718792805,1718793813,finished,1718792841,1718793813,A100-SXM4-80GB,8,2,64,896,36,972
4b2b0df8-b3ae-4b8a-9479-7b5a1058e41a,llama-factory-zj-test,1718793813,1718794311,finished,1718793870,1718794311,A100-SXM4-80GB,8,2,64,896,57,441
3d2a2d85-9466-4b0c-9d9d-b8f10699e0f1,llama3-ntk-91,1718793962,1718797926,finished,1718793981,1718797926,A100-SXM4-80GB,8,1,64,448,19,3945
b8bc85c1-bddb-4c06-b0e3-18af2a6828d4,llama-factory-zj-test,1718794311,1718801217,finished,1718794367,1718801217,A100-SXM4-80GB,8,2,64,896,56,6850
8e59d83f-92a4-4352-a95c-c3cd209ee153,qwen1-5-14b-40bcpt-2ep,1718795400,1718850106,finished,1718795418,1718850106,A100-SXM4-80GB,8,1,64,448,18,54688
f177bc1a-9d3f-4fd4-b458-558c025cb279,opencompass-vllm,1718795551,1718795644,finished,1718795570,1718795644,A100-SXM4-40GB,4,1,32,320,19,74
514f844d-e2f2-455d-a86b-9d892caaf328,geo-moe-data,1718795598,1718795709,finished,1718795617,1718795709,A100-SXM4-80GB,8,1,64,896,19,92
7aa75730-903d-4727-a61c-ceb1a1fe043c,geogpt-qwen2-chat-0612dpo-dare-ties-p17,1718795859,1718850492,finished,1718795878,1718850492,A100-SXM4-80GB,8,1,64,448,19,54614
02be6bfc-488f-4159-b8c0-d939868e47c1,geo-moe-data,1718795913,1718796777,finished,1718795930,1718796777,A100-SXM4-80GB,8,1,64,896,17,847
53663d60-dbac-40d9-adaa-6113518bf640,opencompass-vllm,1718796916,1718798699,finished,1718796935,1718798699,A100-SXM4-40GB,4,1,32,320,19,1764
c135f582-e301-4a64-aaa3-ba553835b5d3,long-context-upsample,1718798167,1718804762,finished,1718798186,1718804762,A100-SXM4-80GB,8,1,64,448,19,6576
c17d4658-6dcc-4b44-9d9e-a4d359dc1f69,geogpt-upcycling-qwen14b-lrexp,1718798492,1718853299,finished,1718798530,1718853299,A100-SXM4-80GB,8,16,64,896,38,54769
ebfbab78-bf67-4527-b66b-eff6dd008393,humaneval-vllm,1718798882,1718799280,finished,1718798903,1718799280,A100-SXM4-80GB,8,1,64,896,21,377
d383241e-88dc-46cc-8acb-9328303fc983,lc-upsample-2dot5b,1718798911,1718804743,finished,1718798934,1718804743,A100-SXM4-80GB,8,1,64,448,23,5809
a45caeab-b760-4837-a1ec-fe93fe1fc0f2,opencompass-buhaili,1718799347,1718802236,finished,1718801935,1718802236,A100-SXM4-80GB,8,1,64,448,2588,301
464750b6-7268-4d1d-8011-207f29806c29,lc-upsample-2dot5b-geo,1718799425,1718799505,finished,1718799444,1718799505,A100-SXM4-80GB,8,1,64,448,19,61
5b21f017-f117-4943-b6ca-f2e52fed79f6,syh-subspace-moe-mathmed,1718799611,1718845870,finished,1718845777,1718845870,A100-SXM4-80GB,8,1,64,448,46166,93
6a37a742-d1eb-47c9-a118-c78259666ba1,humaneval-vllm,1718799669,1718799966,finished,1718799687,1718799966,A100-SXM4-80GB,8,1,64,896,18,279
2093d9f5-0c91-4802-b7db-4c1e9304e572,struxgpt-v2-1-llama2-7b,1718799745,1718884163,finished,1718801269,1718884163,A100-SXM4-80GB,8,1,64,448,1524,82894
51e46f2c-77b1-47ce-9a48-88ab86e390a6,lc-upsample-2dot5b-geo,1718799772,1718800741,finished,1718799791,1718800741,A100-SXM4-80GB,8,1,64,448,19,950
936e2825-34d3-40ae-bade-e2f70442061b,lc-upsample-2dot5b-geo,1718800741,1718866081,finished,1718800760,1718866081,A100-SXM4-80GB,8,1,64,448,19,65321
4e468e4e-a863-406d-bc76-b93e4946a8ef,humaneval-vllm,1718800866,1718811938,finished,1718800885,1718811938,A100-SXM4-80GB,8,1,64,896,19,11053
5a488523-bdfc-48d9-9438-27aff313dd6e,geo-slim-gxy-data08,1718801009,1718801124,finished,1718801049,1718801124,A100-SXM4-80GB,8,2,64,448,40,75
0533d27e-7af8-4a0a-af5f-2c01e4c686e9,geo-slim-gxy-data08,1718801278,1718801355,finished,1718801298,1718801355,A100-SXM4-80GB,8,1,64,448,20,57
cabaf4b2-444d-4620-b26e-60f908bec5ca,geo-slim-gxy-data08,1718801431,1718801622,finished,1718801488,1718801622,A100-SXM4-80GB,8,2,64,448,57,134
c4719f53-0a11-43de-83f7-229f87e1a190,geo-slim-gxy-data08,1718802339,1718802912,finished,1718802416,1718802912,A100-SXM4-80GB,8,2,64,448,77,496
0560f3fb-2e1c-4eb8-a1e3-757e6bc9c336,lzk-structllm,1718802502,1718812861,finished,1718812613,1718812861,A100-SXM4-80GB,8,1,64,448,10111,248
aa8b6b24-eab5-4025-b177-d871043d5f9c,geo-slim-gxy-data08,1718802990,1718853261,finished,1718803009,1718853261,A100-SXM4-80GB,8,1,64,448,19,50252
6de63aac-19c6-4866-9f4d-46149689e731,geo-router-weight-lr-1e-3,1718805670,1718850887,finished,1718845880,1718850887,A100-SXM4-80GB,8,1,64,448,40210,5007
4503267a-892c-4ab6-9a01-5de9273c1679,geo-router-weight-lr-1e-4,1718805714,1718946234,finished,1718813609,1718946234,A100-SXM4-80GB,8,1,64,448,7895,132625
29f379cb-b228-4852-819a-6a5fe15739df,geo-router-weight-full-atten-lr-1e-4,1718805923,1718845750,finished,1718813060,1718845750,A100-SXM4-80GB,8,1,64,448,7137,32690
69b5b231-4040-4757-9e7a-e84a5700e1c1,geogpt-lxz-cft-1-8m-subset-72b,1718808050,1718849914,finished,1718808108,1718849914,A100-SXM4-80GB,8,16,64,448,58,41806
38fc1c63-c85e-4161-966e-e194dac7158b,geo-llamapro-1,1718808285,1718813591,finished,1718813305,1718813591,A100-SXM4-80GB,8,1,64,448,5020,286
5352127b-0aaf-4535-9873-6020c8649b3e,geo-llamapro-2,1718808362,1718850931,finished,1718819721,1718850931,A100-SXM4-80GB,8,1,64,448,11359,31210
1e8cad54-7dd5-4549-838e-b77e6e004c75,geo-llamapro-3,1718808402,1718813041,finished,1718812870,1718813041,A100-SXM4-80GB,8,1,64,448,4468,171
f08912d1-7b4c-4f74-a99d-0e905b5e4caf,geogpt-lxz-cft-tulu-subset-72b,1718808915,1718850933,finished,1718808972,1718850933,A100-SXM4-80GB,8,16,64,448,57,41961
1591b402-c8ea-4db0-9077-ce2cc924ee6c,easycontext-llama3,1718809743,1718810385,finished,1718809820,1718810385,A100-SXM4-80GB,8,2,64,448,77,565
52fb7f18-100c-49ca-b4e1-503f3e4cafeb,easycontext-llama3,1718810535,1718837852,finished,1718825429,1718837852,A100-SXM4-80GB,8,20,64,448,14894,12423
49e56c1e-1a22-476c-ab86-aa80ed015466,geo-base-e16,1718810969,1718838981,finished,1718838059,1718838981,A100-SXM4-80GB,8,32,64,448,27090,922
db348d00-4947-4fa0-9c8d-606b709872e1,geogpt-table-qwen2-72b-datav051,1718815013,1718815203,finished,1718815070,1718815203,A100-SXM4-80GB,8,4,64,896,57,133
a31e4174-32df-4612-9927-0f15ba716685,geogpt-table-qwen2-72b-datav051,1718815448,1718923911,finished,1718815506,1718923911,A100-SXM4-80GB,8,4,64,896,58,108405
03b49945-0c79-4d9f-817b-115c7e7e9e73,llama3-8b-instruct,1718816013,1718850226,finished,1718846222,1718850226,A100-SXM4-40GB,8,1,32,320,30209,4004
9e48e94b-a368-430d-904a-8dbf48073184,llama3-70b-base,1718816033,1718850026,finished,1718846222,1718850026,A100-SXM4-40GB,8,1,32,320,30189,3804
e782e317-06d0-4eb5-a387-5b633a15179c,geo-base-e16,1718842393,1718842620,finished,1718842431,1718842620,A100-SXM4-80GB,8,32,64,448,38,189
2f8b4cf9-effb-4705-a8c3-ef0f096dd9be,geo-base-e16,1718842678,1718843203,finished,1718842715,1718843203,A100-SXM4-80GB,8,32,64,448,37,488
d58a38e4-6eeb-4679-bc62-03d8b4835e7c,geo-base-offline-eval,1718842786,1718843442,finished,1718842805,1718843442,A100-SXM4-80GB,8,1,64,448,19,637
cab39ac0-841e-4140-95f2-d38c45baaeb6,geo-base-e16,1718843203,1718843638,finished,1718843241,1718843638,A100-SXM4-80GB,8,32,64,448,38,397
50f44a80-8a5b-400a-96da-e9b8096f514f,geo-base-offline-eval,1718843442,1718846800,finished,1718843461,1718846800,A100-SXM4-80GB,8,1,64,448,19,3339
d7f81957-1c73-487f-bbc9-fc76ecad2331,geo-base-e16,1718843639,1720141362,finished,1718843695,1720141362,A100-SXM4-80GB,8,32,64,448,56,1297667
f28aac9d-5e0e-4248-81dc-00aa2c5031dc,easycontext-llama3,1718846201,1718846442,finished,1718846275,1718846442,A100-SXM4-80GB,8,2,64,448,74,167
63197dba-0342-4f15-867a-1f293cff3f35,gpt-megatron,1718846983,1718847061,finished,1718847003,1718847061,A100-SXM4-80GB,8,1,64,448,20,58
7435db44-8def-4bfa-a324-79dae3252b24,gpt-megatron,1718847665,1718847836,finished,1718847683,1718847836,A100-SXM4-80GB,8,1,64,448,18,153
72c61e73-9b8a-4178-b878-a3bcefb1eaa1,ruler-eval-0620,1718847912,1718848932,finished,1718847931,1718848932,A100-SXM4-80GB,8,1,64,896,19,1001
78f7c246-7e4e-431e-bbf9-143dceaa1897,gpt-megatron,1718847989,1718848176,finished,1718848008,1718848176,A100-SXM4-80GB,8,1,64,448,19,168
c1bb41eb-2662-4863-8b00-76a9fadbec74,geo-table-merge,1718848275,1718850246,finished,1718848293,1718850246,A100-SXM4-80GB,8,1,64,896,18,1953
618e283f-92ea-4498-89e8-358c5268b82b,ruler-eval-0620,1718848932,1718935837,finished,1718848952,1718935837,A100-SXM4-80GB,8,1,64,896,20,86885
d158e239-52f6-4c97-b932-c96ca156277a,qwen2-72b,1718848983,1718850895,finished,1718849004,1718850895,A100-SXM4-80GB,8,1,64,448,21,1891
dfb80d0d-27ae-45a8-ab35-5adba8bc33d2,easycontext-llama3,1718849522,1718849732,finished,1718849560,1718849732,A100-SXM4-80GB,8,2,64,448,38,172
ce8f9071-d3dc-41f0-80b0-847c8c21fac0,llama3-70b,1718849582,1718852632,finished,1718849602,1718852632,A100-SXM4-40GB,8,1,32,320,20,3030
e48a2098-564f-4bd5-a566-0846b0ac9c09,humaneval-vllm,1718849803,1718850517,finished,1718849822,1718850517,A100-SXM4-80GB,8,1,64,896,19,695
6076739a-08d7-49f5-b1e9-dca2aeb365bc,llama3-8b-instruct,1718849862,1718851209,finished,1718849883,1718851209,A100-SXM4-40GB,8,1,32,320,21,1326
e3b8db74-932a-485c-9569-51b39dd0fd1a,llama3-70b-base,1718849882,1718850875,finished,1718849902,1718850875,A100-SXM4-40GB,8,1,32,320,20,973
c6430dfa-1751-425f-8dd2-584983d00741,geogpt-llama3-70b-0521,1718850034,1718850940,finished,1718850054,1718850940,A100-SXM4-40GB,8,1,32,320,20,886
3ef3a0b0-3ef6-4fd7-88d4-d1abaeba0d19,llama3-70b-base,1718850100,1718850863,finished,1718850119,1718850863,A100-SXM4-40GB,8,1,32,320,19,744
90dfcb50-5a31-4fed-b282-b85ecefc7006,geo-table-datav05-lora-5e-5,1718850190,1718851890,finished,1718850208,1718851890,A100-SXM4-80GB,8,1,64,896,18,1682
a455eb50-a448-4f40-96a2-a02ecbe6ea20,llama3-8b-instruct,1718850316,1718850906,finished,1718850335,1718850906,A100-SXM4-80GB,8,1,64,448,19,571
56eb0e19-7660-4cde-82ec-b669d17bcfa5,llama3-70b-instruct,1718850410,1718850918,finished,1718850430,1718850918,A100-SXM4-40GB,8,1,32,320,20,488
de918293-53c5-4237-90fc-7c331c1ba991,citysora-modelv4-webvid-cele-laion-joint-65-256,1718850581,1718850908,finished,1718850650,1718850908,A100-SXM4-80GB,8,5,64,896,69,258
073fb7a8-a5f2-45a6-b085-f4af9d65416a,geo-router-weight-full-atten-lr-1e-4,1718850805,1718857667,finished,1718850909,1718857667,A100-SXM4-80GB,8,1,64,448,104,6758
b99837ce-bb99-47bf-8651-16f09be87b2b,geo-router-softmax-lr-1e-4,1718850807,1718852271,finished,1718852125,1718852271,A100-SXM4-80GB,8,1,64,448,1318,146
f4607b40-ffa0-4f30-afc7-618d98117cc9,geo-router-sigmoid-lr-1e-4,1718850810,1718854917,finished,1718852955,1718854917,A100-SXM4-80GB,8,1,64,448,2145,1962
242fd2fd-c745-4571-a007-e558a0e7ed5a,geo-router-block-weight,1718850811,1718851606,finished,1718851428,1718851606,A100-SXM4-80GB,8,1,64,448,617,178
3da8749f-93f8-4bf9-b64d-b7f4757ee488,geo-llamapro-5-lr-1e-3,1718850817,1718852106,finished,1718851606,1718852106,A100-SXM4-80GB,8,1,64,448,789,500
08a5c95e-5d8c-484e-9a20-f46c58191e79,geogpt-prompt-tuning-tg-train-all,1718850838,1718891654,finished,1718853001,1718891654,A100-SXM4-80GB,8,1,64,448,2163,38653
c0a43018-0bfd-40e1-a481-8750eb3b75d6,lzk-structllm,1718850847,1718852945,finished,1718852887,1718852945,A100-SXM4-80GB,8,1,64,448,2040,58
17718e6e-fda1-48c1-af49-bbd78873e784,llama3-70b-base,1718850863,1718850952,finished,1718850885,1718850952,A100-SXM4-40GB,8,1,32,320,22,67
12c4a7ca-d53a-4914-a1a1-e4e21d0738d6,geo-router-weight-lr-1e-3,1718850887,1718851410,finished,1718851260,1718851410,A100-SXM4-80GB,8,1,64,448,373,150
ac62c4d4-c00e-40e8-a778-fca1b13375bd,citysora-modelv4-webvid-cele-laion-joint-65-256,1718850908,1718961295,finished,1718850953,1718961295,A100-SXM4-80GB,8,5,64,896,45,110342
a6b49e11-a356-4b35-9a62-70bcd52f3f4f,llama3-70b-instruct,1718850918,1719028000,finished,1718850940,1719028000,A100-SXM4-40GB,8,1,32,320,22,177060
07c74343-d5ab-47bf-89ab-d2c5d1504521,geo-llamapro-2,1718850932,1718851578,finished,1718850956,1718851578,A100-SXM4-80GB,8,1,64,448,24,622
78c6ceb3-2670-4699-a375-e7127d600d24,geogpt-lxz-cft-tulu-subset-72b,1718850933,1718851518,finished,1718850976,1718851518,A100-SXM4-80GB,8,16,64,448,43,542
78c49ceb-d833-4ab0-a972-179b4cbe307e,geogpt-llama3-70b-0521,1718850940,1718864574,finished,1718850964,1718864574,A100-SXM4-40GB,8,1,32,320,24,13610
2c680a4a-153b-4a2d-bf4a-9fe23fbe60f7,qwen2-72b,1718850964,1718956973,finished,1718850989,1718956973,A100-SXM4-80GB,8,1,64,448,25,105984
2bb5887b-a736-454c-98a6-4fa48e0a6587,pix2text-lt,1718851001,1721372031,finished,1718851021,1721372031,A100-SXM4-40GB,1,1,8,32,20,2521010
d9b86869-a54a-47cc-baba-be5d0da5b0a8,geogpt-upcycling-qwen14b-geoseed-bsexp,1718851180,1718864712,finished,1718851241,1718864712,A100-SXM4-80GB,8,8,64,896,61,13471
7ec2c950-abb1-4735-adff-4bafc5ab9fe9,geogpt-llm-moe-expand-0-5B-soft-aux-tag,1718851239,1718858516,finished,1718851625,1718858516,A100-SXM4-80GB,8,1,64,896,386,6891
687c9b02-707c-4fc6-a129-f610963a2e0b,qwen2-72b-instruct,1718851447,1718886393,finished,1718851469,1718886393,A100-SXM4-80GB,8,1,64,896,22,34924
425d2b65-b810-433a-8bd9-e42a6612458a,geogpt-qwen2-72b-0612,1718851468,1718853010,finished,1718851493,1718853010,A100-SXM4-40GB,8,1,32,320,25,1517
683de4c4-86d8-420e-b8ce-f74276d37605,geo-llamapro-5,1718851474,1718876759,finished,1718852898,1718876759,A100-SXM4-80GB,8,2,64,448,1424,23861
27e391f9-87b6-4a1a-aa30-cf2f0145a1d3,rag-rank,1718851512,1718851676,finished,1718851531,1718851676,A100-SXM4-80GB,8,1,64,448,19,145
103ade56-7cc4-4f92-aafd-cc740776762b,geogpt-lxz-cft-tulu-subset-72b,1718851518,1718854454,finished,1718851580,1718854454,A100-SXM4-80GB,8,16,64,448,62,2874
1379d64f-cb96-4239-a1a3-2bc56961d534,tq-embedding-1,1718851543,1720450569,finished,1718851566,1720450569,A100-SXM4-40GB,1,8,8,32,23,1599003
257423a2-f2d6-4341-b151-4669aab20ef4,geo-llamapro-1,1718851577,1718864689,finished,1718852917,1718864689,A100-SXM4-80GB,8,2,64,448,1340,11772
4f454394-2b3e-4c76-9cda-520a0b6c6757,intent-test,1718851737,1718851869,finished,1718851756,1718851869,A100-SXM4-80GB,8,1,64,448,19,113
44a573ad-06c7-40d9-bd84-4f9c1d2b300a,geogpt-sft-qwen2-72b-datav081-ep1,1718851833,1718875203,finished,1718851853,1718875203,A100-SXM4-80GB,8,1,64,448,20,23350
2cddd92a-5a25-47a7-a305-92e21efc3d61,intent-test,1718851926,1718852031,finished,1718851944,1718852031,A100-SXM4-80GB,8,1,64,448,18,87
83e6ad7d-5593-4375-9071-d13f85712f67,intent-test,1718852084,1718852197,finished,1718852103,1718852197,A100-SXM4-80GB,8,1,64,448,19,94
82ed5702-771b-4c31-99cc-997557a3fc75,geo-llamapro-5-lr-1e-3,1718852106,1718878531,finished,1718852898,1718878531,A100-SXM4-80GB,8,2,64,448,792,25633
77ac90eb-eeb3-456e-9729-340ddc21e9b3,geo-router-block-weight,1718852145,1718864731,finished,1718852288,1718864731,A100-SXM4-80GB,8,1,64,448,143,12443
86bb3245-ec71-483a-a1f0-cc481d6d696a,geo-router-weight-lr-1e-3,1718852164,1718864688,finished,1718852876,1718864688,A100-SXM4-80GB,8,1,64,448,712,11812
70ab59ef-1a73-4a67-81fd-645fb746bdfa,intent-test,1718852268,1718852429,finished,1718852286,1718852429,A100-SXM4-80GB,8,1,64,448,18,143
9b9dfbcf-d8ec-4b70-8c3c-c1cdad015328,rag-rank,1718852392,1718852536,finished,1718852410,1718852536,A100-SXM4-80GB,8,1,64,448,18,126
99693b42-3998-432a-aaca-a3d8e4d135d9,geo-seesaw-ssft-2-math-64head-20kdata,1718852396,1718864730,finished,1718852876,1718864730,A100-SXM4-80GB,8,1,64,896,480,11854
12889d9a-d151-4f1c-a6ce-330b5d161e6e,rag-rank,1718852445,1718853468,finished,1718852463,1718853468,A100-SXM4-80GB,8,1,64,448,18,1005
35604101-122a-4e14-8f51-1c5128fc143c,geo-router-softmax-lr-1e-4,1718852521,1718857667,finished,1718852876,1718857667,A100-SXM4-80GB,8,1,64,448,355,4791
54ffff16-d462-42f2-bd0b-069e6accff9f,Llama-3-70B,1718852539,1718956962,finished,1718852560,1718956962,A100-SXM4-40GB,8,1,32,320,21,104402
d867a74f-0097-4b5c-824d-94fbfaecaeae,geo-slim-gxy-doublegeneral,1718852579,1718853509,finished,1718852598,1718853509,A100-SXM4-40GB,4,1,32,320,19,911
d4d2fdea-8b1f-43ec-83c0-927b3ff16790,geogpt-llama3-cpt1ep-sft-jsonl,1718853034,1718854457,finished,1718853090,1718854457,A100-SXM4-80GB,8,48,64,448,56,1367
7716f649-edf4-4ca3-bfa5-9d4562f5c1ea,geogpt-qwen2-72b-0612,1718853066,1718854526,finished,1718853085,1718854526,A100-SXM4-40GB,8,2,32,320,19,1441
64904c40-658b-473d-90fb-ebadeb8ce661,intent-test,1718853450,1718853506,finished,1718853469,1718853506,A100-SXM4-40GB,8,1,32,320,19,37
d6854407-c752-4788-a25d-392acbd00821,geo-slim-gxy-wogeneral,1718853509,1718854151,finished,1718853528,1718854151,A100-SXM4-40GB,4,1,32,320,19,623
a9f92b2f-56f3-433c-85ca-e0c5186d1308,intent-test,1718853526,1718853724,finished,1718853544,1718853724,A100-SXM4-80GB,8,1,64,448,18,180
f5208ca1-1ce5-4916-b315-693db52da364,geo-slim-gxy-data07,1718853669,1718854114,finished,1718853688,1718854114,A100-SXM4-40GB,4,1,32,320,19,426
1c80b09b-8588-4eaf-9fcf-199acf4249b5,llama3-8b-instruct,1718853706,1718936843,finished,1718853725,1718936843,A100-SXM4-40GB,8,1,32,320,19,83118
3b3e0789-d21c-4f4e-b84c-7a829ff3d278,intent-test,1718853724,1718853880,finished,1718853741,1718853880,A100-SXM4-80GB,8,1,64,448,17,139
414acef7-ca3e-44e8-9cff-6ea98b087471,geo-slim-gxy-data07-1,1718853935,1718854220,finished,1718853954,1718854220,A100-SXM4-40GB,1,1,8,32,19,266
3ea44f11-2732-45a0-b02e-4e27102e1e9e,lzk-structllm,1718853980,1718871835,finished,1718854944,1718871835,A100-SXM4-80GB,8,1,64,448,964,16891
c341ba59-f6bc-40f5-af83-758c06f7ef3a,geo-slim-gxy-data07-1,1718854325,1718875684,finished,1718854345,1718875684,A100-SXM4-40GB,1,1,8,32,20,21339
3b62e4af-61d9-4de0-bb15-91cb2718dd95,geo-slim-gxy-data07,1718854345,1718854606,finished,1718854364,1718854606,A100-SXM4-40GB,4,1,32,320,19,242
023a0e34-0e77-472c-a3d0-1831804bdd49,geo-slim-gxy-wogeneral,1718854364,1718856256,finished,1718854393,1718856256,A100-SXM4-40GB,4,1,32,320,29,1863
0c65554c-cfca-4de3-ac15-55c45f44f004,geogpt-llama3-cpt1ep-sft-jsonl,1718854457,1718855277,finished,1718854494,1718855277,A100-SXM4-80GB,8,48,64,448,37,783
dd5c1e9d-66fa-4585-a04b-a196618ae685,geogpt-lxz-cft-tulu-subset-72b,1718854491,1718896376,finished,1718854567,1718896376,A100-SXM4-80GB,8,16,64,448,76,41809
0ce5a864-1f60-4601-b2ff-8ef9433dc4f6,geogpt-qwen2-72b-0612,1718854643,1718859923,finished,1718854661,1718859923,A100-SXM4-40GB,8,1,32,320,18,5262
5730c73e-8feb-45d3-8019-3562d7767d48,geo-router-sigmoid-lr-1e-4,1718854917,1718887011,finished,1718857686,1718887011,A100-SXM4-80GB,8,1,64,448,2769,29325
b8250584-a862-46e0-b1ff-5aacce37244f,geogept-gate-eval,1718854977,1718855954,finished,1718854995,1718855954,A100-SXM4-80GB,8,1,64,448,18,959
ef751b27-f76f-4644-946b-b6f8cfd87579,easycontext-llama3,1718855079,1718855610,finished,1718855133,1718855610,A100-SXM4-80GB,8,2,64,448,54,477
a8fa0783-541b-46b1-af6e-6142fd713809,geogpt-llama3-cpt1ep-sft-jsonl,1718855277,1718855600,finished,1718855331,1718855600,A100-SXM4-80GB,8,48,64,448,54,269
39dbc785-ea17-4222-92ab-20aad7cc7567,geogpt-lxz-cft-1-8m-subset-times2-72b,1718855462,1718900070,finished,1718855516,1718900070,A100-SXM4-80GB,8,20,64,448,54,44554
b597e123-6102-4126-90dc-c2f002fbfeb3,rag-tq-embedding-mistral,1718855591,1718855728,finished,1718855610,1718855728,A100-SXM4-40GB,4,1,32,320,19,118
cdbac9b8-5d8d-4fea-b828-cbf923771833,geogpt-llama3-cpt1ep-sft-jsonl,1718855737,1718856064,finished,1718855791,1718856064,A100-SXM4-80GB,8,48,64,448,54,273
702331fa-de97-4a16-b8a6-579595713ad0,easycontext-llama3,1718856001,1718856945,finished,1718856075,1718856945,A100-SXM4-80GB,8,2,64,448,74,870
0ef83df4-cdb3-404d-8fa6-eb07564357a5,llama2-7b-chat-hf,1718856156,1718857117,finished,1718856174,1718857117,A100-SXM4-80GB,8,1,64,448,18,943
1d5da6f3-aeec-4f32-9581-c0e6c32261e9,version2,1718856193,1718857099,finished,1718856224,1718857099,A100-SXM4-80GB,8,1,64,448,31,875
5810fe63-48df-4d0d-847d-0a4d2fcd53f0,geogept-gate-eval,1718856224,1718856373,finished,1718856262,1718856373,A100-SXM4-80GB,8,1,64,448,38,111
0ee6d64e-a5e8-4d38-bf75-8004dd8cda3b,geogpt-llama3-cpt1ep-sft-jsonl,1718856224,1718857271,finished,1718856280,1718857271,A100-SXM4-80GB,8,48,64,448,56,991
52b9b676-c415-454c-8c9a-0907015acf22,geogept-gate-eval,1718856718,1718857044,finished,1718856935,1718857044,A100-SXM4-80GB,8,1,64,448,217,109
1eb40a21-1b4e-4885-b483-945df8a34bd1,version2,1718857432,1718863626,finished,1718857451,1718863626,A100-SXM4-80GB,8,1,64,448,19,6175
a5abc912-10ae-4109-bad3-7df2cc9458b1,llama2-7b-chat-hf,1718857469,1718863626,finished,1718857488,1718863626,A100-SXM4-80GB,8,1,64,448,19,6138
7db46a20-8e6b-495c-be47-8e065f7c0396,geogpt-llm-moe-expand-0-5B-soft-routing-24,1718857723,1718858516,finished,1718857742,1718858516,A100-SXM4-80GB,8,1,64,896,19,774
fbddffea-7511-4c82-adb9-4b7e6839778b,easycontext-llama3,1718858305,1718858991,finished,1718858360,1718858991,A100-SXM4-80GB,8,2,64,448,55,631
ab139c61-2c7e-4967-9c94-ec6dfe1ce4c1,geogpt-llm-moe-expand-0-5B-soft-routing-5,1718858497,1718943891,finished,1718858516,1718943891,A100-SXM4-80GB,8,1,64,896,19,85375
110ca407-02d4-49b8-be82-9657014c9413,geogpt-llm-moe-expand-0-5B-soft-aux-tag,1718858516,1718877014,finished,1718858536,1718877014,A100-SXM4-80GB,8,1,64,896,20,18478
4e24b8e6-20ec-4ca6-831c-bcebf243f68b,geogpt-llm-moe-expand-0-5B-soft-routing-24,1718858516,1718943851,finished,1718858536,1718943851,A100-SXM4-80GB,8,1,64,896,20,85315
1c6b2c33-f8db-4364-8c6f-e266a00b043b,easycontext-llama3,1718859137,1718859700,finished,1718859173,1718859700,A100-SXM4-80GB,8,2,64,448,36,527
05efc003-b413-45f8-91e1-f2d6108c34fa,geogpt-72b-0326-qa-pre,1718859371,1718932270,finished,1718859389,1718932270,A100-SXM4-80GB,8,1,64,448,18,72881
be61d6aa-0580-4841-876b-26f19ef21ed3,online-doc-extract,1718859407,1718932327,finished,1718859425,1718932327,A100-SXM4-80GB,8,1,64,448,18,72902
ab8fd09b-ec18-4f4a-8cc8-3955cd8cb365,sleep-xiaodian,1718859680,1718869763,finished,1718859698,1718869763,A100-SXM4-80GB,8,1,64,448,18,10065
5a84756a-96b9-4e1b-bfc3-bc57ae42d515,geogpt-qwen2-72b-0612,1718859978,1720765180,finished,1718859998,1720765180,A100-SXM4-40GB,8,1,32,320,20,1905182
322c0556-9744-4437-97a1-114527b77d50,easycontext-llama3,1718860014,1718860818,finished,1718860069,1718860818,A100-SXM4-80GB,8,2,64,448,55,749
40769f1d-61d4-4a64-bc6a-e0f3696bc67c,easycontext-llama3,1718861343,1718862196,finished,1718861379,1718862196,A100-SXM4-80GB,8,2,64,448,36,817
ffdcfc9e-5df2-45df-97fa-498aa5ecadb3,easycontext-llama3,1718862196,1718862375,finished,1718862250,1718862375,A100-SXM4-80GB,8,2,64,448,54,125
4b7f7978-c7bc-481f-8d8e-ac85dbf9db7a,easycontext-llama3,1718862578,1718863968,finished,1718862633,1718863968,A100-SXM4-80GB,8,8,64,448,55,1335
73123dff-e63d-40be-8f3b-e46a8dd1a185,intent-test,1718863546,1718863729,finished,1718863565,1718863729,A100-SXM4-80GB,8,1,64,448,19,164
33069548-0dc1-44b0-a4b5-4a3472817292,easycontext-llama3,1718863968,1718865243,finished,1718864025,1718865243,A100-SXM4-80GB,8,8,64,448,57,1218
9e29b6c6-030e-4ebd-94eb-0be0506cd3a8,llama2-add8-del2,1718864125,1718864199,finished,1718864144,1718864199,A100-SXM4-80GB,8,1,64,448,19,55
4db45e21-9b90-4bf8-b15c-755e47c5910e,llama2-add8-del2,1718864292,1718864736,finished,1718864312,1718864736,A100-SXM4-80GB,8,1,64,448,20,424
f8337627-9c2c-41ec-908d-7337e45ea57c,geogpt-14b-cpt,1718864349,1718865579,finished,1718864386,1718865579,A100-SXM4-80GB,8,2,64,448,37,1193
31215878-703b-40fe-ada3-39a64ebfa200,llama2-5bcpt-0527,1718864534,1718864694,finished,1718864552,1718864694,A100-SXM4-80GB,8,1,64,448,18,142
6ddb40c5-d706-47ba-b193-1ed3eb413d73,opencompass-buhaili,1718864594,1718880911,finished,1718877734,1718880911,A100-SXM4-80GB,8,1,64,448,13140,3177
63bd7446-07f4-4b85-b925-b345d8b9eac4,geo-llamapro-2,1718864620,1718876719,finished,1718864773,1718876719,A100-SXM4-80GB,8,2,64,448,153,11946
40e4d3a1-5c3e-46ed-be9c-8538d1e22eb9,geogpt-llama3-cpt1ep-sft-jsonl,1718864633,1718865536,finished,1718864778,1718865536,A100-SXM4-80GB,8,48,64,448,145,758
ec0c68c4-368d-4ea0-a64a-b2fde321ca21,geogpt-prompt-tuning-tg-infer1,1718864639,1718871646,finished,1718870734,1718871646,A100-SXM4-80GB,8,1,64,448,6095,912
470544aa-3b50-48f5-9d4d-91a5ca2df5be,geogpt-prompt-training-reft-hcx,1718864641,1718865865,finished,1718865797,1718865865,A100-SXM4-80GB,8,1,64,448,1156,68
1c0d4fcc-4b65-43c3-a693-0728aaab91a0,syh-subspace-moe-mathmed,1718864647,1718865797,finished,1718864719,1718865797,A100-SXM4-80GB,8,1,64,448,72,1078
040ad108-4de4-41bc-a251-dc093d19ffd5,geo-router-weight-lr-1e-3,1718864689,1718864873,finished,1718864709,1718864873,A100-SXM4-80GB,8,1,64,448,20,164
ae7982cb-7bc6-4b6d-9959-9f2a6a610a22,geo-llamapro-1,1718864689,1718876759,finished,1718864935,1718876759,A100-SXM4-80GB,8,2,64,448,246,11824
78980bc7-d41c-4836-9f7f-217cf478b1fc,llama2-5bcpt-0527,1718864694,1718868356,finished,1718864715,1718868356,A100-SXM4-80GB,8,1,64,448,21,3641
e685f4dd-d9a9-425d-be67-5ff4e85718f2,geo-router-block-weight,1718864731,1718886586,finished,1718866403,1718886586,A100-SXM4-80GB,8,1,64,448,1672,20183
bb906aab-cc7c-4cf1-a97b-40a18c3e91cd,geo-seesaw-ssft-2-math-64head-20kdata,1718864731,1718864873,finished,1718864752,1718864873,A100-SXM4-80GB,8,1,64,896,21,121
7563882d-0cde-4faa-9577-456a837cfc91,geogpt-llama3-70b-0521,1718864881,1718866285,finished,1718864904,1718866285,A100-SXM4-40GB,8,1,32,320,23,1381
29073c4e-ed70-4c12-a831-dd3150e9165b,llama2-add8-del2,1718864979,1718865417,finished,1718864998,1718865417,A100-SXM4-80GB,8,1,64,448,19,419
c25f452f-4222-4778-92c9-364ac9c20610,easycontext-llama3,1718865243,1718867287,finished,1718865283,1718867287,A100-SXM4-80GB,8,8,64,448,40,2004
14c1a890-43ef-49ae-b793-55084874c653,reranker-hn,1718865325,1718867208,finished,1718865449,1718867208,A100-SXM4-80GB,8,1,64,448,124,1759
a8a30fbf-5d2f-4d76-bbab-e5de381a22a6,geogpt-llama3-cpt1ep-sft-jsonl,1718865537,1718865884,finished,1718865600,1718865884,A100-SXM4-80GB,8,2,64,448,63,284
4d5a4693-17c9-47b3-af74-10eb40dfe46f,geo-router-weight-lr-1e-3,1718865615,1718866108,finished,1718865810,1718866108,A100-SXM4-80GB,8,1,64,448,195,298
7247c0ef-0977-4783-a06a-901b1551adab,geogpt-leonardo-shieh-dsj,1718865774,1718867366,finished,1718865888,1718867366,A100-SXM4-80GB,8,1,64,448,114,1478
f0dc3355-27f9-42c6-af65-5ce80d22dafa,geogpt-llama3-cpt1ep-sft-jsonl,1718865884,1718934619,finished,1718865928,1718934619,A100-SXM4-80GB,8,48,64,448,44,68691
2a18b340-3fcc-4867-b9f3-a8ad472078dd,syh-subspace-moe-mathmed,1718866073,1718866392,finished,1718866139,1718866392,A100-SXM4-80GB,8,1,64,448,66,253
e05041e4-97ea-4d39-9cd8-913448251473,llama2-add8-del2,1718866091,1718866519,finished,1718866113,1718866519,A100-SXM4-80GB,8,1,64,448,22,406
c0ebb5d4-db4e-42ea-b2a6-d5e9499c5940,rag-tq-embedding-mistral,1718866103,1718866313,finished,1718866124,1718866313,A100-SXM4-80GB,8,1,64,448,21,189
4afc1f60-51c1-4c7c-ab1e-a4da1b7cdea8,geogpt-llama3-70b-0521,1718866434,1718964978,finished,1718866458,1718964978,A100-SXM4-40GB,8,1,32,320,24,98520
f54980d3-5d86-40f0-b255-c911381689ae,gpt-megatron,1718866593,1718866676,finished,1718866614,1718866676,A100-SXM4-80GB,8,1,64,448,21,62
7f5cdf21-50f3-4868-b885-d5438b355f3d,geogpt-upcycling-qwen14b-geoseed-bsexp,1718866787,1718939596,finished,1718867312,1718939596,A100-SXM4-80GB,8,8,64,896,525,72284
8ea7fddb-d995-46f8-9744-3f9e5de3ad59,gpt-megatron,1718866818,1718873184,finished,1718866837,1718873184,A100-SXM4-80GB,8,1,64,448,19,6347
7591f8ae-0337-4345-8b01-71200051841b,intent-train,1718866975,1718867091,finished,1718866995,1718867091,A100-SXM4-80GB,8,1,64,448,20,96
ddae3087-68d3-40e1-9467-3cd3663c9f84,intent-train,1718867228,1718867592,finished,1718867249,1718867592,A100-SXM4-80GB,8,1,64,448,21,343
a1c3d7bb-b9b3-4ddf-9933-2e6a74b877c1,easycontext-llama3,1718867287,1718870472,finished,1718867329,1718870472,A100-SXM4-80GB,8,8,64,448,42,3143
260d52dc-37d6-4954-8f5e-b662834033b2,geogpt-leonardo-shieh-dsj,1718867366,1718870714,finished,1718867426,1718870714,A100-SXM4-80GB,8,1,64,448,60,3288
08a4aef9-6129-45bc-ac5e-75849dd1dad6,intent-test,1718868191,1718868368,finished,1718868211,1718868368,A100-SXM4-40GB,8,1,32,320,20,157
2125fc7e-2918-4bca-acd6-939c01dc9735,syh-subspace-moe-mathmed,1718868340,1718872132,finished,1718871855,1718872132,A100-SXM4-80GB,8,1,64,448,3515,277
eeaa13a0-1a9f-4a22-9965-53ac67e21ef7,rag-rank,1718868385,1718870548,finished,1718870396,1718870548,A100-SXM4-80GB,8,1,64,448,2011,152
335eb5e3-a9bc-416e-ac85-14659a7f4a79,intent-test,1718868462,1718868615,finished,1718868482,1718868615,A100-SXM4-40GB,8,1,32,320,20,133
34fc3177-140d-46a6-aafd-b16c63e9b962,llama2-5bcpt-0527,1718868756,1718875151,finished,1718870386,1718875151,A100-SXM4-80GB,8,1,64,448,1630,4765
25187614-cd2d-4488-ad42-e4ea9a87ea03,lc-upsample-2dot5b-geo,1718868941,1718870357,finished,1718870015,1718870357,A100-SXM4-80GB,8,1,64,448,1074,342
63790879-008f-4b89-aa06-08bd5c734042,geogept-qwen1-5-7b-llamapro40-s3-10bcpt,1718869122,1718871583,finished,1718870518,1718871583,A100-SXM4-80GB,8,2,64,448,1396,1065
2dca0354-33b9-4ff0-b25d-78277b677632,intent-train-llm-gpt-le2e-6,1718869326,1718871331,finished,1718870397,1718871331,A100-SXM4-80GB,8,1,64,448,1071,934
f5438c55-bed4-4110-92fb-7c9eedda3a3d,geo-seesaw-sft-code-alpaca-ultra-eval-test,1718869789,1719145881,finished,1718872142,1719145881,A100-SXM4-80GB,8,1,64,896,2353,273739
f29d0e24-14a8-4586-908e-9c8b054749c9,geogpt-leonardo-shieh-dsj,1718870714,1719382855,finished,1718891815,1719382855,A100-SXM4-80GB,8,1,64,448,21101,491040
ccdc0a92-4f69-4135-934d-24f70192f870,lc-upsample-2dot5b-geo,1718870892,1718871406,finished,1718870910,1718871406,A100-SXM4-80GB,8,1,64,448,18,496
bae81561-b813-47bb-b920-52bf4239e45d,geogpt-leonardo-shieh-dsj3,1718871062,1719302208,finished,1718871666,1719302208,A100-SXM4-80GB,8,1,64,448,604,430542
b7b75ffc-5329-4e17-9ba5-abff15f73a4e,rag-rank,1718871199,1718871311,finished,1718871218,1718871311,A100-SXM4-80GB,8,1,64,448,19,93
58cdcbff-8bc4-48f6-a8b5-8b74ea3b813c,easycontext-llama3,1718871386,1718872647,finished,1718871424,1718872647,A100-SXM4-80GB,8,4,64,448,38,1223
86e5022d-bce8-48c0-9833-2639ea04005a,intent-train,1718871464,1718871576,finished,1718871483,1718871576,A100-SXM4-80GB,8,1,64,448,19,93
52f65316-3d17-4fed-97d8-e4ea8e489148,geogept-qwen1-5-7b-llamapro40-s3-10bcpt,1718871583,1718871776,finished,1718871622,1718871776,A100-SXM4-80GB,8,2,64,448,39,154
284efc94-6f57-485a-9306-919bdc321064,intent-train,1718871732,1718872214,finished,1718871750,1718872214,A100-SXM4-80GB,8,1,64,448,18,464
6d6d4a54-9878-4e62-acac-43e65053beaf,geogept-gate-eval,1718871757,1718871869,finished,1718871776,1718871869,A100-SXM4-80GB,8,1,64,448,19,93
cec189cf-7804-4b41-bbb3-fe12d46b51a1,rag-rank,1718872251,1718872401,finished,1718872269,1718872401,A100-SXM4-80GB,8,1,64,448,18,132
c983ea1d-567a-4b5a-a08d-95224e84108e,geogept-gate-eval,1718872278,1718872391,finished,1718872297,1718872391,A100-SXM4-80GB,8,1,64,448,19,94
c9bcbd36-2204-4f55-841c-35930173e97f,sfr-embedding,1718872609,1718874134,finished,1718872628,1718874134,A100-SXM4-40GB,1,8,8,32,19,1506
9195f8da-3ec5-44c6-b9ae-98bd946db27f,opencompass-vllm,1718872772,1718873083,finished,1718872793,1718873083,A100-SXM4-40GB,4,1,32,320,21,290
c94ca55c-0c53-40c3-8c3a-97e9be4018cc,easycontext-llama3,1718872819,1718873319,finished,1718872857,1718873319,A100-SXM4-80GB,8,2,64,448,38,462
eb4948ae-5db6-4774-9271-bd9f3f0ee4f0,geogept-gate-eval,1718872943,1718873653,finished,1718872962,1718873653,A100-SXM4-80GB,8,1,64,448,19,691
331bbb8e-5462-40df-84b7-524ea3f2d7c9,geogpt-eval-latest,1718873038,1718908296,finished,1718873058,1718908296,A100-SXM4-80GB,8,1,64,896,20,35238
4867e915-1eb3-430f-8df9-b282b5e8862b,gpt-megatron,1718873298,1718874459,finished,1718873318,1718874459,A100-SXM4-80GB,8,1,64,448,20,1141
a4d6a589-c6db-4d4c-ac4a-2585811d3412,syh-subspace-moe-mathmed,1718873352,1718876885,finished,1718876605,1718876885,A100-SXM4-80GB,8,1,64,448,3253,280
5d66c45f-f3e6-473a-9dde-66bfb0eb09a3,easycontext-llama3,1718873398,1718882981,finished,1718873455,1718882981,A100-SXM4-80GB,8,4,64,448,57,9526
93f87062-de19-4721-8d35-aeeb7fa5edb4,intent-train-llm-gpt-le2e-6,1718873531,1718873999,finished,1718873646,1718873999,A100-SXM4-80GB,8,1,64,448,115,353
f8ce6213-7266-4553-83f0-6bc0180db4da,rag-tq-embedding-mistral,1718873644,1719146839,finished,1718873663,1719146839,A100-SXM4-80GB,8,1,64,448,19,273176
43126b79-45df-41ce-9d13-535ce3db37da,eval-control-group-fumingxiang,1718873937,1718884412,finished,1718873956,1718884412,A100-SXM4-80GB,8,1,64,448,19,10456
072f411b-7d2f-43d8-811e-b0175cdb4aa5,geogept-gate-eval,1718874142,1718874272,finished,1718874160,1718874272,A100-SXM4-80GB,8,1,64,448,18,112
a715d981-f2b4-4c4a-9ca4-05b131a4bb47,geogept-gate-eval,1718874601,1718875381,finished,1718874639,1718875381,A100-SXM4-80GB,8,1,64,448,38,742
0dee357a-9a5e-4b42-8afa-1fc27919e2fd,gpt-megatron,1718874611,1718880018,finished,1718874629,1718880018,A100-SXM4-80GB,8,1,64,448,18,5389
40622b9f-7a70-4fed-9f43-1dfeee4084a9,sfr-embedding,1718874858,1718876651,finished,1718874877,1718876651,A100-SXM4-40GB,1,8,8,32,19,1774
3169069b-226f-4d92-a230-f85dfa26ac83,rag-rank,1718874970,1718875317,finished,1718875162,1718875317,A100-SXM4-80GB,8,1,64,448,192,155
f5c479c1-ba5b-4781-899a-438eca4f7df7,geogept-qwen1-5-7b-llamapro40-s3-10bcpt,1718875286,1718875419,finished,1718875307,1718875419,A100-SXM4-80GB,8,1,64,448,21,112
2c2598be-a0ba-4a68-81fe-9a74123ed61d,geogpt-sft-qwen2-72b-datav081-ep1,1718875301,1718897218,finished,1718875376,1718897218,A100-SXM4-80GB,8,1,64,448,75,21842
14d8c54c-7f7b-4d05-9333-9f1049e9e443,llama2-add8-del2,1718875306,1718875438,finished,1718875325,1718875438,A100-SXM4-80GB,8,1,64,448,19,113
5f84ad8f-bcf5-4401-9298-1068e7502921,llama2-5bcpt-0527,1718875459,1718881208,finished,1718875477,1718881208,A100-SXM4-80GB,8,1,64,448,18,5731
bf944c64-9575-4ebf-b678-e604675c3604,opencompass-vllm,1718875614,1718876168,finished,1718875634,1718876168,A100-SXM4-40GB,4,1,32,320,20,534
dd3c8da4-6d55-4a44-ac32-5014b8b444b5,geo-slim-gxy-doublegeneral,1718875664,1718876954,finished,1718875684,1718876954,A100-SXM4-40GB,4,1,32,320,20,1270
9864c6ac-f262-4686-9935-c706ee873154,llama-factory-zj-test,1718875682,1718877143,finished,1718876613,1718877143,A100-SXM4-80GB,8,2,64,896,931,530
173cfdeb-18a6-4df0-8cf3-334176f0bb44,geo-slim-gxy-data07-1,1718875741,1718876934,finished,1718875761,1718876934,A100-SXM4-40GB,1,1,8,32,20,1173
f0eebd64-9608-43f4-b6b6-c772191aba8d,geogept-gate-eval,1718875785,1718875917,finished,1718875804,1718875917,A100-SXM4-80GB,8,1,64,448,19,113
a1dfd1f7-cf89-4cbb-9a7a-7ed03bb53b17,geogept-qwen1-5-7b-llamapro40-s3-10bcpt,1718875956,1718876070,finished,1718875975,1718876070,A100-SXM4-80GB,8,1,64,448,19,95
6e32ad9e-892b-4fc7-bee5-1258555fc14f,opencompass-vllm,1718876471,1718878883,finished,1718876490,1718878883,A100-SXM4-40GB,4,1,32,320,19,2393
a65c9680-44c8-4fd8-b05e-909fa0331954,geogpt-llm-moe-expand-0-5B-tag-0-1,1718876579,1718894103,finished,1718876739,1718894103,A100-SXM4-80GB,8,1,64,896,160,17364
e4abd1c8-da98-42b3-bff9-ad73f7d58ed0,geogpt-llm-moe-expand-0-5B-aux-0-1-tag-0-1,1718876876,1718897389,finished,1718876897,1718897389,A100-SXM4-80GB,8,1,64,896,21,20492
b8f96967-b389-4c60-b5ba-cf8f57b00fe3,geogpt-llm-moe-expand-0-5B-soft-aux-tag,1718877014,1718897411,finished,1718877034,1718897411,A100-SXM4-80GB,8,1,64,896,20,20377
d7c08352-f5b9-498f-af38-32d876f4c8c6,geo-slim-gxy-doublegeneral,1718877033,1718877817,finished,1718877054,1718877817,A100-SXM4-40GB,1,1,8,32,21,763
043bd6c4-3bfd-4132-b998-925a2d8757df,geo-llamapro-3,1718877061,1718897478,finished,1718877127,1718897478,A100-SXM4-80GB,8,2,64,448,66,20351
3af4906f-9b95-4fbe-87cf-c879e4a305ea,geo-llamapro-5,1718877062,1718897500,finished,1718877127,1718897500,A100-SXM4-80GB,8,2,64,448,65,20373
069ea04d-2eee-449d-86e7-750f61a102f2,syh-subspace-moe-mathmed,1718877072,1718877848,finished,1718877094,1718877848,A100-SXM4-80GB,8,1,64,448,22,754
263051f2-a92d-41eb-9f5f-3de81845e163,geo-llamapro-4,1718877084,1718897477,finished,1718877899,1718897477,A100-SXM4-80GB,8,2,64,448,815,19578
3c510e92-ad24-4364-a8ad-9f5837609f53,llama-factory-zj-test,1718877143,1718877452,finished,1718877202,1718877452,A100-SXM4-80GB,8,2,64,896,59,250
eaaa13f1-7e69-4d23-8f23-bb57cdb71841,geogpt-prompt-training-reft-hcx2,1718877155,1718891796,finished,1718891671,1718891796,A100-SXM4-80GB,8,1,64,896,14516,125
dd07f0de-ecd7-4111-a74f-a61690c6da3d,llama-factory-zj-test,1718877603,1718878030,finished,1718877660,1718878030,A100-SXM4-80GB,8,2,64,896,57,370
d1b487c0-1d40-455e-a3eb-ab8f3b5d63ba,sleeping-buhaili,1718877715,1718891351,finished,1718881025,1718891351,A100-SXM4-80GB,8,1,64,448,3310,10326
6022c948-eb1b-4e73-874f-068a2c315083,geogept-gate-eval,1718877725,1718878478,finished,1718877745,1718878478,A100-SXM4-80GB,8,1,64,448,20,733
db266a33-b9c6-4082-b50a-eb3201687c38,slimorca-geo-mtm1-mt-wild-14b,1718877822,1719004838,finished,1718877842,1719004838,A100-SXM4-80GB,8,1,64,448,20,126996
ceb3a287-d5b2-47ae-81d8-4320b09f6cdb,syh-subspace-moe-mathmed,1718877848,1718881155,finished,1718878560,1718881155,A100-SXM4-80GB,8,1,64,448,712,2595
0bbcce9c-28f2-4e72-aece-7e66c1148aea,geogpt-dairui-model-merge-exp-2,1718877880,1718878647,finished,1718878549,1718878647,A100-SXM4-80GB,8,1,64,896,669,98
c1387f05-db00-49d3-b344-0b206a04cd60,sfr-embedding,1718877914,1718900167,finished,1718877933,1718900167,A100-SXM4-80GB,8,1,64,448,19,22234
51d61e2a-7bff-48ef-a6e8-84e8c3a32f93,sfr-embedding-test,1718878029,1718878107,finished,1718878050,1718878107,A100-SXM4-80GB,8,1,64,448,21,57
ac4b5a15-e81b-410b-a3b3-865df888ab9c,geo-slim-gxy-qwen2-7b,1718878033,1718897363,finished,1718878053,1718897363,A100-SXM4-40GB,1,1,8,32,20,19310
e7aa4c83-a078-41a3-9733-e34fa0449160,llama-factory-zj-test,1718878222,1718878834,finished,1718878336,1718878834,A100-SXM4-80GB,8,2,64,896,114,498
d6fe6315-cd5d-4b75-89c7-5dd9332e947f,sfr-embedding-test,1718878259,1718878355,finished,1718878279,1718878355,A100-SXM4-80GB,8,1,64,448,20,76
fc5d74c4-5073-4915-acbe-4ed10f16f42b,geo-router-softmax-lr-1e-4,1718878551,1718886247,finished,1718878667,1718886247,A100-SXM4-80GB,8,1,64,448,116,7580
3e790f54-424d-4262-ae05-4ed9425e497e,opencompass-vllm,1718878883,1718880830,finished,1718878903,1718880830,A100-SXM4-40GB,4,1,32,320,20,1927
719c94d4-96a2-4561-b060-3786e5fd7c31,llama-factory-zj-test,1718878984,1718879439,finished,1718879043,1718879439,A100-SXM4-80GB,8,2,64,896,59,396
2117bbeb-9ffc-48b1-97c0-e838f3b0d524,geogpt-dairui-model-merge-exp-2,1718879009,1718965522,finished,1718881166,1718965522,A100-SXM4-80GB,8,1,64,896,2157,84356
ad678a62-6338-4923-91b6-e337d33d2c93,llama-factory-zj-test,1718880038,1718881028,finished,1718880095,1718881028,A100-SXM4-80GB,8,2,64,896,57,933
e65836fc-3017-4216-ad27-669f262c23a5,opencompass-tianwenbucket,1718880642,1718882225,finished,1718880719,1718882225,A100-SXM4-80GB,8,1,64,448,77,1506
85ecee50-2a35-43d1-8b94-1be7d05a4c8c,geogpt-tableqa-dpo-qwen2-72b-0619-datav0,1718880666,1718888796,finished,1718883757,1718888796,A100-SXM4-80GB,8,8,64,896,3091,5039
5683d08b-d12c-42d7-8b83-c4f9899d6136,opencompass-vllm,1718880831,1718881174,finished,1718880848,1718881174,A100-SXM4-40GB,4,1,32,320,17,326
f2a8df14-ff89-4bae-8154-21ed26309a83,opencompass-vllm,1718881403,1718882426,finished,1718881423,1718882426,A100-SXM4-40GB,4,1,32,320,20,1003
4586e5ac-7d8d-4bbd-88a9-86cff2f74018,syh-subspace-moe-math,1718881611,1718885059,finished,1718884183,1718885059,A100-SXM4-80GB,8,1,64,448,2572,876
7b179648-71e3-4487-9eca-b71e3d80da6f,geogpt-tableqa-dpo-qwen2-72b-0620-datav0,1718881910,1718883567,finished,1718882963,1718883567,A100-SXM4-80GB,8,4,64,896,1053,604
f3cee84f-f5dc-443e-8e3d-9dbe86cbba45,opencompass-tianwenbucket,1718882225,1718935912,finished,1718882244,1718935912,A100-SXM4-80GB,8,1,64,448,19,53668
b957b9c2-545e-44ea-a251-81a626c02d54,llama-factory-zj-test,1718882772,1718883735,finished,1718882810,1718883735,A100-SXM4-80GB,8,2,64,896,38,925
4d4c64e0-dba5-4f76-a974-246c9c7529d3,easycontext-llama3,1718883018,1718883433,finished,1718883075,1718883433,A100-SXM4-80GB,8,4,64,448,57,358
5b27b95a-f267-4a10-b517-98f13a269f62,geogept-qwen1-5-7b-llamapro40-s3-10bcpt,1718883143,1718932624,finished,1718883442,1718932624,A100-SXM4-80GB,8,1,64,448,299,49182
f80e2fde-5de0-480c-9d8b-80f03e11ddfb,ls2,1718883564,1718890863,finished,1718883583,1718890863,A100-SXM4-80GB,8,1,64,896,19,7280
4eacb315-7cf7-4421-8275-d0d6fc51b2e5,llama-factory-zj-test,1718883833,1718890718,finished,1718888866,1718890718,A100-SXM4-80GB,8,2,64,896,5033,1852
411c1411-1471-48e8-848f-4ffb292d0b90,geo-llamapro-1,1718885205,1718897456,finished,1718886450,1718897456,A100-SXM4-80GB,8,2,64,448,1245,11006
41a9fb05-3591-4271-9443-9462e612810a,llm-trainer,1718885330,1718959566,finished,1718885348,1718959566,A100-SXM4-80GB,8,1,64,448,18,74218
eae89d73-cc98-43a2-8304-dc01e0fa6bd0,geogpt-dairui-model-merge-exp-1,1718885858,1718886395,finished,1718885877,1718886395,A100-SXM4-80GB,8,1,64,896,19,518
31b566f2-b1a0-44d8-9036-c2c504c57c43,geogpt-dairui-model-merge-exp-1,1718886507,1718889573,finished,1718886604,1718889573,A100-SXM4-80GB,8,1,64,896,97,2969
4c4ddeee-9caa-4646-a5b0-47bba4129d3d,geogpt-dairui-eval-code,1718886566,1718889681,finished,1718889591,1718889681,A100-SXM4-80GB,8,1,64,896,3025,90
44e5d7cd-f261-45f7-9e0c-f9d6ad51e22a,geo-router-weight-full-atten-lr-1e-4,1718886880,1718946193,finished,1718887029,1718946193,A100-SXM4-80GB,8,1,64,448,149,59164
b6f4c244-185c-4078-a947-fbe44598d345,geo-router-weight-lr-1e-3,1718886991,1718897412,finished,1718889699,1718897412,A100-SXM4-80GB,8,1,64,448,2708,7713
dd1f40c3-873e-4d9b-82af-ecc8f567cdfa,geogpt-dpo-qwen2-72b-datav0-ep1,1718888011,1718888760,finished,1718888030,1718888760,A100-SXM4-40GB,4,1,32,320,19,730
04438e08-6bbc-4c6b-9de7-9b7c8fa2813f,llama2-5bcpt-0527,1718888370,1718894216,finished,1718888388,1718894216,A100-SXM4-80GB,8,1,64,448,18,5828
ef4c479b-ca01-44fb-979b-7538c60376b1,llama-factory-zj-test,1718890718,1718893592,finished,1718890771,1718893592,A100-SXM4-80GB,8,8,64,896,53,2821
d763084d-adaa-4cba-92a1-80e16bd00efb,easycontext-llama3,1718891950,1718894704,finished,1718893629,1718894704,A100-SXM4-80GB,8,4,64,448,1679,1075
11a4b0dc-b42e-48d1-98a5-9956e0782a0e,geogpt-llm-moe-expand-0-5B-tag-0-1,1718894103,1718897410,finished,1718894121,1718897410,A100-SXM4-80GB,8,1,64,896,18,3289
679a0034-58c6-484e-a8c2-a1a743f59e34,geogpt-lxz-cft-new-mix-72b,1718894407,1718938785,finished,1718896414,1718938785,A100-SXM4-80GB,8,16,64,448,2007,42371
1c3747cc-768a-4113-9189-7336ffe1f89d,easycontext-llama3,1718894704,1718894882,finished,1718894739,1718894882,A100-SXM4-80GB,8,2,64,448,35,143
68c3f99c-6e1b-4bac-a438-86b5c9786377,llama2-5bcpt-0527,1718894926,1718895034,finished,1718894943,1718895034,A100-SXM4-80GB,8,1,64,448,17,91
bbee9539-b34b-43a8-af99-5ef5cdc03131,llama2-5bcpt-0527,1718895320,1718895429,finished,1718895338,1718895429,A100-SXM4-80GB,8,1,64,448,18,91
a20316b0-3c01-420c-ba4f-69569d45e470,easycontext-llama3,1718895563,1718895760,finished,1718895618,1718895760,A100-SXM4-80GB,8,2,64,448,55,142
e765379c-3c28-4f43-b0cf-0802c9c636a4,llama2-5bcpt-0527,1718895893,1718900889,finished,1718895910,1718900889,A100-SXM4-80GB,8,1,64,448,17,4979
b05683c6-bf9c-446e-8750-0bf0bc219c3b,llama2-add8-del2,1718895928,1718906595,finished,1718895964,1718906595,A100-SXM4-80GB,8,2,64,448,36,10631
e3c6c6c7-f7ab-48ec-be04-64319ea17287,easycontext-llama3,1718896101,1718896298,finished,1718896154,1718896298,A100-SXM4-80GB,8,4,64,448,53,144
1f4edc5c-6964-4a03-9673-de63a875912d,opencompass-vllm,1718896383,1718897172,finished,1718896401,1718897172,A100-SXM4-40GB,4,1,32,320,18,771
9a3fb870-377b-4a1a-ae9e-8e058d28fe86,easycontext-llama3,1718896580,1718897717,finished,1718896635,1718897717,A100-SXM4-80GB,8,4,64,448,55,1082
e0084b2b-3b47-4ed3-800e-59372b46f285,slimorca-geo-mtm1-geotable-nt-14b,1718897221,1718897391,finished,1718897240,1718897391,A100-SXM4-80GB,8,1,64,448,19,151
47ec6aec-8635-408e-a010-33dbf39c9327,llama-factory-zj-test,1718897303,1718933332,finished,1718900142,1718933332,A100-SXM4-80GB,8,20,64,896,2839,33190
ad18165c-5a5b-4028-b41a-6917cc756213,geogpt-dairui-eval-code,1718897316,1718916879,finished,1718916783,1718916879,A100-SXM4-80GB,8,1,64,896,19467,96
d3b0f7a3-3d77-4a10-9166-49c7906b49ac,geo-router-block-weight,1718897325,1718946234,finished,1718916898,1718946234,A100-SXM4-80GB,8,1,64,448,19573,29336
5225e975-4ca8-4748-965a-29bd9656fa9c,geo-llamapro-2,1718897328,1719145968,finished,1718897521,1719145968,A100-SXM4-80GB,8,2,64,448,193,248447
968a0fb8-91c3-4482-80ca-2f56f2167f79,geogpt-upcycle-4x14b-baseline,1718897336,1718930334,finished,1718929914,1718930334,A100-SXM4-80GB,8,16,64,896,32578,420
77d6644e-3006-423b-b0c1-5ee4f7c81f35,lzk-structllm,1718897351,1718945299,finished,1718897445,1718945299,A100-SXM4-80GB,8,1,64,448,94,47854
f1116216-f9e5-42b5-b647-24cc9807e6c8,geo-slim-gxy-qwen2-7b,1718897363,1718961603,finished,1718897388,1718961603,A100-SXM4-40GB,1,1,8,32,25,64215
248fd94b-e5e6-42fd-8001-3263f3e10a43,geogpt-llm-moe-expand-0-5B-aux-0-1-tag-0-1,1718897389,1719145860,finished,1718897411,1719145860,A100-SXM4-80GB,8,1,64,896,22,248449
4ef38734-6056-4f5d-9908-f1d119012d7b,slimorca-geo-mtm1-geotable-nt-14b,1718897391,1719004860,finished,1718897416,1719004860,A100-SXM4-80GB,8,1,64,448,25,107444
f80d8bb2-37cd-42c5-a891-18418fc73ae0,geogpt-llm-moe-expand-0-5B-tag-0-1,1718897411,1719145968,finished,1718920789,1719145968,A100-SXM4-80GB,8,1,64,896,23378,225179
150ad3e5-663e-4bbd-9462-76293bcf7427,geo-router-weight-lr-1e-3,1718897412,1718947717,finished,1718897434,1718947717,A100-SXM4-80GB,8,1,64,448,22,50283
3e10b40a-08de-4569-99f2-4fbcfc3fa815,geogpt-llm-moe-expand-0-5B-soft-aux-tag,1718897412,1719145054,finished,1718897433,1719145054,A100-SXM4-80GB,8,1,64,896,21,247621
8355db79-263e-49df-967c-b5e1860870b8,geo-llamapro-1,1718897456,1718927924,finished,1718897562,1718927924,A100-SXM4-80GB,8,2,64,448,106,30362
799bbaef-6b71-4a21-9429-052ab4144458,geo-llamapro-4,1718897477,1719145611,finished,1718897542,1719145611,A100-SXM4-80GB,8,2,64,448,65,248069
4a1ca8b6-a680-43d7-bafb-ff01ed54d2d9,geo-llamapro-3,1718897478,1719145903,finished,1718897542,1719145903,A100-SXM4-80GB,8,2,64,448,64,248361
fdd3963f-2a23-46dc-85cb-1f7be80c5c47,geo-llamapro-5,1718897501,1719145968,finished,1718927981,1719145968,A100-SXM4-80GB,8,2,64,448,30480,217987
4e056ca7-0e6f-455e-9e8b-223814f99450,easycontext-llama3,1718897833,1718898939,finished,1718897890,1718898939,A100-SXM4-80GB,8,4,64,448,57,1049
57728b97-c905-485d-a1d8-b10cd34aeee0,opencompass-vllm,1718898464,1718898832,finished,1718898484,1718898832,A100-SXM4-40GB,4,1,32,320,20,348
aae76181-3357-442a-a27c-f1bbf2b893f2,easycontext-llama3,1718898939,1718899655,finished,1718898997,1718899655,A100-SXM4-80GB,8,4,64,448,58,658
b5f424ea-8b84-4130-ade3-340ff175328b,sfr-embedding-test,1718898996,1718899113,finished,1718899016,1718899113,A100-SXM4-80GB,8,1,64,448,20,97
f5374e52-8d58-476d-8671-0828c8e406ad,sfr-embedding-test,1718899250,1718900265,finished,1718899270,1718900265,A100-SXM4-80GB,8,1,64,448,20,995
d8fa63c4-cc29-41fd-8855-d3996c611802,easycontext-llama3,1718899829,1718900557,finished,1718899887,1718900557,A100-SXM4-80GB,8,4,64,448,58,670
37098234-06a7-4e04-9b69-1e3957ed6add,sfr-embedding,1718900167,1718904519,finished,1718900187,1718904519,A100-SXM4-80GB,8,1,64,448,20,4332
96776b00-b5e4-424b-b29d-2ebd67c4e85f,sfr-embedding-test,1718900265,1718900400,finished,1718900285,1718900400,A100-SXM4-80GB,8,1,64,448,20,115
5a63ef78-6f8b-4765-9046-97f5aeede695,easycontext-llama3,1718900708,1718901379,finished,1718900767,1718901379,A100-SXM4-80GB,8,4,64,448,59,612
f962c7c1-6755-43e7-abbf-8b217d7727db,easycontext-llama3,1718901593,1718902424,finished,1718901632,1718902424,A100-SXM4-80GB,8,8,64,448,39,792
48482988-2695-44e1-bec9-08b5174ee735,easycontext-llama3,1718902558,1718903040,finished,1718902616,1718903040,A100-SXM4-80GB,8,4,64,448,58,424
b5034404-8b17-492b-84e7-d51c5189100a,lc-upsample-2dot5b-geo,1718903059,1718945421,finished,1718903079,1718945421,A100-SXM4-80GB,8,1,64,448,20,42342
6fb094fe-e011-4fbe-81f8-570d1dc3191f,easycontext-llama3,1718903137,1718904251,finished,1718903195,1718904251,A100-SXM4-80GB,8,4,64,448,58,1056
6c91f5c5-6bfb-470c-923e-38e02861fd4e,sfr-embedding-test,1718903254,1718903482,finished,1718903272,1718903482,A100-SXM4-80GB,8,1,64,448,18,210
fcfab304-eebf-4b67-a940-1381a4c88fb1,sfr-embedding-test,1718903482,1718904538,finished,1718903502,1718904538,A100-SXM4-80GB,8,1,64,448,20,1036
fab95a40-5c57-42b7-8604-806991355165,easycontext-llama3,1718904252,1718907281,finished,1718906663,1718907281,A100-SXM4-80GB,8,8,64,448,2411,618
a471efd0-af68-4157-8085-6fbda36535d2,sfr-embedding,1718904519,1718904733,finished,1718904539,1718904733,A100-SXM4-80GB,8,1,64,448,20,194
7f1c9f3a-2873-4e73-8592-9481ac2b30be,sfr-embedding-test,1718904538,1718904753,finished,1718904558,1718904753,A100-SXM4-80GB,8,1,64,448,20,195
98768de3-fbb3-47df-ad4d-76afe608a3e4,sfr-embedding,1718904733,1718904928,finished,1718904754,1718904928,A100-SXM4-80GB,8,1,64,448,21,174
1ab7954f-ab2e-4983-bc37-4ecd0733dabf,sfr-embedding-test,1718904753,1718904948,finished,1718904772,1718904948,A100-SXM4-80GB,8,1,64,448,19,176
d5a502c9-31ee-4629-ae64-a4960fe8c168,sfr-embedding,1718904928,1718912825,finished,1718904948,1718912825,A100-SXM4-80GB,8,1,64,448,20,7877
6c41481c-2db7-43c1-9a21-1468a767394e,sfr-embedding-test,1718904948,1718909129,finished,1718904968,1718909129,A100-SXM4-80GB,8,1,64,448,20,4161
525f2c45-865d-4b91-b198-4e04cc7a4851,easycontext-llama3,1718920059,1718920348,finished,1718920117,1718920348,A100-SXM4-80GB,8,8,64,448,58,231
dddd48f9-46d1-459a-9d3a-d0120d7138ae,easycontext-llama3,1718920443,1718930432,finished,1718920500,1718930432,A100-SXM4-80GB,8,4,64,448,57,9932
46133ebd-f059-4f92-accb-a3aa9a3dae62,geogpt-qwen2-72b-11bcpt-2ep,1718929952,1718946791,finished,1718930401,1718946791,A100-SXM4-80GB,8,50,64,448,449,16390
d1a9e3ed-95c4-4b83-82ea-48685572d670,gpt-megatron,1718930192,1718939707,finished,1718930211,1718939707,A100-SXM4-80GB,8,1,64,448,19,9496
4267abd6-87d4-4fe5-8044-a3ba60e05df1,geogpt-upcycle-4x14b-baseline,1718930397,1718933094,finished,1718932680,1718933094,A100-SXM4-80GB,8,16,64,896,2283,414
ceb3cab9-448b-4500-bb65-f1c3b01a00da,easycontext-llama3,1718930432,1718935656,finished,1718935061,1718935656,A100-SXM4-80GB,8,40,64,448,4629,595
deb5bee2-30c3-48bc-8cf2-e616f6194263,geogpt-72b-0326-qa-pre,1718932327,1718932652,finished,1718932346,1718932652,A100-SXM4-80GB,8,1,64,448,19,306
f9975b3b-cd2e-44d5-ab50-7378a3266fe5,online-doc-extract,1718932384,1718932576,finished,1718932403,1718932576,A100-SXM4-80GB,8,1,64,448,19,173
f0e7e04d-5489-46ab-aa74-a376688e1439,geogpt-72b-0326-qa-pre,1718932832,1719751731,finished,1718932852,1719751731,A100-SXM4-80GB,8,1,64,448,20,818879
b9b6f9f4-1674-48bd-920f-2c0c9e7c0b23,online-doc-extract,1718933087,1719752044,finished,1718933105,1719752044,A100-SXM4-80GB,8,1,64,448,18,818939
a1f2e2c7-0b82-49c0-87aa-22605494ef92,geogpt-upcycle-4x14b-baseline,1718933153,1718933417,finished,1718933193,1718933417,A100-SXM4-80GB,8,16,64,896,40,224
25de5136-bb8d-4b4d-ac2e-dd89f4cbe1d4,llama-factory-zj-test,1718933332,1718935193,finished,1718933409,1718935193,A100-SXM4-80GB,8,10,64,896,77,1784
84bdeca4-3463-439c-88e6-da56326defb8,geogpt-upcycle-4x14b-baseline,1718933480,1718933946,finished,1718933538,1718933946,A100-SXM4-80GB,8,16,64,896,58,408
39018b73-ff3e-41ed-9c9b-10eb5221c824,geogpt-lxz-cft-1-8m-subset-times2-72b,1718933700,1718938447,finished,1718934008,1718938447,A100-SXM4-80GB,8,20,64,448,308,4439
67b32c27-2cd9-4873-b6f5-14d6f9a42a36,geogpt-upcycle-4x14b-baseline,1718934016,1718934985,finished,1718934674,1718934985,A100-SXM4-80GB,8,16,64,896,658,311
c6b9a205-b770-4297-8613-791c281e833e,reranker2-inference,1718934485,1718936821,finished,1718934505,1718936821,A100-SXM4-40GB,1,1,8,32,20,2316
4ac3262e-91c6-4eef-adeb-58c894472c04,reranker-base,1718934524,1718944473,finished,1718934543,1718944473,A100-SXM4-40GB,1,1,8,32,19,9930
66be9ed6-2127-43dc-9b72-dd98b13dee28,opencompass-vllm,1718934641,1718935480,finished,1718934661,1718935480,A100-SXM4-40GB,4,1,32,320,20,819
71e45ee8-26c5-431c-9b38-2e94d8cf582a,geogpt-upcycle-4x14b-baseline,1718935047,1718935590,finished,1718935237,1718935590,A100-SXM4-80GB,8,16,64,896,190,353
aeeaaff5-0651-4e95-8e7e-716282e1de3d,llama-factory-zj-test,1718935193,1718938780,finished,1718935676,1718938780,A100-SXM4-80GB,8,10,64,896,483,3104
ef35b253-415b-4560-94ea-27b77ec6467b,rag-rank,1718935411,1718935993,finished,1718935430,1718935993,A100-SXM4-80GB,8,1,64,448,19,563
1cae3db2-6354-4b0e-8b00-ab717fc6e06f,opencompass-vllm,1718935480,1718935851,finished,1718935500,1718935851,A100-SXM4-40GB,4,1,32,320,20,351
dbe8c7eb-82ed-4e86-8fd7-e6df094762cd,sfr-embedding-test,1718935622,1718935780,finished,1718935656,1718935780,A100-SXM4-80GB,8,1,64,448,34,124
ed1f4584-8485-41eb-b937-25da3222dc1c,slimorca-geo-mtm1-funcfil2-14b,1718935636,1719004793,finished,1718935661,1719004793,A100-SXM4-80GB,8,1,64,448,25,69132
6c024b7b-2724-4306-abf5-13ef7793ab78,geogpt-upcycle-4x14b-baseline,1718935662,1718935979,finished,1718935703,1718935979,A100-SXM4-80GB,8,16,64,896,41,276
3d261389-9ffe-4190-9cf3-346d0758e730,easycontext-llama3,1718935800,1718936465,finished,1718936037,1718936465,A100-SXM4-80GB,8,40,64,448,237,428
1a4a898d-6596-4c2d-a864-c76e191f33ed,ruler-eval-0620,1718935837,1719146219,finished,1718935857,1719146219,A100-SXM4-80GB,8,1,64,896,20,210362
02f2f29d-7801-4193-a8de-8aabcfbb443e,opencompass-vllm,1718935851,1718936238,finished,1718935869,1718936238,A100-SXM4-40GB,4,1,32,320,18,369
de8964e2-8141-4a22-a4af-623e5c98b6a9,geogept-qwen1-5-7b-llamapro40-s3-10bcpt,1718935904,1718936255,finished,1718935923,1718936255,A100-SXM4-80GB,8,1,64,448,19,332
b25cb892-819e-4c42-9374-620faf8374f7,opencompass-tianwenbucket,1718935912,1718966085,finished,1718935931,1718966085,A100-SXM4-80GB,8,1,64,448,19,30154
7f472e62-db0c-41c5-bbf7-302401cf09b7,sfr-embedding-test,1718935974,1718936131,finished,1718935994,1718936131,A100-SXM4-80GB,8,1,64,448,20,137
c5acef37-5718-4ec5-9918-4d4f8060f881,geogpt-upcycle-4x14b-baseline,1718936058,1718936808,finished,1718936510,1718936808,A100-SXM4-80GB,8,16,64,896,452,298
840c5996-6de7-40c9-8ae5-530b357ea196,opencompass-vllm,1718936239,1718936964,finished,1718936258,1718936964,A100-SXM4-40GB,4,1,32,320,19,706
e609a752-7f9b-4bd7-9421-4c4e0d1cb066,rag-rank,1718936744,1718936907,finished,1718936764,1718936907,A100-SXM4-80GB,8,1,64,448,20,143
7236c315-4e76-4955-a327-dc4bdafd056e,geogpt-eval-latest,1718936871,1718938560,finished,1718936892,1718938560,A100-SXM4-80GB,8,1,64,896,21,1668
1dceda62-f701-4738-b6ca-4068ac8666d4,geogpt-upcycle-4x14b-baseline,1718936873,1718937204,finished,1718936933,1718937204,A100-SXM4-80GB,8,16,64,896,60,271
2661af35-d2bd-4659-a907-2b73325d404b,opencompass-vllm,1718936964,1718940212,finished,1718936984,1718940212,A100-SXM4-40GB,4,1,32,320,20,3228
f288033a-1a69-42ef-9208-bfb48c874bf7,reranker2-inference,1718937030,1718937869,finished,1718937049,1718937869,A100-SXM4-40GB,1,1,8,32,19,820
7e269d52-4941-4e95-b3cf-032963b11d3b,easy-context-llama3-copy,1718937070,1718937832,finished,1718937262,1718937832,A100-SXM4-80GB,8,40,64,448,192,570
1da886c4-0422-4374-9907-0e795fe87066,geo-llamapro-5-restart,1718937113,1718946431,finished,1718946273,1718946431,A100-SXM4-80GB,8,2,64,448,9160,158
683c21a6-3898-457c-8eed-6a25f94d0f66,sfr-embedding-test,1718937198,1718937333,finished,1718937217,1718937333,A100-SXM4-80GB,8,1,64,448,19,116
b9d77611-83e8-40b3-84a2-48b4427c0272,sfr-embedding-test,1718937370,1718937770,finished,1718937388,1718937770,A100-SXM4-80GB,8,1,64,448,18,382
7b23710d-b271-4fe5-bb21-1fd0eea9dee8,geogpt-upcycle-4x14b-baseline,1718937594,1718938154,finished,1718937875,1718938154,A100-SXM4-80GB,8,16,64,896,281,279
a366dbb4-65cb-4bc7-9baf-a95a36910c3a,eval-control-group-fumingxiang,1718937768,1718939284,finished,1718937786,1718939284,A100-SXM4-80GB,8,1,64,448,18,1498
cdf078fe-a4fb-44d6-aecb-d8d1f2ee587e,geogept-gate-eval,1718937939,1718938691,finished,1718937958,1718938691,A100-SXM4-80GB,8,1,64,448,19,733
b5c3690f-ae19-46e6-9771-0c22531936ab,reranker-inference,1718937967,1718938078,finished,1718937986,1718938078,A100-SXM4-80GB,8,1,64,448,19,92
4b60be1a-1c59-46db-b25f-047a62a95674,sfr-embedding-test,1718938004,1718938205,finished,1718938024,1718938205,A100-SXM4-80GB,8,1,64,448,20,181
c7178732-3b64-4d82-8715-b6476e33afc8,sfr-embedding-test,1718938205,1718938591,finished,1718938224,1718938591,A100-SXM4-80GB,8,1,64,448,19,367
7da5309d-6f25-43f7-b1b5-812baaa55bcc,ls2,1718938352,1718938536,finished,1718938370,1718938536,A100-SXM4-80GB,8,1,64,896,18,166
2d337849-4f74-4f6f-b0b8-974a1727478b,sun-opencompass,1718938404,1719146284,finished,1718938422,1719146284,A100-SXM4-80GB,8,1,64,896,18,207862
de3c4416-55db-430e-a22a-15c1138f58f1,geogept-qwen1-5-7b-llamapro40-s3-10bcpt,1718938414,1718938544,finished,1718938432,1718938544,A100-SXM4-80GB,8,1,64,448,18,112
91a34c63-26a6-45b2-986a-1c561d9476ce,reranker2-inference,1718938477,1718938535,finished,1718938498,1718938535,A100-SXM4-80GB,8,1,64,896,21,37
d8177c2c-7d8c-47ec-b01d-afecdef91d43,reranker-inference,1718938573,1718938646,finished,1718938591,1718938646,A100-SXM4-80GB,8,1,64,448,18,55
f1b3b939-9af2-46e5-aae9-2b3f9051a8ac,llama-factory-zj-test,1718938780,1718939003,finished,1718938837,1718939003,A100-SXM4-80GB,8,10,64,896,57,166
ab07ae79-1ecf-4eb1-8c93-199711b7a4e3,sfr-embedding-test,1718938818,1718939210,finished,1718938837,1718939210,A100-SXM4-80GB,8,1,64,448,19,373
efa0e353-67d2-425a-a054-d3095e8bff11,reranker-inference,1718938966,1718953267,finished,1718938985,1718953267,A100-SXM4-80GB,8,1,64,448,19,14282
a557cd88-7119-4e8c-963e-235f3677faea,llama3-rag,1718939075,1719147243,finished,1718939094,1719147243,A100-SXM4-80GB,8,1,64,448,19,208149
577d259b-196f-48dd-9c70-cdf0c7728dc9,geogpt-upcycle-4x14b-baseline,1718939216,1718940122,finished,1718939291,1718940122,A100-SXM4-80GB,8,16,64,896,75,831
aaaa69ed-b588-42bf-af96-2fb25ea6124a,geogept-qwen1-5-7b-llamapro40-s3-10bcpt,1718939257,1718939521,finished,1718939276,1718939521,A100-SXM4-80GB,8,1,64,448,19,245
63ece33e-2764-4fb6-a01f-3b6277d0232d,eval-control-group-fumingxiang,1718939284,1718940347,finished,1718939308,1718940347,A100-SXM4-80GB,8,1,64,448,24,1039
6d2e355c-e571-4155-9ac9-be8c895c0ded,geogept-gate-eval,1718939300,1718943642,finished,1718939318,1718943642,A100-SXM4-80GB,8,1,64,448,18,4324
f2876128-528f-4503-a6f1-cec3e5a4297e,geogpt-smoe-eval,1718939373,1718961769,finished,1718939391,1718961769,A100-SXM4-80GB,8,1,64,448,18,22378
d6046aac-3e91-484e-841d-63b857afdda2,geogept-qwen1-5-7b-llamapro40-s3-10bcpt,1718939637,1718940165,finished,1718939655,1718940165,A100-SXM4-80GB,8,1,64,448,18,510
b456bfaa-6d96-4ea5-ae4a-a507215db06e,geogpt-upcycling-qwen14b-geoseed-bsexp,1718939652,1718939907,finished,1718939692,1718939907,A100-SXM4-80GB,8,8,64,896,40,215
c607921d-2824-49cb-b8e8-6aa6c7e8f265,geogpt-eval-latest,1718939692,1718946095,finished,1718939714,1718946095,A100-SXM4-80GB,8,1,64,896,22,6381
c7f22e9e-acbd-4eae-84ff-f41fd1223421,gpt-megatron,1718939707,1719059620,finished,1718939727,1719059620,A100-SXM4-80GB,8,1,64,448,20,119893
548ea10c-ac2e-4eaf-af1d-5abe3f934233,sfr-embedding-test,1718939840,1718940098,finished,1718939865,1718940098,A100-SXM4-80GB,8,1,64,448,25,233
c55da86a-6d0d-4511-b4fc-ac80702f00de,geogpt-lxz-cft-1-8m-subset-times2-72b,1718939870,1718957509,finished,1718939926,1718957509,A100-SXM4-80GB,8,20,64,448,56,17583
b70f6e3c-16f8-4867-b1ea-565046fe3808,geogpt-upcycling-qwen14b-geoseed-bsexp,1718939973,1718940297,finished,1718940015,1718940297,A100-SXM4-80GB,8,8,64,896,42,282
4369b465-e9d0-4afb-942c-2a0a806e57c2,geogpt-lxz-cft-new-mix-72b,1718939995,1718946197,finished,1718940078,1718946197,A100-SXM4-80GB,8,16,64,448,83,6119
98dc710e-a389-4de9-a66e-5a3cf2c0a54a,sfr-embedding-test,1718940098,1718940504,finished,1718940117,1718940504,A100-SXM4-80GB,8,1,64,896,19,387
ff897433-ae98-4389-aa22-1af90f9f0edb,geogpt-upcycle-4x14b-baseline,1718940122,1719038185,finished,1718940199,1719038185,A100-SXM4-80GB,8,16,64,896,77,97986
bba2831b-a27b-44ac-a35c-5633f7868610,sfr-embedding,1718940138,1718940541,finished,1718940157,1718940541,A100-SXM4-80GB,8,1,64,448,19,384
9f478f30-74e5-43de-b981-596f87e74f31,geogpt-upcycling-qwen14b-geoseed-bsexp,1718940355,1718963102,finished,1718940413,1718963102,A100-SXM4-80GB,8,8,64,896,58,22689
7407888e-fe8a-4405-8c8f-658117b2c80d,geogept-qwen1-5-7b-llamapro40-s3-10bcpt,1718940358,1718941007,finished,1718940376,1718941007,A100-SXM4-80GB,8,1,64,448,18,631
738433b1-fed3-41c9-933e-d6dd36ff41d6,geogpt-qwen2-chat-0612dpo-dare-ties-p53,1718940393,1719027282,finished,1718940416,1719027282,A100-SXM4-80GB,8,1,64,448,23,86866
32775514-7dd1-4d69-aeba-d3cdaae2aec3,geogpt-qwen2-chat-0612dpo-dare-ties-p55,1718940453,1718943199,finished,1718940473,1718943199,A100-SXM4-80GB,8,1,64,448,20,2726
0d835f07-fba8-4ede-9aec-72f012ac14c8,sfr-embedding,1718940541,1718940924,finished,1718940559,1718940924,A100-SXM4-80GB,8,1,64,448,18,365
ccb7c334-a66e-46a6-b146-08a06b4d9a83,sfr-embedding-test,1718940578,1718941109,finished,1718940596,1718941109,A100-SXM4-80GB,8,1,64,448,18,513
493d7c9b-08d0-4f1e-bb13-d512e6729373,easycontext-llama3,1718940632,1718942193,finished,1718940687,1718942193,A100-SXM4-80GB,8,32,64,448,55,1506
4aa7be4c-fb14-46d6-aa81-ea944e0902ba,geogpt-qwen2-chat-0612dpo-dare-ties-p57,1718940743,1719027600,finished,1718940761,1719027600,A100-SXM4-80GB,8,1,64,448,18,86839
f1ea755a-a289-446a-971c-65611b73368b,geogpt-qwen2-chat-0612dpo-dare-ties-p59,1718940782,1718943218,finished,1718940800,1718943218,A100-SXM4-80GB,8,1,64,448,18,2418
1964d526-7b0a-4847-b729-4b186c54aa7e,test-xiaodian,1718941354,1718941646,finished,1718941375,1718941646,A100-SXM4-80GB,8,1,64,448,21,271
4763cedf-a371-4f2d-8712-a210e4672f14,test-xiaodian,1718941779,1718962827,finished,1718941799,1718962827,A100-SXM4-80GB,8,1,64,448,20,21028
8effcd92-f9e4-4309-bcc7-e391d4f3f24d,geo-router-block-weight-full-atten,1718942092,1719145926,finished,1718946213,1719145926,A100-SXM4-80GB,8,1,64,448,4121,199713
f260c057-03c6-43c6-84ec-59ddc7956e2c,easycontext-llama3,1718942193,1718947101,finished,1718943691,1718947101,A100-SXM4-80GB,8,40,64,448,1498,3410
3658f2b2-ab29-4d07-b701-cf67dd47b351,geogpt-dairui-eval-code,1718942293,1718944439,finished,1718943871,1718944439,A100-SXM4-80GB,8,1,64,896,1578,568
86560a79-fda9-405b-a309-8e9d49ff0e57,geo-router-block-weight-raw,1718942446,1719145281,finished,1718945309,1719145281,A100-SXM4-80GB,8,1,64,448,2863,199972
adfb3e13-632e-4f4c-8ba1-8e085958c8fd,geogpt-qwen2-chat-0612dpo-ties-p17,1718942871,1718950498,finished,1718942891,1718950498,A100-SXM4-80GB,8,1,64,448,20,7607
cacbe8c4-e264-412b-84b3-1d3384e1e80f,sfr-embedding,1718942981,1718943847,finished,1718943001,1718943847,A100-SXM4-80GB,8,1,64,448,20,846
90387d9b-bf11-455e-b3da-3047ae2ff0ba,sfr-embedding-test,1718943001,1718943867,finished,1718943021,1718943867,A100-SXM4-80GB,8,1,64,448,20,846
4f619ef5-da82-4442-8a5e-89037863b2e3,geogpt-moe-0-5B-sr5-ckpt200,1718943732,1719145990,finished,1718943910,1719145990,A100-SXM4-80GB,8,1,64,896,178,202080
81842dc5-d764-44da-96a8-1837534a18db,sfr-embedding,1718943847,1718944493,finished,1718943868,1718944493,A100-SXM4-80GB,8,1,64,448,21,625
a92893f6-dc35-446e-a1c7-9761da357507,sfr-embedding-test,1718943868,1718944743,finished,1718943887,1718944743,A100-SXM4-80GB,8,1,64,448,19,856
b420586f-f32a-47a5-89ab-e12fcce6c229,geogpt-moe-0-5B-sr5-ckpt800,1718944220,1718956180,finished,1718947658,1718956180,A100-SXM4-80GB,8,1,64,896,3438,8522
906b08a2-32ec-4b06-b525-d473e68a6c35,geogpt-moe-0-5B-sr24-ckpt200,1718944242,1719145406,finished,1718947658,1719145406,A100-SXM4-80GB,8,1,64,896,3416,197748
4c983f02-0f88-4fed-9f13-c2ea0823892f,geogpt-moe-0-5B-sr24-ckpt200,1718944321,1719145469,finished,1718944458,1719145469,A100-SXM4-80GB,8,1,64,896,137,201011
3cfa2638-0cf7-4351-9860-2c46210f1f98,reranker2-inference,1718944377,1719107531,finished,1718944397,1719107531,A100-SXM4-80GB,8,1,64,896,20,163134
d8ce68ea-57ed-4a88-8744-477605de9c87,sfr-embedding,1718944551,1718945246,finished,1718944571,1718945246,A100-SXM4-80GB,8,1,64,448,20,675
0ded8def-c5a2-4561-8bed-75a422834beb,sfr-embedding-test,1718944743,1718945284,finished,1718944762,1718945284,A100-SXM4-80GB,8,1,64,448,19,522
851a082e-838a-4c0e-b85f-3d7a1f32e280,sfr-embedding-test,1718945284,1718945935,finished,1718945305,1718945934,A100-SXM4-80GB,8,1,64,448,21,629
6a5ba288-a06b-46c0-a2ec-230b4415fa4e,sfr-embedding,1718945285,1718945915,finished,1718945305,1718945915,A100-SXM4-80GB,8,1,64,448,20,610
47957815-3504-4173-a842-7694b9f5aa08,sfr-embedding,1718945915,1718946249,finished,1718945935,1718946249,A100-SXM4-80GB,8,1,64,448,20,314
5d8a5d1b-2bbc-466c-adce-555e2942cab8,sfr-embedding-test,1718945935,1718946070,finished,1718945955,1718946070,A100-SXM4-80GB,8,1,64,448,20,115
a5418e3f-06f3-4a4a-90ed-83121eed7561,sfr-embedding-test,1718946108,1718946485,finished,1718946129,1718946485,A100-SXM4-80GB,8,1,64,448,21,356
6da8f9e6-2e82-4b1c-ba20-d825031ae39b,geo-router-softmax-lr-1e-4,1718946352,1718947639,finished,1718946489,1718947639,A100-SXM4-80GB,8,2,64,448,137,1150
aaa3b0f3-6413-4a23-af92-f15494220103,sfr-embedding,1718946446,1718952500,finished,1718946466,1718952500,A100-SXM4-80GB,8,1,64,448,20,6034
ca4d674e-d0fd-44fd-8d34-db87d14befba,sfr-embedding-test,1718946485,1718946957,finished,1718946505,1718946957,A100-SXM4-80GB,8,1,64,448,20,452
6dd891cf-1ab0-49f2-a8ca-3e267772d7b9,geogpt-qwen2-72b-11bcpt-2ep,1718946868,1718947928,finished,1718946926,1718947928,A100-SXM4-80GB,8,50,64,448,58,1002
8784c8e0-4de1-444d-8f93-57d3cd9da7d3,sfr-embedding-test,1718946957,1718952539,finished,1718946977,1718952539,A100-SXM4-80GB,8,1,64,448,20,5562
26745a56-144b-449e-9b18-daea64abae77,sft-1-8m-110b-eval,1718947144,1719053355,finished,1718947164,1719053355,A100-SXM4-80GB,8,1,64,448,20,106191
10f521fe-a642-442c-8f18-6fc636404fed,easycontext-llama3,1718947236,1718952646,finished,1718947275,1718952646,A100-SXM4-80GB,8,40,64,448,39,5371
cfb08017-38db-486a-aa95-9649f19c12c2,geogpt-qwen2-72b-11bcpt-2ep,1718948006,1718962494,finished,1718948063,1718962494,A100-SXM4-80GB,8,50,64,448,57,14431
040f0975-b53b-450d-8913-39f75461243f,qwen2-72b-sft-dpo,1718948242,1718948779,finished,1718948282,1718948779,A100-SXM4-80GB,8,4,64,896,40,497
bb1ef84f-fb34-4a10-a18d-c134b56aa3d4,reranker-base,1718948353,1718953267,finished,1718948373,1718953267,A100-SXM4-80GB,8,1,64,896,20,4894
11bb7d16-3227-4cae-bb91-2e5dc731fff4,geogpt-dairui-model-merge-exp-1,1718948731,1718965520,finished,1718948751,1718965520,A100-SXM4-80GB,8,1,64,896,20,16769
931168a8-c50a-4a03-9016-d3f2e3b43903,geogept-gate-eval,1718948799,1718962393,finished,1718948821,1718962393,A100-SXM4-80GB,8,1,64,448,22,13572
35abf702-50ca-4d3d-9057-4754656e4254,geogept-qwen1-5-7b-llamapro40-s3-10bcpt,1718948799,1718949357,finished,1718948821,1718949357,A100-SXM4-80GB,8,1,64,448,22,536
d87aa752-87fe-4dde-9e4b-896a33409dd7,geogpt-dairui-eval-code,1718948814,1718950540,finished,1718949806,1718950540,A100-SXM4-80GB,8,1,64,896,992,734
4c36df44-490c-41b3-a41b-4b11942ccd7a,qwen2-72b-sft-dpo,1718949218,1718949734,finished,1718949259,1718949734,A100-SXM4-80GB,8,4,64,896,41,475
189514c0-f0e2-497c-9513-fd401ee1f8f8,geogept-qwen1-5-7b-llamapro40-s3-10bcpt,1718949436,1718950129,finished,1718949456,1718950129,A100-SXM4-80GB,8,1,64,448,20,673
5d390564-498c-4a4a-9887-84851c340385,geogpt-lxz-cft-new-mix-mtm1-72b,1718950068,1718950707,finished,1718950564,1718950707,A100-SXM4-80GB,8,16,64,448,496,143
f7e46de0-c182-48e3-8b5b-7762e1bce9d3,geogpt-qwen2-chat-0612dpo-dare-ties-p17,1718950520,1719037391,finished,1718950725,1719037391,A100-SXM4-80GB,8,1,64,448,205,86666
350654eb-75d1-4791-9734-700bfc6e0005,geogpt-dpo-qwen2-72b-datav0-ep1,1718950559,1718955143,finished,1718950722,1718955143,A100-SXM4-80GB,8,1,64,448,163,4421
df29539b-97c1-4c55-ab84-d3d5227e3388,geogpt-eval-latest,1718950788,1718950907,finished,1718950808,1718950907,A100-SXM4-80GB,8,1,64,896,20,99
2e1a79bd-ef32-45b5-8d51-d5d3d9bd35dc,geogept-qwen1-5-7b-llamapro40-s3-10bcpt,1718950850,1718953501,finished,1718950910,1718953501,A100-SXM4-80GB,8,4,64,448,60,2591
c03a53ca-7737-491f-88dc-d10e3261e0e7,geogpt-lxz-cft-new-mix-mtm1-72b,1718951584,1718953660,finished,1718952672,1718953660,A100-SXM4-80GB,8,16,64,448,1088,988
cad670f6-c519-4c24-a24b-7c634fe01704,sfr-embedding,1718952500,1719107472,finished,1718952520,1719107472,A100-SXM4-80GB,8,1,64,448,20,154952
8e8c22f4-c02e-4313-88d8-855fc7e0481d,sfr-embedding-test,1718952539,1718958673,finished,1718952559,1718958673,A100-SXM4-80GB,8,1,64,448,20,6114
907a8527-7ca9-444c-8640-1fd3323126f7,geogpt-eval-latest,1718953374,1718959765,finished,1718953395,1718959765,A100-SXM4-80GB,8,1,64,896,21,6370
b0aabf83-664d-4791-b2f5-98207eef62b2,geogept-qwen1-5-7b-llamapro40-s3-10bcpt,1718953501,1718969579,finished,1718953541,1718969579,A100-SXM4-80GB,8,4,64,448,40,16038
f23fd9b9-48a7-4650-b30f-9721e1419f84,humaneval-vllm,1718953644,1718954640,finished,1718953667,1718954640,A100-SXM4-80GB,8,1,64,896,23,973
f8bbb3ec-8310-4b0e-b959-e2624cff381e,geogpt-lxz-cft-new-mix-mtm1-72b,1718953660,1718963270,finished,1718953721,1718963270,A100-SXM4-80GB,8,16,64,448,61,9549
5e12a376-88e0-4476-af86-973caead27a4,easycontext-llama3,1718953715,1718954207,finished,1718953763,1718954207,A100-SXM4-80GB,8,2,64,448,48,444
7ddf2640-4bdb-438c-8f24-73ebe36cda7a,docxchain-iso-002,1718954001,1718954167,finished,1718954022,1718954167,A100-SXM4-40GB,4,1,32,320,21,145
96bc15bd-6172-4fb9-8ad0-f433a565f309,formula-iso-002,1718954043,1718954208,finished,1718954064,1718954208,A100-SXM4-40GB,4,1,32,320,21,144
4e2d0ebb-14f7-48f9-b896-bf7cb8deff06,table-iso-002,1718954084,1718954250,finished,1718954106,1718954250,A100-SXM4-40GB,4,1,32,320,22,144
29043ece-db93-4942-b6eb-0970745f2c6c,formula-iso-002,1718954208,1718954630,finished,1718954229,1718954630,A100-SXM4-40GB,4,1,32,320,21,401
20d5de1c-d67f-4c25-b77c-22a81f8b8fff,docxchain-iso-002,1718954229,1718954650,finished,1718954250,1718954650,A100-SXM4-40GB,4,1,32,320,21,400
e1975bcb-b018-4aae-9b87-c6247111688e,table-iso-002,1718954349,1718954650,finished,1718954369,1718954650,A100-SXM4-40GB,4,1,32,320,20,281
8572d458-aec4-432a-9eac-d16be10ce70f,geogpt-cft-fusion17-newmix100k-geo92k,1718954677,1718955268,finished,1718954741,1718955268,A100-SXM4-80GB,8,8,64,448,64,527
8a9e0458-e2c8-4dd1-b947-f9bafd88834f,docxchain-iso-002,1718954693,1718957809,finished,1718954715,1718957809,A100-SXM4-40GB,4,1,32,320,22,3094
dd267921-4ff5-407a-808c-52206b18a903,formula-iso-002,1718954715,1718955427,finished,1718954736,1718955427,A100-SXM4-40GB,4,1,32,320,21,691
2a684f8b-2bb2-4788-80f8-c64dcf2b9527,table-iso-002,1718954735,1718956445,finished,1718954759,1718956445,A100-SXM4-40GB,4,1,32,320,24,1686
ecdb704a-800c-41ef-8b84-edceb114c373,easycontext-llama3,1718954899,1718955488,finished,1718954959,1718955488,A100-SXM4-80GB,8,4,64,448,60,529
062179b2-4198-487a-90df-975657fe4a0e,geogpt-dpo-qwen2-72b-datav0-ep1,1718955285,1718961183,finished,1718955306,1718961183,A100-SXM4-80GB,8,1,64,448,21,5877
ea86ccc3-732a-49dd-a8de-6dc1cb8f7610,formula-iso-002,1718955489,1718956404,finished,1718955510,1718956404,A100-SXM4-40GB,4,1,32,320,21,894
35f4d088-9305-4bde-b638-c57018a914ef,geogpt-cft-fusion17-newmix100k-geo92k,1718955557,1718963632,finished,1718955623,1718963632,A100-SXM4-80GB,8,16,64,448,66,8009
ffb88f30-a928-4d9c-987f-a7e2b797b6e9,formula-iso-002,1718956405,1718957830,finished,1718956425,1718957830,A100-SXM4-40GB,4,1,32,320,20,1405
aad74c9d-cb89-46d8-ba9c-b6baedc75848,table-iso-002,1718956445,1718957787,finished,1718956466,1718957787,A100-SXM4-40GB,4,1,32,320,21,1321
733d3ff2-b55b-44e8-9690-89b2054c4152,sfr-ft-2,1718956566,1718958672,finished,1718956591,1718958672,A100-SXM4-80GB,8,1,64,448,25,2081
2d091401-58a1-497e-8e21-121bd8eb9d1f,geogpt-moe-0-5B-sr5-ckpt2k,1718957707,1719021066,finished,1718957728,1719021066,A100-SXM4-80GB,8,1,64,896,21,63338
96013b9c-19db-41ef-993c-d35feea1d446,geogpt-moe-0-5B-sr24-ckpt2k,1718957769,1719021283,finished,1718957791,1719021283,A100-SXM4-80GB,8,1,64,896,22,63492
82767e80-026a-4d92-89e6-575f324d5a46,table-iso-002,1718957787,1718958289,finished,1718957809,1718958289,A100-SXM4-40GB,4,1,32,320,22,480
c1bc6457-9727-496b-b4dd-aad0be2c6739,docxchain-iso-002,1718957810,1718964659,finished,1718957830,1718964659,A100-SXM4-40GB,1,4,8,32,20,6829
ccad95d8-e275-4340-81ab-d88d9e972838,formula-iso-002,1718957830,1718958613,finished,1718957851,1718958613,A100-SXM4-40GB,1,4,8,32,21,762
4e30cce4-0aa1-476d-9b5a-69b449f4d730,table-iso-002,1718958289,1718958854,finished,1718958309,1718958854,A100-SXM4-40GB,1,1,8,96,20,545
9017b2e6-5bcc-4b9e-b54a-73ebe773cadb,intent-train,1718958431,1718958855,finished,1718958453,1718958855,A100-SXM4-80GB,8,1,64,448,22,402
6fcacbad-6c93-4729-9b5e-df3ab8e047bf,formula-iso-002,1718958613,1718963309,finished,1718958634,1718963309,A100-SXM4-40GB,1,4,8,96,21,4675
2781d844-8b21-4c91-8bbf-9e5e8522f486,sfr-embedding-test,1718958673,1718958873,finished,1718958693,1718958873,A100-SXM4-80GB,8,1,64,448,20,180
7ab2c800-8aa8-465e-8acc-b953f8da9a21,table-iso-002,1718958855,1718959342,finished,1718958875,1718959342,A100-SXM4-40GB,1,1,16,256,20,467
3d60d490-3612-4c53-810e-7a3d1540081a,sfr-embedding-test,1718958874,1719045476,finished,1718958894,1719045476,A100-SXM4-80GB,8,1,64,448,20,86582
47096557-c8ed-4b1f-864e-bbb6e271f66e,geogpt-lxz-cft-1-8m-subset-times2-72b,1718959157,1718959367,finished,1718959200,1718959367,A100-SXM4-80GB,8,20,64,448,43,167
83730ed7-7b95-4230-9474-4676e1ee68f8,table-iso-002,1718959343,1718961221,finished,1718959362,1718961221,A100-SXM4-40GB,1,1,16,256,19,1859
20841507-8bcd-4246-91b3-7f9c8ebbc256,geogpt-lxz-cft-1-8m-subset-times2-72b,1718959512,1718975678,finished,1718959575,1718975678,A100-SXM4-80GB,8,20,64,448,63,16103
652a65d4-cff3-443b-94bf-f7c36ac1c325,llm-trainer,1718959566,1719059677,finished,1718959595,1719059677,A100-SXM4-80GB,8,1,64,448,29,100082
1d3bf0e4-d9e7-422c-b6f1-8e4b3d0b1d67,sfr-ft-2,1718959637,1718961669,finished,1718959658,1718961669,A100-SXM4-80GB,8,1,64,448,21,2011
49a3b118-cd48-44dd-81df-91fc5cf0bb14,geogpt-eval-latest,1718960763,1719011417,finished,1718960783,1719011417,A100-SXM4-80GB,8,1,64,896,20,50634
dcb75bef-bcec-4827-ad19-54b4dc5e7d35,table-iso-002,1718961222,1718962852,finished,1718961246,1718962852,A100-SXM4-40GB,1,1,16,256,24,1606
dbb57cf3-784d-4b00-abc1-3e812f7721bc,easy-context-llama3-copy,1718961266,1718961492,finished,1718961338,1718961492,A100-SXM4-80GB,8,2,64,448,72,154
ea0b2bcd-1e43-4202-b1ad-4778768c5f28,intent-train,1718961268,1718961717,finished,1718961288,1718961717,A100-SXM4-80GB,8,1,64,448,20,429
a5d736f2-b62c-45eb-b8b2-ab7e28be5fe5,citysora-modelv4-webvid-cele-laion-joint-65-256,1718961296,1718961975,finished,1718961364,1718961975,A100-SXM4-80GB,8,5,64,896,68,611
5fe57e37-94ec-47dd-a3f9-98d59fe38497,geogpt-table-qwen2-72b-datav051,1718961320,1718961578,finished,1718961363,1718961578,A100-SXM4-80GB,8,4,64,896,43,215
5f230e2d-baf4-4936-8847-d541a638c27d,llama-factory-zj-test,1718961338,1718964103,finished,1718961384,1718964103,A100-SXM4-80GB,8,10,64,896,46,2719
7b7f7294-83ec-4b90-80d6-004129d032c0,citysora-modelv4-webvid-humanface-65-128,1718961364,1718961626,finished,1718961432,1718961626,A100-SXM4-80GB,8,4,64,896,68,194
11870161-0dfd-430c-8498-7e37f675a07e,easycontext-llama3,1718961533,1718985365,finished,1718962551,1718985365,A100-SXM4-80GB,8,40,64,448,1018,22814
bf5942b7-275e-4c44-a5db-495a0cfaaa02,geogpt-dpo-qwen2-72b-datav0-ep1,1718961542,1718972294,finished,1718961579,1718972294,A100-SXM4-80GB,8,1,64,448,37,10715
b6b7cf76-fda1-4c96-8f89-4cbc774ffd5e,geo-slim-gxy-qwen2-7b,1718961603,1718961648,finished,1718961625,1718961648,A100-SXM4-40GB,1,1,8,32,22,23
7fe3cafa-d949-47aa-9e2b-1bfff401eab0,citysora-modelv4-webvid-humanface-65-128,1718961626,1718961999,finished,1718961673,1718961999,A100-SXM4-80GB,8,4,64,896,47,326
3a6f0276-79ae-4767-bca3-ca365a980e53,sfr-ft-2,1718961669,1718961851,finished,1718961694,1718961851,A100-SXM4-80GB,8,1,64,448,25,157
064c672f-c662-4a13-96d7-8e55183449c0,geogpt-smoe-eval,1718961769,1718961906,finished,1718961790,1718961906,A100-SXM4-80GB,8,1,64,448,21,116
a02f4f34-e688-4322-8b9f-52ba374da482,geogpt-table-qwen2-72b-datav051,1718961924,1718970500,finished,1718961972,1718970500,A100-SXM4-80GB,8,4,64,896,48,8528
1027da2a-c2f0-4f75-bf25-63313fb39151,citysora-modelv4-webvid-cele-laion-joint-65-256,1718961975,1719197321,finished,1718962049,1719197321,A100-SXM4-80GB,8,5,64,896,74,235272
0d2a8b6e-04c7-4c19-a8c3-1752ae49b430,citysora-modelv4-webvid-humanface-65-128,1718962000,1719213573,finished,1718962075,1719213573,A100-SXM4-80GB,8,4,64,896,75,251498
4ddb2304-f99f-4743-95f2-3ecd7098361a,sfr-ft-4,1718962044,1718962230,finished,1718962071,1718962230,A100-SXM4-80GB,8,1,64,448,27,159
c611544f-5720-4141-9b0e-be613a7bce74,easy-context-llama3-copy,1718962045,1718962786,finished,1718962120,1718962786,A100-SXM4-80GB,8,2,64,448,75,666
1679a84b-41e2-47b3-97ca-0381d4b34f03,geogpt-smoe-eval,1718962079,1719023012,finished,1718962105,1719023012,A100-SXM4-80GB,8,1,64,448,26,60907
ba3b34cd-6a48-4f8d-8678-fcd829cd5dc3,qwen2-72b-chat,1718962099,1718963172,finished,1718962122,1718963172,A100-SXM4-40GB,8,1,32,320,23,1050
60ac3380-a8e2-4e10-aa02-8c06f9201002,sfr-ft-2,1718962208,1718962361,finished,1718962230,1718962361,A100-SXM4-80GB,8,1,64,448,22,131
cfa7db83-b1fb-43a0-8263-1262202af77a,geogept-gate-eval,1718962393,1718962540,finished,1718962415,1718962540,A100-SXM4-80GB,8,1,64,448,22,125
da9cdb46-bb27-42ae-a82d-04dbc6f2c7fd,sfr-ft-4,1718962506,1719060679,finished,1718962528,1719060679,A100-SXM4-80GB,8,1,64,448,22,98151
7a23432c-a0fd-4504-9313-56b6611ef080,sfr-ft-2,1718962528,1719061871,finished,1718962551,1719061871,A100-SXM4-80GB,8,1,64,448,23,99320
c4801d45-8b02-41a5-81d0-be6aac00ff9f,table-iso-002,1718962853,1718963625,finished,1718962875,1718963625,A100-SXM4-40GB,1,1,16,256,22,750
25d33b4a-0b03-4b00-92a9-983712f6767d,easy-context-llama3-copy,1718963004,1718963123,finished,1718963026,1718963123,A100-SXM4-80GB,8,2,64,448,22,97
f78f8ced-1a62-4363-b37a-80ba9f76ce12,easy-context-llama3-copy,1718963123,1718964658,finished,1718963193,1718964658,A100-SXM4-80GB,8,2,64,448,70,1465
ac4e73bf-920b-48c5-ac3f-0c4794c39882,geogpt-qwen2-72b-11bcpt-2ep,1718963134,1718968324,finished,1718963702,1718968324,A100-SXM4-80GB,8,50,64,448,568,4622
5481ec34-ff46-4b6f-b67c-f37125d2d3c4,qwen2-72b-chat,1718963172,1719345381,finished,1718963196,1719345381,A100-SXM4-40GB,8,1,32,320,24,382185
d6a29768-d683-4f54-a267-95a2304b9837,formula-iso-002,1718963309,1718964637,finished,1718963332,1718964637,A100-SXM4-40GB,1,1,8,96,23,1305
8ce62f1c-5102-450a-83ee-89d74bd48a0a,table-iso-002,1718963625,1718964614,finished,1718963648,1718964614,A100-SXM4-40GB,1,1,16,256,23,966
05b9caf3-4288-4b41-8758-a7017a77461e,llama-factory-zj-test,1718964103,1718965207,finished,1718964150,1718965207,A100-SXM4-80GB,8,2,64,896,47,1057
a3bff200-2206-4a54-ae2d-3506ab718dca,table-iso-002,1718964614,1719194533,finished,1718964637,1719194533,A100-SXM4-40GB,1,1,16,256,23,229896
6412b919-4548-4a6b-a2e3-4bb3e0cda375,formula-iso-002,1718964637,1719201439,finished,1718964659,1719201439,A100-SXM4-40GB,1,1,8,96,22,236780
4430bf55-bb56-4955-a8ac-9efc3e5d89c1,docxchain-iso-002,1718964659,1719216135,finished,1718964682,1719216135,A100-SXM4-40GB,1,1,8,32,23,251453
ab44ffe9-b0c7-4454-8628-bd3d3193dc54,geogpt-llama3-70b-0521,1718965043,1718968841,finished,1718965065,1718968841,A100-SXM4-40GB,8,1,32,320,22,3776
e147e84b-8957-46ea-ae48-e910f1893209,geogept-gate-eval,1718965173,1718986352,finished,1718965195,1718986352,A100-SXM4-80GB,8,1,64,448,22,21157
fe5268e1-d37a-4184-b1e0-2a8b4dddf9a2,llama-factory-zj-test,1718965207,1718965406,finished,1718965251,1718965406,A100-SXM4-80GB,8,2,64,896,44,155
f8af1e3c-9276-4c71-a329-387e38906ddb,geogpt-cft-fusion17-newmix100k-geo92k,1718965281,1718977303,finished,1718968385,1718977303,A100-SXM4-80GB,8,16,64,448,3104,8918
145883db-4cfb-48c8-9c9f-ff43a7903dd1,geogpt-dairui-model-merge-exp-2,1718965523,1719207757,finished,1718965547,1719207757,A100-SXM4-80GB,8,1,64,896,24,242210
ce2f9e88-4409-4753-86ca-961e0ad80c0b,llama-factory-zj-test,1718965565,1718965768,finished,1718965612,1718965768,A100-SXM4-80GB,8,2,64,896,47,156
fe5567b8-86e3-4621-95b9-ef46026527a5,llama-factory-zj-test,1718965835,1718967542,finished,1718965879,1718967542,A100-SXM4-80GB,8,2,64,896,44,1663
d2ec3de3-729f-4da3-834f-87006e15d338,opencompass-tianwenbucket,1718966085,1719106816,finished,1718966107,1719106816,A100-SXM4-80GB,8,1,64,448,22,140709
e6e21a1c-0a89-41c2-82b8-149684262ae6,llama-factory-zj-test,1718967542,1719044618,finished,1718967585,1719044618,A100-SXM4-80GB,8,2,64,896,43,77033
236fed44-1627-444b-a79f-ad8bcb0e43f1,geogpt-llama3-70b-0521,1718968841,1718969559,finished,1718968864,1718969559,A100-SXM4-40GB,8,1,32,320,23,695
6820c470-c71a-41a7-960b-94e1cfcb8ec0,geogpt-qwen2-72b-11bcpt-2ep,1718969469,1718969906,finished,1718969622,1718969906,A100-SXM4-80GB,8,50,64,448,153,284
6806d976-8e38-42c4-a5c0-c39c5c01371c,geogpt-llama3-70b-0521,1718969559,1718972193,finished,1718969582,1718972193,A100-SXM4-40GB,8,1,32,320,23,2611
67212c51-349f-43ee-9464-72e3b7b7f956,geogpt-qwen2-72b-11bcpt-2ep,1718970005,1718970361,finished,1718970071,1718970361,A100-SXM4-80GB,8,50,64,448,66,290
cf7f3f38-5de9-45e1-98c9-8eb28eff71dd,geogpt-qwen2-72b-11bcpt-2ep,1718970463,1718970789,finished,1718970530,1718970789,A100-SXM4-80GB,8,50,64,448,67,259
e071fb50-8110-461c-97f9-dc48f23be4c4,geogpt-qwen2-72b-11bcpt-2ep,1718970855,1718971214,finished,1718970933,1718971214,A100-SXM4-80GB,8,50,64,448,78,281
f6a13503-d0c8-4db9-9c66-7f160ef828b2,easy-context-llama3-copy,1718971556,1718978612,finished,1718971600,1718978612,A100-SXM4-80GB,8,2,64,448,44,7012
5fe0cec3-faee-4155-aae3-42d488482d30,geogpt-qwen2-72b-11bcpt-2ep,1718971713,1718972280,finished,1718971760,1718972280,A100-SXM4-80GB,8,50,64,448,47,520
63126db2-d847-4e6b-a1df-2b0f7bf9f34e,geogpt-dairui-model-merge-exp-1,1718972111,1719023789,finished,1719023720,1719023789,A100-SXM4-80GB,8,1,64,896,51609,69
fc4c9361-9e11-42a6-8186-938441bc099d,geogpt-dairui-eval-code,1718972113,1719024720,finished,1719023942,1719024720,A100-SXM4-80GB,8,1,64,896,51829,778
45c4c85b-a855-4184-a8ae-dc77c3a0ed18,geogpt-dairui-eval-code-2,1718972116,1719021412,finished,1719021304,1719021412,A100-SXM4-80GB,8,1,64,448,49188,108
1bfb9b02-6f49-439b-8b4c-a723806d1eec,geo-router-weight-full-atten-lr-1e-4,1718972118,1719088749,finished,1719021456,1719088749,A100-SXM4-80GB,8,2,64,448,49338,67293
c025ff9c-86d5-49c2-9b2a-d8da2eb68b74,geo-router-softmax-lr-1e-4,1718972120,1719086817,finished,1719023744,1719086817,A100-SXM4-80GB,8,2,64,448,51624,63073
6a5d2be0-e89a-4953-a286-b5c4655c9807,geo-router-block-weight,1718972123,1719086317,finished,1719023744,1719086317,A100-SXM4-80GB,8,2,64,448,51621,62573
c9309469-1892-4111-91e0-abbecb6f6da7,geo-router-weight-lr1e-4,1718972125,1719024008,finished,1719023767,1719024008,A100-SXM4-80GB,8,2,64,448,51642,241
3d89ede4-07f3-4cf3-a3d4-f516940e099d,geo-router-softmax-reserved,1718972127,1719087068,finished,1719023767,1719087068,A100-SXM4-80GB,8,2,64,448,51640,63301
231af360-d7b0-4d58-b9d9-77ea50098136,txchen-eval,1718972146,1719021422,finished,1719021101,1719021422,A100-SXM4-80GB,8,1,64,448,48955,321
7e1bc47a-dfba-4f07-ab2d-375a8e8ac07a,geogpt-llama3-70b-0521,1718972193,1719545842,finished,1718972216,1719545842,A100-SXM4-40GB,8,1,32,320,23,573626
b50ad7b0-6423-4fe1-b6d1-67b7e34988ea,test-api-2539b-auto,1718972257,1718974340,finished,1718972280,1718974340,A100-SXM4-80GB,8,1,64,448,23,2060
25f2e61d-a4a3-4a5f-b92d-e29a664336ae,qwen2-72b-10bcpt-1ep,1718972414,1719038824,finished,1718972437,1719038824,A100-SXM4-80GB,8,1,64,448,23,66387
39f079c4-b540-44fe-92b0-ff23ab9de0af,geogpt-qwen2-72b-11bcpt-2ep,1718972490,1719027760,finished,1718972535,1719027760,A100-SXM4-80GB,8,50,64,448,45,55225
d8f80c8f-b870-4cb5-ba73-3ea2c0062d1f,geogept-qwen1-5-7b-llamapro40-s3-10bcpt,1718972555,1719185006,finished,1718975726,1719185006,A100-SXM4-80GB,8,4,64,448,3171,209280
c8dc8173-0516-4e90-867a-e955ad811c1e,lzk-structllm,1718974564,1719023953,finished,1719023732,1719023953,A100-SXM4-80GB,8,1,64,448,49168,221
121b7f80-4719-4901-831d-b5b910e8da8a,paly-qwen2-7b-sft,1718974736,1718974825,finished,1718974758,1718974825,A100-SXM4-80GB,8,1,64,896,22,67
674b389a-d022-4628-9d50-5d5f12ca50dc,paly-qwen2-7b-sft,1718974957,1718975112,finished,1718974979,1718975112,A100-SXM4-80GB,8,1,64,896,22,133
e9228d4a-2bea-4bdc-a703-c1bd1b7d3103,paly-qwen2-7b-sft,1718975752,1718975884,finished,1718975775,1718975884,A100-SXM4-80GB,8,1,64,896,23,109
1bbaef7a-8f24-49f3-b09f-4a3ab9093a4d,geogpt-lxz-cft-1-8m-subset-times2-72b,1718975769,1718985416,finished,1718977401,1718985416,A100-SXM4-80GB,8,20,64,448,1632,8015
b0f1ba7c-1289-4b80-a877-284591c40d90,paly-qwen2-7b-sft,1718976537,1718976668,finished,1718976558,1718976668,A100-SXM4-80GB,8,1,64,896,21,110
a77cd0ea-468c-42d0-8fda-048b593caf28,paly-qwen2-7b-sft,1718976994,1718977192,finished,1718977016,1718977192,A100-SXM4-80GB,8,1,64,896,22,176
92005a43-d53d-4fd3-863e-db3256eb1c00,paly-qwen2-7b-sft,1718977192,1718977384,finished,1718977214,1718977384,A100-SXM4-80GB,8,1,64,896,22,170
d0f0fa6a-2e62-41b6-8d97-3883c1c552c1,lzk-qwen15-7b-scihub-abstract-cpt,1718977703,1719053595,finished,1719023821,1719053595,A100-SXM4-80GB,8,1,64,448,46118,29774
55a4e16a-d265-49f1-958d-b20a630fadd5,paly-qwen2-7b-sft,1718978270,1718978748,finished,1718978292,1718978748,A100-SXM4-80GB,8,1,64,896,22,456
7bd02fbb-0eaa-4733-96c6-cf566ca21056,easy-context-llama3-copy,1718978612,1718979695,finished,1718978656,1718979695,A100-SXM4-80GB,8,2,64,448,44,1039
967f3c1f-4e02-4bf0-96f9-670b2f7b0036,geogpt-cft-fusion17-newmix100k-geo92k,1718978961,1719014182,finished,1718979744,1719014182,A100-SXM4-80GB,8,16,64,448,783,34438
6b35e1ab-2871-4ec4-a0f8-2ec52f5d36a8,paly-qwen-sft,1718980826,1718985486,finished,1718985376,1718985486,A100-SXM4-80GB,8,1,64,896,4550,110
34f1121b-e0b0-4438-acdd-8a8c69e01247,paly-qwen2-7b-sft,1718981001,1718981045,finished,1718981023,1718981045,A100-SXM4-40GB,4,1,32,320,22,22
7f9d500b-0921-48d6-8375-f5cef0074211,paly-qwen2-7b-sft,1718981391,1718981435,finished,1718981414,1718981435,A100-SXM4-40GB,8,1,32,320,23,21
42b2071f-2b3b-4a05-aae8-606a5de26a0c,paly-qwen2-7b-sft,1718981696,1718981740,finished,1718981719,1718981740,A100-SXM4-40GB,1,1,8,32,23,21
162c4a27-7397-4984-a32d-e67ea0bc5b46,paly-qwen-sft-2,1718981870,1718981914,finished,1718981892,1718981914,A100-SXM4-40GB,1,1,8,96,22,22
8eea6562-8209-41ac-8edd-21d8cc956d1d,paly-qwen2-7b-sft,1718982414,1718982458,finished,1718982436,1718982458,A100-SXM4-40GB,1,1,16,256,22,22
a46e2bda-3db8-42a9-9451-5e20205b63bf,paly-qwen2-7b-sft,1718982591,1718985662,finished,1718985376,1718985662,A100-SXM4-80GB,8,1,64,448,2785,286
aadcb86b-f953-4e59-b631-f5d5663203b4,easy-context-llama3-copy,1718983664,1718986210,finished,1718985410,1718986210,A100-SXM4-80GB,8,2,64,448,1746,800
71a97fc8-ed37-48a6-b771-8ca59e4f0a3b,geogpt-lxz-cft-new-mix-mtm1-72b,1718985679,1719002970,finished,1718985724,1719002970,A100-SXM4-80GB,8,16,64,448,45,17246
e0a98655-ef50-4070-b5db-300ddafb681b,cft-mt-lr1e-5-14b,1718985798,1719053356,finished,1718985820,1719053356,A100-SXM4-80GB,8,1,64,448,22,67536
9b591e7e-5407-4dbd-8a8c-9839b99eb4e3,paly-qwen-sft,1718986747,1718987100,finished,1718986769,1718987100,A100-SXM4-80GB,8,1,64,896,22,331
dedcce71-26e3-461a-93ad-a4453c3c9132,paly-qwen2-7b-sft,1718987188,1718987760,finished,1718987210,1718987760,A100-SXM4-80GB,8,1,64,896,22,550
03f81df5-8c87-4095-87c5-5c52b10d84fe,easy-context-llama3-copy,1718988080,1718989092,finished,1718988124,1718989092,A100-SXM4-80GB,8,2,64,448,44,968
db366b7b-26d1-4499-afef-0951e69a042c,geogpt-lxz-cft-new-mix-mtm1-72b,1719004162,1719004792,finished,1719004230,1719004792,A100-SXM4-80GB,8,16,64,448,68,562
16a9d990-b14f-4fdb-bbf0-34d22d8ba5f9,slimorca-geo-mtm1-funcfil2-14b,1719004838,1719053357,finished,1719004860,1719053357,A100-SXM4-80GB,8,1,64,448,22,48497
1ebaeb6b-9403-41ba-966b-839e76e29314,geogpt-lxz-cft-new-mix-mtm1-72b,1719004992,1719005603,finished,1719005055,1719005603,A100-SXM4-80GB,8,16,64,448,63,548
a55e25ec-6059-4ca7-a87b-3c18ac932402,geogpt-lxz-cft-new-mix-mtm1-72b,1719005950,1719017721,finished,1719005995,1719017721,A100-SXM4-80GB,8,16,64,448,45,11726
0c608a96-fc3b-48c1-ae18-dadb00984915,geogpt-lxz-cft-new-mix-mtm1-72b,1719017791,1719025835,finished,1719017856,1719025835,A100-SXM4-80GB,8,16,64,448,65,7979
597671d3-5391-4362-90d3-fbf9c6e97e19,geogpt-lxz-cft-1-8m-4-5-subset-72b,1719020478,1719021093,finished,1719020545,1719021093,A100-SXM4-80GB,8,16,64,448,67,548
0adcc9c6-31f1-4d50-86ea-bcf6fb1b953d,geogpt-lxz-cft-1-8m-4-5-subset-72b,1719021546,1719069576,finished,1719021590,1719069576,A100-SXM4-80GB,8,16,64,448,44,47986
0927aa64-ee18-435d-baee-7d2cbff09d76,geogpt-llama3-cpt1ep-sft-jsonl,1719023795,1719024102,finished,1719023862,1719024102,A100-SXM4-80GB,8,48,64,448,67,240
90d3cef7-4afd-4f55-bcf9-adcc53c54426,lzk-structllm,1719024151,1719053829,finished,1719024173,1719053829,A100-SXM4-80GB,8,1,64,448,22,29656
ce8e0c3b-aad6-40e2-895e-385bda7c2f94,geogpt-14b-38bcpt,1719024965,1719025189,finished,1719025008,1719025189,A100-SXM4-80GB,8,48,64,448,43,181
f85815fb-87d0-4865-ba03-1f5980ba457e,geogpt-14b-38bcpt,1719025319,1719025997,finished,1719025363,1719025997,A100-SXM4-80GB,8,48,64,448,44,634
c484d1dd-995d-4d42-ab5d-eb6394e0a66a,geogpt-lxz-cft-new-mix-mtm1-72b,1719025913,1719048992,finished,1719025955,1719048992,A100-SXM4-80GB,8,16,64,448,42,23037
e1dc2604-86e7-4b0e-8848-e1ff0234b47f,geogpt-14b-38bcpt,1719026233,1719026554,finished,1719026299,1719026554,A100-SXM4-80GB,8,48,64,448,66,255
eae8b94c-eee1-46cc-b97f-eb1b4249688c,geogpt-qwen2-72b-11bcpt-2ep,1719027760,1719027843,finished,1719027780,1719027843,A100-SXM4-80GB,8,50,64,448,20,63
d4fd3617-baa3-471f-8b07-6de01fc7ed62,geogpt-14b-38bcpt,1719027874,1719075474,finished,1719027917,1719075474,A100-SXM4-80GB,8,48,64,448,43,47557
24179a94-1fe0-4881-9cf9-1246bda4a839,geogpt-qwen2-72b-11bcpt-2ep,1719037697,1719038319,finished,1719037758,1719038319,A100-SXM4-80GB,8,50,64,448,61,561
04b37309-0153-4633-8079-0c1f852ae28f,geogpt-qwen2-72b-11bcpt-2ep,1719038401,1719189483,finished,1719038461,1719189483,A100-SXM4-80GB,8,50,64,448,60,151022
24449b34-f166-4bc3-bb24-c96826624f9a,geogpt-eval-latest,1719044340,1719044462,finished,1719044360,1719044462,A100-SXM4-80GB,8,1,64,896,20,102
106f3537-a46d-4ac5-b65f-244f1d7aafec,geogpt-eval-latest,1719044686,1719101306,finished,1719044708,1719101306,A100-SXM4-80GB,8,1,64,896,22,56598
274c34bd-ede2-4123-8162-12902dd257dd,geo-router-weight-lr1e-4,1719045419,1719108841,finished,1719045480,1719108841,A100-SXM4-80GB,8,2,64,448,61,63361
4e5dec0c-9cb0-4076-b99e-315b95f8d8fb,geogpt-lxz-cft-new-mix-mtm1-72b,1719049054,1719072043,finished,1719049095,1719072043,A100-SXM4-80GB,8,16,64,448,41,22948
187319ca-59b2-4edc-83b1-6b6ca7953c9f,paly-qwen2-7b-sft,1719050565,1719051026,finished,1719050585,1719051026,A100-SXM4-80GB,8,1,64,896,20,441
b60cbbb6-0543-45e7-83d7-5bddf82c1c43,qwen2-72b-chat-sft-dpo,1719050646,1719051410,finished,1719050666,1719051410,A100-SXM4-80GB,8,1,64,448,20,744
e35b5212-276d-401a-b525-54eaec4c5e31,paly-qwen2-7b-sft,1719051348,1719051691,finished,1719051369,1719051691,A100-SXM4-80GB,8,1,64,896,21,322
e5eda879-1c0e-40e1-9aaf-388bc7eb349e,qwen2-72b-chat-sft-dpo,1719051691,1719107421,finished,1719051712,1719107421,A100-SXM4-80GB,8,1,64,448,21,55709
3dd3d21f-9f1e-4564-985f-81b92ad9ab5e,paly-qwen2-7b-sft,1719052916,1719053361,finished,1719052937,1719053361,A100-SXM4-80GB,8,1,64,896,21,424
b0e6a8d5-dd70-45f0-ab5c-1f960b2b77bb,geogpt-lxz-cft-1-8m-subset-m1l3-72b,1719053940,1719085109,finished,1719054000,1719085109,A100-SXM4-80GB,8,16,64,448,60,31109
ab9d71c3-5b54-4ddf-8a18-1b063eefee7d,easy-context-llama3-copy,1719054080,1719054594,finished,1719054120,1719054594,A100-SXM4-80GB,8,2,64,448,40,474
5184ab29-d773-49f7-9b6a-3b3f3fc7816e,easy-context-llama3-copy,1719054594,1719055825,finished,1719054653,1719055825,A100-SXM4-80GB,8,2,64,448,59,1172
c691aeb6-5c65-4c9f-acc7-96f9e42b0751,easy-context-llama3-copy,1719056002,1719057998,finished,1719056041,1719057998,A100-SXM4-80GB,8,2,64,448,39,1957
0e50aa15-f494-4bd8-82bd-0d056c5dcc67,lzk-structllm,1719058009,1719058228,finished,1719058030,1719058228,A100-SXM4-80GB,8,1,64,448,21,198
619e5e9e-820a-4d8b-b335-d474ac8e0735,easy-context-llama3-copy,1719058155,1719106597,finished,1719058216,1719106597,A100-SXM4-80GB,8,2,64,448,61,48381
4016486b-432f-4a13-9b5a-908dbf788254,lzk-structllm,1719058579,1719176494,finished,1719058600,1719176494,A100-SXM4-80GB,8,1,64,448,21,117894
d415c706-0f44-4222-8d17-3ee5b02a4530,lzk-qwen15-7b-scihub-abstract-cpt,1719058835,1719059187,finished,1719058855,1719059187,A100-SXM4-80GB,8,1,64,448,20,332
8d91a61f-7444-46f8-b3c1-34309d93f585,lzk-qwen15-7b-scihub-abstract-cpt,1719059928,1719089426,finished,1719059949,1719089426,A100-SXM4-80GB,8,1,64,448,21,29477
e1b52c84-13d1-4574-b0f9-4c9d8d7d067f,lzk-qwen15-7b-scihub-abstract-with-struct-cpt,1719060534,1719141755,finished,1719060555,1719141755,A100-SXM4-80GB,8,1,64,448,21,81200
c19e8db9-061f-4ca1-aa26-7a975dc6c809,geogpt-table-qwen2-72b-datav041,1719064012,1719064210,finished,1719064071,1719064210,A100-SXM4-80GB,8,4,64,896,59,139
5017c2d1-35aa-4935-a3e3-30c8cd7dbd97,geogpt-table-qwen2-72b-datav041,1719064406,1719113408,finished,1719064466,1719113408,A100-SXM4-80GB,8,4,64,896,60,48942
a4242c41-0170-43a3-9a4e-f1ae396cec09,Qwen2-72B-Instruct-69e18-auto,1719066896,1719068046,finished,1719066917,1719068046,A100-SXM4-80GB,8,1,64,448,21,1129
5732d627-44da-4ea3-bca8-54eae0c9dea2,Qwen1-5-110B-Chat-2fb64-auto,1719066995,1719068369,finished,1719067015,1719068369,A100-SXM4-80GB,8,1,64,448,20,1354
99eb4cbb-c8a1-403c-8426-9253d5274b3d,Qwen1-5-72B-Chat-51ada-auto,1719067034,1719068268,finished,1719067055,1719068268,A100-SXM4-80GB,8,1,64,448,21,1213
c590acbf-4f7e-462d-9173-74cda5ab611c,Llama-3-70B-Instruct-e90c3-auto,1719067076,1719068369,finished,1719067097,1719068369,A100-SXM4-80GB,8,1,64,448,21,1272
8fbab923-a133-4293-ac53-795fa450b62c,Llama-3-70B-Instruct-a71f6-auto,1719067098,1719069460,finished,1719068068,1719069460,A100-SXM4-80GB,8,1,64,448,970,1392
a650d7f3-e511-4c6a-a974-c89cef3ccd82,Qwen1-5-72B-Chat-b9d25-auto,1719067138,1719069340,finished,1719068289,1719069340,A100-SXM4-80GB,8,1,64,448,1151,1051
d3e51448-5b84-45f5-9206-31c5ebec02ea,Qwen2-72B-Instruct-caf86-auto,1719067218,1719069757,finished,1719068390,1719069757,A100-SXM4-80GB,8,1,64,448,1172,1367
f80852e8-5a7f-47c1-8629-28dc67978f50,geogpt-lxz-cft-1-8m-4-5-subset-72b,1719070295,1719090850,finished,1719070334,1719090850,A100-SXM4-80GB,8,16,64,448,39,20516
40e09263-f7f4-4c60-b194-e1438804d717,geogpt-lxz-cft-new-mix-mtm1-72b,1719072103,1719104039,finished,1719072143,1719104039,A100-SXM4-80GB,8,16,64,448,40,31896
42c57824-7ed3-40df-a2e6-e8e5a95ad497,geogpt-lxz-cft-new-mix-m1l3-72b,1719075471,1719129615,finished,1719075531,1719129615,A100-SXM4-80GB,8,16,64,448,60,54084
f7318174-d7d3-4065-8a7e-5612b0ea2695,geogpt-lxz-cft-1-8m-subset-m1l3-72b,1719103421,1719118743,finished,1719103481,1719118743,A100-SXM4-80GB,8,16,64,448,60,15262
a78eec06-bd7a-4aa6-844d-83e1a5dd6682,geogpt-lxz-cft-1-8m-4-5-subset-72b,1719103442,1719105573,finished,1719103506,1719105573,A100-SXM4-80GB,8,16,64,448,64,2067
8e773c20-53b3-4a03-ac7c-4e973cde360d,sft-tulu-v2-14b-eval,1719104600,1719191714,finished,1719104620,1719191714,A100-SXM4-80GB,8,1,64,448,20,87094
f1177a1f-29ee-4311-b4b4-b42b02064864,slimorca-geo-mtm1-mt-ultra-14b,1719106002,1719142047,finished,1719106024,1719142047,A100-SXM4-80GB,8,1,64,448,22,36023
2005a0a0-285f-4925-8149-f9ac634b35fa,geogpt-llama3-cpt1ep-sft-jsonl,1719106406,1719192037,finished,1719106466,1719192037,A100-SXM4-80GB,8,48,64,448,60,85571
3c181501-547c-4259-9f1c-091724112c87,geogpt-qwen2-cpt-dare-fusion,1719110363,1719111821,finished,1719110383,1719111821,A100-SXM4-80GB,8,1,64,448,20,1438
bc7ad34c-cad4-4613-baa7-c1e4dac405e6,geogpt-qwen2-cpt-dare-fusion,1719111861,1719113057,finished,1719111880,1719113057,A100-SXM4-80GB,8,1,64,448,19,1177
d921aa37-a223-452f-b0fb-0c379805b09c,geogpt-eval-latest,1719111998,1719147409,finished,1719112017,1719147409,A100-SXM4-80GB,8,1,64,896,19,35392
2e54790b-b03e-4b57-8ce0-056729512f94,geogpt-qwen2-cpt-dare-fusion,1719113233,1719200365,finished,1719113253,1719200365,A100-SXM4-80GB,8,1,64,448,20,87112
02262dc1-fc0a-4b7f-a19b-b64e1de9e671,geogpt-eval-deductive,1719113394,1719113472,finished,1719113414,1719113472,A100-SXM4-80GB,8,1,64,896,20,58
558a434c-348c-44ad-ab55-fdf5755acb02,qwen2-72b-chat-sft-dpo,1719113491,1719200440,finished,1719113512,1719200440,A100-SXM4-80GB,8,1,64,448,21,86928
00c7f544-6f05-4aae-bfd8-716bdd07b34d,geogpt-eval-deductive,1719113550,1719113629,finished,1719113570,1719113629,A100-SXM4-80GB,8,1,64,896,20,59
d9e6db53-b906-4396-9d47-8019518c9e21,geogpt-eval-deductive,1719114059,1719114178,finished,1719114079,1719114178,A100-SXM4-80GB,8,1,64,896,20,99
24d13475-c1d7-4fbb-8642-1ec7cbe96fe6,geogpt-eval-deductive,1719114592,1719114731,finished,1719114612,1719114731,A100-SXM4-80GB,8,1,64,896,20,119
79578a1b-52d4-4f68-8f70-046c10aa5888,geogpt-eval-deductive,1719114850,1719115069,finished,1719114872,1719115069,A100-SXM4-80GB,8,1,64,896,22,197
9a079b26-ad23-4180-8bd0-46fa594ac4e0,easy-context-llama3-copy,1719114861,1719145192,finished,1719114921,1719145192,A100-SXM4-80GB,8,2,64,448,60,30271
332369b3-8d79-40f3-9d2f-674910f6d678,geogpt-eval-deductive,1719115291,1719115370,finished,1719115311,1719115370,A100-SXM4-80GB,8,1,64,896,20,59
e9c0d578-7b46-4439-9239-add6a1a145ad,geogpt-eval-deductive,1719115723,1719116021,finished,1719115743,1719116021,A100-SXM4-80GB,8,1,64,896,20,278
6f426e88-bd13-4eea-9d75-286577325b7a,llama-factory-zj-test,1719116172,1719117065,finished,1719116233,1719117065,A100-SXM4-80GB,8,4,64,896,61,832
e46029ac-8aa3-4a5a-ac02-cd620f2dafdb,geogpt-eval-deductive,1719116263,1719116401,finished,1719116283,1719116401,A100-SXM4-80GB,8,1,64,896,20,118
9883e015-47d1-4971-92a4-a2368b83ee9b,geogpt-eval-deductive,1719116579,1719116758,finished,1719116600,1719116758,A100-SXM4-80GB,8,1,64,896,21,158
fe70a4f0-ae9f-43a8-b10e-d74cc1066100,llama-factory-zj-test,1719117065,1719117839,finished,1719117124,1719117839,A100-SXM4-80GB,8,4,64,896,59,715
16c35c42-53a3-4356-a41a-d09a0014a299,geogpt-eval-deductive,1719117252,1719117570,finished,1719117273,1719117570,A100-SXM4-80GB,8,1,64,896,21,297
56e6b261-bbb9-482c-8fab-9c0be589343e,geogpt-eval-deductive,1719117570,1719118198,finished,1719117589,1719118198,A100-SXM4-80GB,8,1,64,896,19,609
f44b68e2-71ea-49e1-947a-bbd94c5e94d7,llama-factory-zj-test,1719117839,1719118714,finished,1719117879,1719118714,A100-SXM4-80GB,8,4,64,896,40,835
6c4f41fd-ad56-47e2-b009-cfa02f88c341,geogpt-7b-llamapro40-38bcpt2ep,1719118066,1719118322,finished,1719118125,1719118322,A100-SXM4-80GB,8,32,64,448,59,197
bce60d1d-2c03-4a42-95fa-fd6db1619a5d,geogpt-7b-llamapro40-38bcpt2ep,1719118432,1719213722,finished,1719118492,1719213722,A100-SXM4-80GB,8,32,64,448,60,95230
9f66d8a6-284b-4ea2-9f13-bcbb21125fe3,llama-factory-zj-test,1719118714,1719119632,finished,1719118777,1719119632,A100-SXM4-80GB,8,4,64,896,63,855
a98f24a6-1cb9-4ab8-bfd9-b1a089937757,geogpt-eval-deductive,1719119280,1719119421,finished,1719119301,1719119421,A100-SXM4-80GB,8,1,64,896,21,120
91d09855-7866-4e6b-b3bd-212f17f7c69f,geogpt-eval-deductive,1719119421,1719121866,finished,1719119441,1719121866,A100-SXM4-80GB,8,1,64,896,20,2425
7a4ad96f-20f4-41cc-a86e-215d44a51f5e,llama-factory-zj-test,1719119632,1719122650,finished,1719119691,1719122650,A100-SXM4-80GB,8,10,64,896,59,2959
8cdd197f-d902-4d47-9e3b-6a589687af24,geogpt-lxz-cft-1-8m-subset-m1l3-72b,1719119879,1719132206,finished,1719119920,1719132206,A100-SXM4-80GB,8,16,64,448,41,12286
0c73ec37-3c77-49a4-b8e1-e5a5f7ad30b9,geogpt-upcycle-4x14b-sf4,1719120144,1719130244,finished,1719129655,1719130244,A100-SXM4-80GB,8,16,64,896,9511,589
bcefca9e-98b8-4967-990b-473b4b3adba0,geogpt-eval-common-latest,1719121091,1719178735,finished,1719121112,1719178735,A100-SXM4-80GB,8,1,64,896,21,57623
6b1db5a9-862a-4c94-be6f-46130fc341fb,geogpt-eval-deductive,1719122200,1719122537,finished,1719122221,1719122537,A100-SXM4-80GB,8,1,64,896,21,316
f2ba72ca-b265-42ec-927a-2a6f3f2fece5,llama-factory-zj-test,1719122650,1719124130,finished,1719122709,1719124130,A100-SXM4-80GB,8,10,64,896,59,1421
cbf70d33-efb4-467a-aba7-cde896eb7b23,geogpt-eval-deductive,1719122743,1719123332,finished,1719122763,1719123332,A100-SXM4-80GB,8,1,64,896,20,569
a5ef56b1-3798-4acf-a110-8c0564946911,geogpt-eval-deductive,1719123332,1719126928,finished,1719123352,1719126928,A100-SXM4-80GB,8,1,64,896,20,3576
2ca11b5a-eac5-4820-831b-8cd9d75c9cd4,llama-factory-zj-test,1719124130,1719127777,finished,1719124190,1719127777,A100-SXM4-80GB,8,10,64,896,60,3587
50504c74-3ca5-4fa7-9c11-41e05bbebe85,geogpt-eval-inductive,1719124625,1719125982,finished,1719124646,1719125982,A100-SXM4-80GB,8,1,64,896,21,1336
b658f604-3a8f-484a-9e46-d810bb7008d8,geogpt-eval-deductive,1719126928,1719127127,finished,1719126948,1719127127,A100-SXM4-80GB,8,1,64,896,20,179
78723006-2078-4a24-8d2e-934f28d8e2ec,geogpt-eval-inductive,1719127167,1719128642,finished,1719127187,1719128642,A100-SXM4-80GB,8,1,64,896,20,1455
b97d9cbb-daa8-42da-b09f-2d8dccdf3fa8,geogpt-eval-deductive,1719127424,1719129020,finished,1719127445,1719129020,A100-SXM4-80GB,8,1,64,896,21,1575
3bf8b802-ad8a-48b3-8e84-73604264d9b2,llama-factory-zj-test,1719127777,1719182291,finished,1719130320,1719182291,A100-SXM4-80GB,8,20,64,896,2543,51971
d6dde0ce-6082-4c78-a9b0-c7b34c9d6e1d,geogpt-eval-inductive,1719129080,1719133618,finished,1719129100,1719133618,A100-SXM4-80GB,8,1,64,896,20,4518
6f4f3c84-c117-4b5f-a96b-3bdf1fb04836,geogpt-eval-deductive,1719129477,1719129706,finished,1719129498,1719129706,A100-SXM4-80GB,8,1,64,896,21,208
07fde70d-e152-4d2d-88f9-80136d069011,geogpt-eval-deductive,1719129706,1719132658,finished,1719129726,1719132658,A100-SXM4-80GB,8,1,64,896,20,2932
52c1a282-8e9c-47e7-97ca-8926f18fbd78,geogpt-upcycle-4x14b-sf4,1719130305,1719132579,finished,1719132248,1719132579,A100-SXM4-80GB,8,16,64,896,1943,331
16f63d88-9813-4dfe-9d07-455945b4ad3b,geogpt-lxz-sft-1-8m-tablellm-110b-eval,1719130934,1719210605,finished,1719130955,1719210605,A100-SXM4-80GB,8,1,64,448,21,79650
bf012c47-39fb-4d75-a92b-aa62a9ead31d,geogpt-lxz-cft-1-8m-subset-m1l3-72b,1719132276,1719141479,finished,1719132646,1719141479,A100-SXM4-80GB,8,16,64,448,370,8833
4def2c9b-34ee-4488-971f-58d1d392e38a,geogpt-upcycle-4x14b-sf4,1719132646,1719141792,finished,1719141520,1719141792,A100-SXM4-80GB,8,16,64,896,8874,272
e2bff883-4b84-4380-b928-597c461ce034,geogpt-eval-deductive,1719132658,1719132902,finished,1719132678,1719132902,A100-SXM4-80GB,8,1,64,896,20,224
6d7b3499-83aa-46d3-bae9-636462c15ce1,geogpt-eval-deductive,1719133275,1719136206,finished,1719133295,1719136206,A100-SXM4-80GB,8,1,64,896,20,2911
7b4d46c9-a5aa-447a-b70c-26a23bf82520,geogpt-eval-inductive,1719133618,1719136025,finished,1719133638,1719136025,A100-SXM4-80GB,8,1,64,896,20,2387
0531144f-0707-43e8-a05a-1fd6b1491d29,geogpt-eval-abductive,1719133657,1719142978,finished,1719133678,1719142978,A100-SXM4-80GB,8,1,64,896,21,9300
4d50fef2-7dc0-4eda-b4fa-9a09501a3b89,lzk-qwen15-7b-scihub-abstract-cpt,1719134798,1719261758,finished,1719141779,1719261758,A100-SXM4-80GB,8,1,64,448,6981,119979
9d5b7efa-6ed2-4f6a-87bd-117922240704,geogpt-eval-inductive,1719136025,1719142998,finished,1719136045,1719142998,A100-SXM4-80GB,8,1,64,896,20,6953
28740995-42c1-4685-bfa4-4fe29360efd3,geogpt-eval-deductive,1719136408,1719142998,finished,1719136429,1719142998,A100-SXM4-80GB,8,1,64,896,21,6569
b869cab2-f0c1-4641-9528-3dedd1bb14ce,geogpt-lxz-cft-new-mix-mtm1-m1l3-72b-2,1719141814,1719201089,finished,1719141859,1719201089,A100-SXM4-80GB,8,16,64,448,45,59230
4d168f9b-aa83-4027-8cd6-191958205e52,slimorca-geo-mtm1-mt-wild-14b,1719142089,1719145303,finished,1719142109,1719145303,A100-SXM4-80GB,8,1,64,448,20,3194
60790330-4c67-47ef-8432-af312b06197e,geogpt-eval-abductive,1719143280,1719148544,finished,1719143300,1719148544,A100-SXM4-80GB,8,1,64,896,20,5244
c6b2db42-240e-4ff1-97a6-3fc62bfe1e9e,lzk-qwen15-7b-scihub-abstract-with-struct-cpt,1719143910,1719145184,finished,1719145083,1719145184,A100-SXM4-80GB,8,1,64,448,1173,101
2eb567f4-9649-4cac-a5b4-2da18fecd41d,lzk-qwen15-7b-scihub-abstract-with-struct-cpt,1719145184,1719266374,finished,1719145205,1719266374,A100-SXM4-80GB,8,1,64,448,21,121169
ae7918a0-77fa-4838-b14c-ac89ecadda8c,easy-context-llama3-copy,1719145192,1719147046,finished,1719145236,1719147046,A100-SXM4-80GB,8,2,64,448,44,1810
d2fd1883-7586-4c2c-b359-2efa409c7f0b,geogpt-dairui-model-merge-exp-1,1719146761,1719198677,finished,1719146782,1719198677,A100-SXM4-80GB,8,1,64,896,21,51895
4548295f-3de8-41dd-a799-7b9f667e5205,geogpt-upcycle-4x14b-sf4,1719147000,1719182955,finished,1719182297,1719182955,A100-SXM4-80GB,8,16,64,896,35297,658
cb83719a-91e7-4db4-a73b-846eb975f931,geogpt-lxz-cft-new-mix-geotable-1-8m-sub-m1l3-72b,1719147003,1719195718,finished,1719182345,1719195718,A100-SXM4-80GB,8,16,64,448,35342,13373
0798a2af-223c-49df-b2c5-8024ba598345,easy-context-llama3-copy,1719147046,1719192711,finished,1719147106,1719192711,A100-SXM4-80GB,8,2,64,448,60,45605
1535dc37-8b92-4102-b9ae-1d1ca69a4bd8,geo-router-softmax-reserve-fullatten,1719153513,1719154490,finished,1719153574,1719154490,A100-SXM4-80GB,8,4,64,448,61,916
6812ff7d-9a35-4879-b359-1a2c6cf12294,geo-router-softmax-reserve-fullatten,1719154490,1719159549,finished,1719154530,1719159549,A100-SXM4-80GB,8,4,64,448,40,5019
786d8f69-2ca5-455b-b363-54cc17146b39,geo-router-block-weight-fullatten,1719159609,1719160425,finished,1719159670,1719160425,A100-SXM4-80GB,8,4,64,448,61,755
4768bd70-bbd3-4a50-9ba0-48b994c8f7a3,geo-router-block-weight-fullatten,1719160425,1719193396,finished,1719160487,1719193396,A100-SXM4-80GB,8,4,64,448,62,32909
9536f573-04fb-4038-a155-4c1efee3f238,geo-router-block-weight,1719160447,1719191122,finished,1719160508,1719191122,A100-SXM4-80GB,8,4,64,448,61,30614
c049dbb2-06c7-412f-993b-33de0e737e68,geo-seesaw-sft-code-alpaca-ultra-eval-test,1719161872,1719213789,finished,1719161892,1719213789,A100-SXM4-80GB,8,1,64,896,20,51897
45f565a4-e9b0-47c0-8a47-b829db8d5170,geogpt-table-qwen2-72b-datav051,1719163272,1719288361,finished,1719182340,1719288361,A100-SXM4-80GB,8,4,64,896,19068,106021
d9efdc73-61f6-457e-a0c2-1be923c1bf31,geogpt-upcycle-4x14b-sf4,1719183017,1719214827,finished,1719189518,1719214827,A100-SXM4-80GB,8,16,64,896,6501,25309
2a955c23-d9ed-4323-a344-3d72e3b1ebd4,geogpt-qwen2-72b-11bcpt-2ep,1719189575,1719244165,finished,1719192096,1719244165,A100-SXM4-80GB,8,50,64,448,2521,52069
8a528c27-8624-44f2-becb-7bb46dbebf9f,ruler-eval-0624,1719191841,1719195863,finished,1719191862,1719195863,A100-SXM4-80GB,8,1,64,896,21,4001
8230dc2d-8005-43a4-9703-5bf77e6b7e5a,easycontext-llama3,1719191864,1719384648,finished,1719191926,1719384648,A100-SXM4-80GB,8,40,64,448,62,192722
a3b1cc98-6f98-481e-b9ad-83ea3711f807,easy-context-llama3-copy,1719192787,1719193733,finished,1719192844,1719193733,A100-SXM4-80GB,8,2,64,448,57,889
d4d3f055-18e6-4d98-bc14-94efdebe17b2,txchen-eval,1719194088,1719198223,finished,1719194108,1719198223,A100-SXM4-80GB,8,1,64,448,20,4115
381738a3-67e1-40ed-b66c-31003c9ec18a,table-iso-002,1719194533,1719195769,finished,1719194553,1719195769,A100-SXM4-40GB,1,1,16,256,20,1216
79217a67-9bd3-432c-a902-d32ec3db5ab0,easy-context-llama3-copy,1719194552,1719195672,finished,1719194591,1719195672,A100-SXM4-80GB,8,2,64,448,39,1081
882f436c-07f6-43d2-aa99-eeaf318aa7f5,qwen2-72b-sft-dpo,1719194926,1719195440,finished,1719194985,1719195440,A100-SXM4-80GB,8,4,64,896,59,455
14c05693-c9f8-46cc-8d83-17a6f3f68f7c,gpt-megatron,1719195573,1719195972,finished,1719195631,1719195972,A100-SXM4-80GB,8,4,64,448,58,341
10d6c1f9-8ed0-417a-b725-4b1984612246,geogpt-lxz-cft-new-mix-geotable-1-8m-sub-m1l3-72b,1719195718,1719201483,finished,1719195775,1719201483,A100-SXM4-80GB,8,16,64,448,57,5708
90801927-0839-4ae0-88b9-b30c3882f0d1,intent-train-llm-lora-gpt,1719195751,1719195866,finished,1719195770,1719195866,A100-SXM4-80GB,8,1,64,448,19,96
22817902-605b-4825-a907-6d8b36fa2978,table-iso-002,1719195770,1719196330,finished,1719195795,1719196330,A100-SXM4-40GB,1,1,16,256,25,535
712b985f-06fd-4b72-a1f3-00e75c39c18f,intent-train-llm-lora-gpt,1719195957,1719196186,finished,1719195975,1719196186,A100-SXM4-80GB,8,1,64,448,18,211
935bb852-7ec6-4ef3-870b-ffd5b6c7c7b8,qwen2-72b-sft-dpo,1719196123,1719200856,finished,1719196157,1719200856,A100-SXM4-80GB,8,4,64,896,34,4699
1a0697cd-7bfb-4ba5-a236-bd66d4b58915,intent-train-llm-lora-gpt,1719196275,1719196421,finished,1719196293,1719196421,A100-SXM4-80GB,8,1,64,448,18,128
8acbbdbe-c061-49ec-8391-8c75233f4d0b,table-iso-002,1719196330,1719196768,finished,1719196348,1719196768,A100-SXM4-40GB,1,1,16,256,18,420
6f88bf15-a339-4d01-8e4d-c296c92b23a1,Llama-2-70B-Chat-ed039-auto,1719196410,1719196759,finished,1719196429,1719196759,A100-SXM4-80GB,8,1,64,448,19,330
57de2a7e-29fa-4574-b4ce-be0ec55db251,geogpt-dairui-eval-code-2,1719196479,1719196605,finished,1719196497,1719196605,A100-SXM4-80GB,8,1,64,448,18,108
aea2cecd-482f-43c2-8ee0-ec7f9060d2b8,table-iso-002,1719196768,1719198841,finished,1719196786,1719198841,A100-SXM4-40GB,1,1,16,256,18,2055
c4b68062-4ae0-409b-b722-68d3ebdba9be,gpt-megatron,1719196836,1719198520,finished,1719197390,1719198520,A100-SXM4-80GB,8,4,64,448,554,1130
60531f41-69ae-4455-ad03-bca726ee7a75,ls2,1719196910,1719198992,finished,1719196930,1719198992,A100-SXM4-80GB,8,1,64,896,20,2062
2442b310-8ed7-46ed-be16-6ed145aa5efb,citysora-modelv4-webvid-cele-laion-joint-65-256,1719197322,1719213162,finished,1719197358,1719213162,A100-SXM4-80GB,8,5,64,896,36,15804
4342171a-8693-4ff7-adc7-c471eda41233,dockertest,1719197573,1719198602,finished,1719198543,1719198602,A100-SXM4-80GB,8,1,64,448,970,59
92a3f7cd-fd9d-4e72-8cb7-d0e9ef5c36db,geogpt-dairui-eval-code-2,1719197689,1719198658,finished,1719198526,1719198658,A100-SXM4-80GB,8,1,64,448,837,132
c519594c-6d99-4d6e-abb9-0fabf1d41541,geogpt-qwen2-chat-0612dpo-dare-ties-p51,1719197872,1719199857,finished,1719198547,1719199857,A100-SXM4-80GB,8,1,64,448,675,1310
e7f0f043-1750-4834-8cd9-ad9c9d220d42,geogept-gate-eval,1719198000,1719198682,finished,1719198590,1719198682,A100-SXM4-80GB,8,1,64,448,590,92
e0d604d2-b6b6-41b9-8849-75a81f3ed7e2,intent-train-llm-lora-gpt,1719198066,1719199123,finished,1719198602,1719199123,A100-SXM4-80GB,8,1,64,448,536,521
21617426-6611-4a87-965c-4aedf96fda02,geogpt-dairui-eval-code,1719198090,1719198657,finished,1719198526,1719198657,A100-SXM4-80GB,8,1,64,896,436,131
dbaa1dd5-a4bc-4ef3-a133-c7464c0e03d7,geogpt-cft-fusion17-newmix100k-geo92k,1719198606,1719203356,finished,1719201124,1719203356,A100-SXM4-80GB,8,16,64,448,2518,2232
328cb819-1f83-422f-ae60-2f29b09ea24a,txchen-eval,1719198759,1719198887,finished,1719198778,1719198887,A100-SXM4-80GB,8,1,64,448,19,109
edb796fa-414c-4294-91a1-218b130680e7,gpt-megatron,1719198765,1719199101,finished,1719198819,1719199101,A100-SXM4-80GB,8,2,64,448,54,282
1fcf84b4-db47-4ef2-a87c-d709714bffa8,table-iso-002,1719198842,1719200161,finished,1719198859,1719200161,A100-SXM4-40GB,1,1,16,256,17,1302
b70bace2-ac7e-4155-a3a1-8f82a73a9e71,geogpt-dairui-eval-code,1719198975,1719199713,finished,1719198996,1719199713,A100-SXM4-80GB,8,1,64,896,21,717
fa51b2d7-8a41-4f71-80bc-eba66a9de8b2,txchen-eval,1719198985,1719199520,finished,1719199133,1719199520,A100-SXM4-80GB,8,1,64,448,148,387
e429b44f-80ee-4f24-9e84-5c151ac8f71b,ls2,1719198992,1719206373,finished,1719199121,1719206373,A100-SXM4-80GB,8,1,64,896,129,7252
c261fcce-d531-4bce-b80b-3d006723ae65,geogpt-dairui-eval-code-2,1719198996,1719199307,finished,1719199087,1719199307,A100-SXM4-80GB,8,1,64,448,91,220
0c66559a-1c13-446d-b63b-ee1b09d93cf7,geogpt-dairui-model-merge-exp-1,1719199087,1719211255,finished,1719199107,1719211255,A100-SXM4-80GB,8,1,64,896,20,12148
a0255518-db3a-46c7-83de-cb06c4126e48,geogpt-qwen2-chat-0612dpo-dare-ties-p17,1719199327,1719200039,finished,1719199513,1719200039,A100-SXM4-80GB,8,1,64,448,186,526
f362617c-6341-4a2d-be66-2c953dbdd6ae,Qwen1-5-110B-Chat-83537-auto,1719199446,1719216438,finished,1719199720,1719216438,A100-SXM4-80GB,8,1,64,448,274,16718
09b18536-54d2-4d52-a4a7-b903562199b5,txchen-eval,1719199685,1719199810,finished,1719199702,1719199810,A100-SXM4-80GB,8,1,64,448,17,108
996562a9-2484-49f8-b3af-970f82670029,gpt-megatron,1719199779,1719200377,finished,1719200121,1719200377,A100-SXM4-80GB,8,2,64,448,342,256
db0ff727-adbf-4525-bd37-ce4e4ea694fb,geogept-gate-eval,1719199949,1719200060,finished,1719199967,1719200060,A100-SXM4-80GB,8,1,64,448,18,93
bf3f88bb-f5fb-44aa-bdda-9118bde51822,geogpt-dairui-eval-code-2,1719200037,1719200346,finished,1719200074,1719200346,A100-SXM4-80GB,8,1,64,448,37,272
41e4b750-6f4d-4a48-a959-a3a457c27819,table-iso-002,1719200161,1719200779,finished,1719200179,1719200779,A100-SXM4-40GB,1,1,16,256,18,600
0f21546e-c172-4e75-b5a5-73966aad0a51,geogpt-dairui-eval-code,1719200237,1719201105,finished,1719200364,1719201105,A100-SXM4-80GB,8,1,64,896,127,741
99fd0f3c-dee0-4603-b9ae-40a699f75fe5,txchen-eval,1719200499,1719225346,finished,1719200519,1719225346,A100-SXM4-80GB,8,1,64,448,20,24827
7abec07b-92b9-4617-9c49-46b0e02ca0d7,geogpt-dairui-eval-code-2,1719200621,1719200799,finished,1719200639,1719200799,A100-SXM4-80GB,8,1,64,448,18,160
5f252ba0-5f58-42a9-9b81-28e3699ac380,table-iso-002,1719200779,1719201264,finished,1719200796,1719201264,A100-SXM4-40GB,1,1,16,256,17,468
473414e8-e9b2-4be3-a1d3-6831f37124dd,geogept-gate-eval,1719201000,1719201191,finished,1719201018,1719201191,A100-SXM4-80GB,8,1,64,448,18,173
48e67b82-2b68-4e20-9bf7-af786ff38921,geogpt-lxz-cft-new-mix-mtm1-m1l3-72b-2,1719201151,1719203100,finished,1719201535,1719203100,A100-SXM4-80GB,8,16,64,448,384,1565
fc52c5b1-0d08-4868-88f6-6ef79364a21c,geogpt-qwen2-chat-0612dpo-dare-ties-p17,1719201153,1719288266,finished,1719201170,1719288266,A100-SXM4-80GB,8,1,64,448,17,87096
265ba339-0a5f-44f8-b02c-8c459dc6f777,geogpt-qwen2-cpt-dare-fusion,1719201208,1719227204,finished,1719201227,1719227204,A100-SXM4-80GB,8,1,64,448,19,25977
fa02ffb9-3c14-45e3-883d-796e84ce2e61,geogpt-qwen2-chat-0612dpo-dare-ties-p51,1719201228,1719288477,finished,1719201249,1719288477,A100-SXM4-80GB,8,1,64,448,21,87228
cc5eff6c-1940-46be-a34d-69f84e0130f8,geogept-gate-eval,1719201252,1719255544,finished,1719201270,1719255544,A100-SXM4-80GB,8,1,64,448,18,54274
c36a97e9-d9d5-47b0-b598-00b90bdc5383,table-iso-002,1719201264,1719364103,finished,1719201282,1719364103,A100-SXM4-40GB,1,1,16,256,18,162821
b93506ba-6a1b-4728-be37-47e148114def,formula-iso-002,1719201439,1719201880,finished,1719201461,1719201880,A100-SXM4-40GB,1,1,8,96,22,419
0a813608-f534-492c-977b-50b39cc2e351,formula-iso-002,1719201880,1719209620,finished,1719201898,1719209620,A100-SXM4-40GB,1,1,8,96,18,7722
59d953d4-fe24-4618-8a99-97a1bc323a5c,geogpt-dairui-eval-code-2,1719203037,1719203605,finished,1719203057,1719203605,A100-SXM4-80GB,8,1,64,448,20,548
e2cdd253-ee0e-40cd-8b0e-69cb32aa217b,geogpt-dairui-eval-code,1719203056,1719207067,finished,1719203080,1719207067,A100-SXM4-80GB,8,1,64,896,24,3987
ce308333-d5cd-441b-9f9e-86f6e20068a3,geogpt-lxz-cft-new-mix-geotable-1-8m-sub-m1l3-72b,1719203119,1719203374,finished,1719203157,1719203374,A100-SXM4-80GB,8,16,64,448,38,217
64dc8a0d-e739-42a9-92a9-5f6892172f85,geogpt-lxz-cft-new-mix-mtm1-m1l3-72b-2,1719203200,1719204648,finished,1719203413,1719204648,A100-SXM4-80GB,8,16,64,448,213,1235
fccc9151-c17e-4f4e-b914-9f00d7ce3a09,geogpt-cft-fusion17-newmix100k-geo92k,1719203356,1719210586,finished,1719204685,1719210586,A100-SXM4-80GB,8,16,64,448,1329,5901
45fade13-1b32-4473-90e9-bfad81cfc6cd,geogpt-lxz-cft-new-mix-geotable-1-8m-sub-m1l3-72b,1719203374,1719205024,finished,1719203420,1719205024,A100-SXM4-80GB,8,16,64,448,46,1604
abe14316-a01f-4d2a-bfd5-f3f863e250de,gpt-megatron,1719203904,1719204319,finished,1719203959,1719204319,A100-SXM4-80GB,8,2,64,448,55,360
4ae2975e-c0d5-4f61-9256-27d0a680b2bb,dockertest,1719204643,1719204762,finished,1719204663,1719204762,A100-SXM4-80GB,8,1,64,448,20,99
61282032-1543-4e30-805c-4f0e603c397f,qwen2-72b-chat-sft-dpo,1719204695,1719291826,finished,1719204713,1719291826,A100-SXM4-80GB,8,1,64,448,18,87113
89671121-cea5-4122-acde-bc28dcd27383,geogpt-lxz-cft-new-mix-mtm1-m1l3-72b-2,1719204822,1719221523,finished,1719205061,1719221523,A100-SXM4-80GB,8,16,64,448,239,16462
33c9a4d0-ef1d-47b2-83e2-3844c296d495,geogpt-lxz-cft-new-mix-geotable-1-8m-sub-m1l3-72b,1719205158,1719222078,finished,1719213763,1719222078,A100-SXM4-80GB,8,16,64,448,8605,8315
d9bba4c3-ad76-47df-aa8d-ef4f6f656c22,geogpt-dairui-eval-code-2,1719207049,1719211255,finished,1719207067,1719211255,A100-SXM4-80GB,8,1,64,448,18,4188
de764917-117a-4aca-aa47-1b503b8b59f1,geogpt-eval-common-latest,1719207378,1719207487,finished,1719207396,1719207487,A100-SXM4-80GB,8,1,64,896,18,91
d2255ce6-cfa6-435c-bb24-2400a9610fa2,geogpt-dairui-model-merge-exp-2,1719207919,1719209088,finished,1719207938,1719209088,A100-SXM4-80GB,8,1,64,896,19,1150
71833109-153c-4003-ad42-7cc50391ded1,gpt-megatron,1719208043,1719209044,finished,1719208097,1719209044,A100-SXM4-80GB,8,2,64,448,54,947
860d6baf-9850-436c-94ae-7cb649cb5786,geogpt-eval-latest,1719208429,1719231382,finished,1719209014,1719231382,A100-SXM4-80GB,8,1,64,896,585,22368
91a5a8a1-0ff0-410e-84dc-b410facc15e4,geogpt-eval-common-latest,1719208429,1719518390,finished,1719209032,1719518390,A100-SXM4-80GB,8,1,64,896,603,309358
52b9d2e6-7103-4f35-88ce-e027bc98c095,llama3-rag,1719208443,1723023875,finished,1719209027,1723023875,A100-SXM4-80GB,8,1,64,448,584,3814848
5e44694b-8484-4c22-9f46-3e46c39fad2b,gpt-megatron,1719209487,1719211329,finished,1719210617,1719211329,A100-SXM4-80GB,8,2,64,448,1130,712
f418b049-0f0f-41eb-bd60-2797765d4c7d,intent-train-llm-lora-gpt,1719209509,1719211230,finished,1719210581,1719211230,A100-SXM4-80GB,8,1,64,448,1072,649
40f613cb-edd3-48b5-9385-295aa3ece0df,formula-iso-002,1719209620,1719209961,finished,1719209639,1719209961,A100-SXM4-40GB,1,1,8,96,19,322
5facc6b3-edde-483f-a967-d8c3ff4a8c71,geogpt-dairui-model-merge-exp-2,1719209830,1719211134,finished,1719210564,1719211134,A100-SXM4-80GB,8,1,64,896,734,570
70a49054-0b3f-4611-be45-087e977182fe,formula-iso-002,1719209961,1719211985,finished,1719209980,1719211985,A100-SXM4-40GB,1,1,8,96,19,2005
bfe47d12-012a-452c-ba3b-3809586148d4,llama3-instruct-70b,1719210225,1719228555,finished,1719210566,1719228555,A100-SXM4-80GB,8,1,64,448,341,17989
52f6016f-3a15-470d-9f61-7641282d2681,syh-subspace-moe-mathmed,1719210232,1719210632,finished,1719210573,1719210632,A100-SXM4-80GB,8,1,64,448,341,59
3dfd976e-4211-4c3f-8467-9262262fef9f,rag-tq-embedding-mistral,1719210460,1719383635,finished,1719210580,1719383635,A100-SXM4-80GB,8,1,64,448,120,173055
0084ddbf-e521-4fc9-96ef-e2357eeeebba,geogpt-cft-fusion17-newmix100k-geo92k,1719210586,1719216251,finished,1719213186,1719216251,A100-SXM4-80GB,8,16,64,448,2600,3065
1dc82c09-cd02-42ae-a013-e93c21aae445,sfr-embedding-test,1719210767,1719211444,finished,1719210787,1719211444,A100-SXM4-80GB,8,1,64,448,20,657
5637ab5a-aa19-426e-a586-f245ecbcf187,Llama-2-70B-Chat-24de8-auto,1719211200,1719212379,finished,1719211220,1719212379,A100-SXM4-80GB,8,1,64,448,20,1159
3e29846e-21d0-4028-9345-a59bfa961874,geogpt-dairui-model-merge-exp-1,1719211255,1719211488,finished,1719211275,1719211488,A100-SXM4-80GB,8,1,64,896,20,213
408755af-2b7d-4e49-a68a-eb1beec25b3f,geogpt-dairui-eval-code-2,1719211255,1719211488,finished,1719211275,1719211488,A100-SXM4-80GB,8,1,64,448,20,213
0fe05965-e5de-4cd5-b2b8-4ce0c370a26c,geogpt-llm-moe-expand-0-5B-soft-routing-12,1719211276,1719286669,finished,1719211297,1719286669,A100-SXM4-80GB,8,1,64,896,21,75372
b6d08775-daf1-4ed7-89ed-3ac3c95fe1eb,geogpt-dairui-eval-code-2,1719211488,1719285339,finished,1719211509,1719285339,A100-SXM4-80GB,8,1,64,448,21,73830
6f051b7d-fd5d-46d9-963d-883eecf412e2,geogpt-dairui-model-merge-exp-1,1719211488,1719285339,finished,1719211509,1719285339,A100-SXM4-80GB,8,1,64,896,21,73830
5131d58e-a628-435a-aa82-17bbec18f375,sfr-embedding-test,1719211562,1719213895,finished,1719211582,1719213895,A100-SXM4-80GB,8,1,64,448,20,2313
e882c0a2-946b-42d4-b475-4703f611a37c,intent-train-llm-lora-gpt,1719211831,1719212507,finished,1719211851,1719212507,A100-SXM4-80GB,8,1,64,448,20,656
e148fbba-d7fe-4c9b-9d45-934a4d30d11b,formula-iso-002,1719211985,1719215482,finished,1719212005,1719215482,A100-SXM4-40GB,1,1,8,96,20,3477
438274b1-8eb3-43d6-9828-49734089384c,gpt-megatron,1719212097,1719212870,finished,1719212154,1719212870,A100-SXM4-80GB,8,2,64,448,57,716
84bb0b75-3538-4756-9925-8f8da45b549d,syh-subspace-moe-mathmed,1719212518,1719212598,finished,1719212538,1719212598,A100-SXM4-80GB,8,1,64,448,20,60
78e7fc2a-ff08-4f40-9fa7-f4652133fc7c,ruler-eval-0624,1719212524,1719212603,finished,1719212543,1719212603,A100-SXM4-80GB,8,1,64,896,19,60
4c68ab8a-b8d4-46e5-8b7b-4b73f7999c21,intent-train-llm-lora-gpt,1719212567,1719213391,finished,1719212587,1719213391,A100-SXM4-80GB,8,1,64,448,20,804
2fac5d8f-e3ae-46f4-bf63-226406c68039,ruler-eval-0624,1719212715,1719213098,finished,1719212733,1719213098,A100-SXM4-80GB,8,1,64,896,18,365
12bdae9d-f92c-476d-8ef1-83c40e0f8603,syh-subspace-moe-mathmed,1719213017,1719213133,finished,1719213036,1719213133,A100-SXM4-80GB,8,1,64,448,19,97
0ce72020-92ad-4a92-8ebe-d80d5d13b98b,ruler-eval-0624,1719213098,1719238422,finished,1719213116,1719238422,A100-SXM4-80GB,8,1,64,896,18,25306
26063842-f6d0-459a-ab7c-4a4ef887fabc,syh-subspace-moe-math,1719213133,1719213281,finished,1719213173,1719213281,A100-SXM4-80GB,8,1,64,448,40,108
c45ea7ad-cdb2-4f93-8084-89a736036703,citysora-modelv4-webvid-cele-laion-joint-65-256,1719213162,1719285772,finished,1719213209,1719285772,A100-SXM4-80GB,8,5,64,896,47,72563
d5798572-8d69-4d26-a656-07ef585790e9,geo-router-softmax-lr-1e-4,1719213231,1719213857,finished,1719213739,1719213857,A100-SXM4-80GB,8,4,64,448,508,118
83bede51-36d9-4af5-9bcf-5fff7fa5f239,syh-subspace-moe-mathmed,1719213281,1719214931,finished,1719213705,1719214931,A100-SXM4-80GB,8,1,64,448,424,1226
96256b42-1262-4ee0-87d5-4346f4e0dab2,gpt-megatron,1719213287,1719214483,finished,1719213755,1719214483,A100-SXM4-80GB,8,2,64,448,468,728
3bfe3000-8d68-4615-b2dd-f52e70b1c9da,intent-train-llm-lora-gpt,1719213491,1719214524,finished,1719213714,1719214524,A100-SXM4-80GB,8,1,64,448,223,810
a0cba1de-7d7f-485d-99bd-12bab5f9ca7d,syh-subspace-moe-math,1719213563,1719214629,finished,1719213705,1719214629,A100-SXM4-80GB,8,1,64,448,142,924
814bb446-4b68-4c1a-ab8e-f7945673803c,citysora-modelv4-webvid-humanface-65-128,1719213573,1719289007,finished,1719213736,1719289007,A100-SXM4-80GB,8,4,64,896,163,75271
3b2846ae-9a36-4923-8ed0-714cdd197080,geogpt-btx-2x14b-sf4,1719213576,1719215296,finished,1719213811,1719215296,A100-SXM4-80GB,8,16,64,896,235,1485
83db239a-ce74-44e6-8999-bb21d4b787f9,sfr-embedding-test,1719213895,1719217830,finished,1719214821,1719217830,A100-SXM4-80GB,8,1,64,448,926,3009
651fb8ab-73e5-41a7-885a-14529bb652f0,ls2,1719214100,1719222093,finished,1719214821,1719222093,A100-SXM4-80GB,8,1,64,896,721,7272
60befcd2-e0f7-43c8-8da9-efc106a5723b,llama3-70b-base-cc715-auto,1719214759,1719216445,finished,1719214820,1719216445,A100-SXM4-80GB,8,1,64,896,61,1625
b514db33-3b0b-4616-bda0-69673d64f65e,sfr-ft-4,1719214821,1719314308,finished,1719214840,1719314308,A100-SXM4-80GB,8,1,64,448,19,99468
947941b1-3016-4068-ac19-60904c0d24f8,geo-router-softmax-lr-1e-4,1719214825,1719215329,finished,1719214885,1719215329,A100-SXM4-80GB,8,4,64,448,60,444
bdbbed75-cf6b-4e7c-9340-aba45d27361c,syh-subspace-moe-math,1719214894,1719215814,finished,1719214913,1719215814,A100-SXM4-80GB,8,1,64,448,19,901
f0badde7-9b29-413e-9c49-f31755689647,syh-subspace-moe-mathmed,1719214931,1719216866,finished,1719214949,1719216866,A100-SXM4-80GB,8,1,64,448,18,1917
126d26d1-fa44-4143-a823-b560658f6f10,geogpt-btx-2x14b-sf4,1719215350,1719215899,finished,1719215387,1719215899,A100-SXM4-80GB,8,16,64,896,37,512
b66cb82b-60ff-473b-9da8-b1d9496a1e32,geo-table-datav05-lora-5e-5,1719215366,1719215409,finished,1719215385,1719215409,A100-SXM4-40GB,8,1,32,320,19,24
d9581322-ee25-4d8d-b146-0cf8606a0ef9,formula-iso-002,1719215482,1719364123,finished,1719215502,1719364123,A100-SXM4-40GB,1,1,8,96,20,148621
f8093f22-4b20-4d4f-8781-496ae9dd7fda,geo-router-softmax-lr-1e-4,1719215486,1719221483,finished,1719215542,1719221483,A100-SXM4-80GB,8,4,64,448,56,5941
722b7e9c-3b57-4614-9c71-09733def4d9a,gpt-megatron,1719215499,1719215948,finished,1719215537,1719215948,A100-SXM4-80GB,8,2,64,448,38,411
04040b3d-27b0-4648-be29-7a1207af07db,geo-table-datav05-lora-5e-5,1719215504,1719219991,finished,1719215523,1719219991,A100-SXM4-80GB,8,1,64,448,19,4468
041275df-948b-4fb1-9e86-7267735c9f7f,txchen-train-task,1719215866,1719229652,finished,1719215888,1719229652,A100-SXM4-80GB,8,1,64,448,22,13764
bd6c6e5b-a084-474e-b88d-84e21d9d4ce8,geogpt-btx-2x14b-sf4,1719215954,1719216500,finished,1719216026,1719216500,A100-SXM4-80GB,8,16,64,896,72,474
49b708a3-4a98-401d-b3eb-98ccdee4d2e5,docxchain-iso-002,1719216135,1719297277,finished,1719216153,1719297277,A100-SXM4-40GB,1,1,8,32,18,81124
f8c2487b-89cd-413c-a122-6c6ff3cdbd6c,gpt-megatron,1719216338,1719217680,finished,1719216389,1719217680,A100-SXM4-80GB,8,2,64,448,51,1291
d8ea3a7b-ae2f-46a2-8038-8e7f220081fc,geogpt-cft-fusion17-newmix100k-geo92k-hy,1719216432,1719259869,finished,1719216506,1719259869,A100-SXM4-80GB,8,16,64,896,74,43363
5b67cbdf-88c2-4805-b3ad-bb07d053afe9,easy-context-llama3-copy,1719216485,1719217264,finished,1719216572,1719217264,A100-SXM4-80GB,8,2,64,448,87,692
9131d00b-1be5-49b9-b205-068d8fc98dc9,geogpt-btx-2x14b-sf4,1719216769,1719217078,finished,1719216829,1719217078,A100-SXM4-80GB,8,16,64,896,60,249
4520b812-360d-479b-bd4e-80797a4c7c4b,syh-subspace-moe-math,1719217158,1719217759,finished,1719217181,1719217759,A100-SXM4-80GB,8,1,64,448,23,578
1532ae54-1b4e-4095-9804-816601d9c549,qwen1-5-7b-64c1f-auto,1719217346,1719218342,finished,1719217370,1719218342,A100-SXM4-80GB,8,1,64,448,24,972
2cc6b46c-a789-47b3-8c1b-e40f318330b5,geogpt-btx-2x14b-sf4,1719217467,1719218211,finished,1719217515,1719218211,A100-SXM4-80GB,8,16,64,896,48,696
3cf6dacb-751a-45cc-acc0-6c6cc28676ec,qwen1-5-7b-chat-62d0d-auto,1719217757,1719218226,finished,1719217791,1719218226,A100-SXM4-80GB,8,1,64,448,34,435
0abee8bb-cb5b-4015-8839-e00d19a59274,syh-subspace-moe-mathmed,1719217758,1719220391,finished,1719217792,1719220391,A100-SXM4-80GB,8,1,64,448,34,2599
8d9c05da-b52e-47c6-b4f2-07d00aa3ab06,syh-subspace-moe-math,1719217759,1719218670,finished,1719217792,1719218670,A100-SXM4-80GB,8,1,64,448,33,878
bf709d3d-42c8-461d-945d-69261aae082e,qwen1-5-7b-scihub-abstract-lr1e-4-3503f-auto,1719217813,1719218226,finished,1719217843,1719218226,A100-SXM4-80GB,8,1,64,448,30,383
ecc743ca-b7fa-4496-b941-0412008c09f8,sfr-embedding-test,1719217831,1719285934,finished,1719217861,1719285934,A100-SXM4-80GB,8,1,64,448,30,68073
f7069f47-8708-4705-9193-d6b11abd1fbd,qwen1-5-7b-scihub-abstract-lr2e-5-5009f-auto,1719217913,1719218227,finished,1719217937,1719218227,A100-SXM4-80GB,8,1,64,448,24,290
94c34ef9-eac1-4c9f-846a-5199df7f6c2d,qwen1-5-7b-a1e70-auto,1719218306,1719219629,finished,1719218334,1719219629,A100-SXM4-80GB,8,1,64,448,28,1295
6a305c3c-32c3-4db9-b566-6ed15fef2dd3,geo-softmax-check,1719218575,1719218921,finished,1719218607,1719218921,A100-SXM4-80GB,8,1,64,448,32,314
921a621c-6912-423b-b030-c2ebbc840920,geogpt-btx-2x14b-sf4,1719218579,1719219365,finished,1719218649,1719219365,A100-SXM4-80GB,8,16,64,896,70,716
a40a23d8-b034-435f-9135-9a5a7faa9e3a,gpt-megatron,1719219002,1719219531,finished,1719219056,1719219531,A100-SXM4-80GB,8,2,64,448,54,475
becc33e9-df75-4e31-be22-5de7da9bbcfd,gpt-megatron,1719219531,1719220304,finished,1719219603,1719220304,A100-SXM4-80GB,8,2,64,448,72,701
9ddbd655-ac0e-478e-98e8-51fb0db7395c,qwen1-5-7b-c6347-auto,1719219557,1719220584,finished,1719219585,1719220584,A100-SXM4-80GB,8,1,64,448,28,999
4aabcc5d-d90b-4f73-ad0e-12256d970fa6,syh-subspace-eval,1719219596,1719306076,finished,1719219615,1719306076,A100-SXM4-80GB,8,1,64,448,19,86461
34b4b307-4926-4e99-98f3-56d8831c1147,easy-context-llama3-copy,1719220081,1719220441,finished,1719220125,1719220441,A100-SXM4-80GB,8,2,64,448,44,316
9869636f-bb9e-4428-8b26-cc1d315a5545,data-gen-magpie,1719220205,1719220304,finished,1719220231,1719220304,A100-SXM4-80GB,8,1,64,448,26,73
68b36057-dd94-48d7-a984-bebccdc344e8,data-gen-magpie,1719220624,1719220755,finished,1719220646,1719220755,A100-SXM4-80GB,8,1,64,448,22,109
927e1c33-863f-462d-8313-ed5151eb8041,data-gen-magpie,1719220900,1719221024,finished,1719220922,1719221024,A100-SXM4-80GB,8,1,64,448,22,102
1330953c-7fca-4afe-8025-c66640d6acf8,qwen1-5-7b-scihub-abstract-lr1e-4-33eb1-auto,1719220959,1719222312,finished,1719220992,1719222312,A100-SXM4-80GB,8,1,64,448,33,1320
f3bbe8ed-7b67-4481-a028-f5b160d91122,qwen1-5-7b-scihub-abstract-lr1e-4-55246-auto,1719221301,1719224611,finished,1719221335,1719224611,A100-SXM4-80GB,8,1,64,448,34,3276
16f7feeb-ece1-402c-87f7-5b3bfbd988df,geogpt-btx-2x14b-sf4,1719221633,1719222389,finished,1719221669,1719222389,A100-SXM4-80GB,8,16,64,896,36,720
33bfdef3-57c8-4d22-98e7-26b4415b3112,qwen1-5-7b-chat-171fa-auto,1719221750,1719225677,finished,1719221773,1719225677,A100-SXM4-80GB,8,1,64,448,23,3904
73f14e94-6666-461d-a40e-5b39f9665edc,easy-context-llama3-test,1719222021,1719223055,finished,1719222067,1719223055,A100-SXM4-80GB,8,2,64,448,46,988
ebb93e02-a705-412c-b476-656cab361283,geogpt-lxz-cft-new-mix-geotable-1-8m-sub-m1l3-72b,1719222352,1719223107,finished,1719222422,1719223107,A100-SXM4-80GB,8,16,64,448,70,685
b5eeff82-9cf9-4d00-8a25-d0e9ebc345c3,geogpt-btx-2x14b-sf4,1719222496,1719223271,finished,1719222546,1719223271,A100-SXM4-80GB,8,16,64,896,50,725
a92085d9-5d17-4afb-9caf-cf1db7cc0999,geogpt-qwen2-chat-0612dpo-dare-ties-p57,1719222805,1719285166,finished,1719222839,1719285166,A100-SXM4-80GB,8,1,64,448,34,62327
7d77d4dd-f3d5-4199-bcdb-a3a16c38a1af,geogpt-7b-llamapro40-38bcpt2ep,1719223403,1719223493,finished,1719223436,1719223493,A100-SXM4-80GB,8,32,64,448,33,57
2277b78c-b360-4410-8918-fc3e1d8f9f3a,geogpt-lxz-cft-new-mix-geotable-1-8m-sub-m1l3-72b,1719223433,1719263224,finished,1719223498,1719263224,A100-SXM4-80GB,8,16,64,448,65,39726
da506dca-83ad-4659-a41e-6a9d10340c0d,geo-router-softmax-lr-1e-4,1719223988,1719224549,finished,1719224047,1719224549,A100-SXM4-80GB,8,4,64,448,59,502
9fe994e5-631f-4dfa-88ef-2792b7d34620,qwen1-5-110b-chat,1719224485,1719224595,finished,1719224517,1719224595,A100-SXM4-80GB,8,1,64,448,32,78
0219df08-0c10-4e4a-9b00-8c0cef9dadc3,geo-router-softmax-lr-1e-4,1719224549,1719272817,finished,1719224586,1719272817,A100-SXM4-80GB,8,4,64,448,37,48231
b1bd430c-e316-41c4-bca1-eec01a292414,qwen1-5-110b-chat,1719224595,1719311693,finished,1719224614,1719311693,A100-SXM4-80GB,8,1,64,448,19,87079
c73228db-34a7-4029-8edf-dce68c6dac0c,ls2,1719225116,1719232392,finished,1719225135,1719232392,A100-SXM4-80GB,8,1,64,896,19,7257
7bc8e635-4f77-43ef-b41d-0172b6c948be,qwen1-5-7b-chat-9fa04-auto,1719225456,1719227016,finished,1719225475,1719227016,A100-SXM4-80GB,8,1,64,448,19,1541
a43d8e86-8ad6-42cb-a517-0f7898442619,geogpt-qwen2-chat-0612dpo-dare-ties-p55,1719227182,1719305117,finished,1719227204,1719305117,A100-SXM4-80GB,8,1,64,448,22,77913
bd902201-ed4e-4129-b605-6a5029e4ed2a,geogpt-7b-50bcpt,1719227672,1719228301,finished,1719227734,1719228301,A100-SXM4-80GB,8,32,64,448,62,567
cad70e1d-89ba-41b8-b450-60b1e88ed926,qwen1-5-7b-edebb-auto,1719227789,1719229550,finished,1719227808,1719229550,A100-SXM4-80GB,8,1,64,448,19,1742
871fe852-afcd-47cf-b152-bb9e14c6ddf1,qwen1-5-7b-chat-a9fd9-auto,1719227890,1719228993,finished,1719227912,1719228993,A100-SXM4-80GB,8,1,64,448,22,1081
b4477ab6-cb46-4010-93e2-94136cc6993d,cft-mt-lr1e-5-14b,1719228180,1719231023,finished,1719228198,1719231023,A100-SXM4-80GB,8,1,64,448,18,2825
0dee3c08-25bd-4aea-8be1-8724fec7e933,qwen2-72b-10bcpt2ep-sft2ep-ragdpo0618-a94c8-auto,1719228438,1719230972,finished,1719228457,1719230972,A100-SXM4-80GB,8,1,64,448,19,2515
968d6efb-038f-4838-9292-cf8471ec30c8,geogpt-7b-50bcpt,1719228477,1719229035,finished,1719228525,1719229035,A100-SXM4-80GB,8,32,64,448,48,510
587da84c-3a45-41c9-8f57-bd9a304a6b2f,txchen-train-task2,1719228840,1719229514,finished,1719228859,1719229514,A100-SXM4-80GB,8,1,64,448,19,655
074dc8bd-9a24-4d60-b461-f4eb873d63f5,qwen1-5-7b-chat-224e7-auto,1719228933,1719230662,finished,1719228954,1719230662,A100-SXM4-80GB,8,1,64,448,21,1708
aef6949e-94c6-41f5-81e3-97832c6c0b61,geogpt-btx-2x14b-sf4,1719229005,1719229566,finished,1719229088,1719229566,A100-SXM4-80GB,8,16,64,896,83,478
4067ed7e-cf44-4472-8c0d-e500b6f3f14a,llama-factory-zj-test,1719229329,1719230207,finished,1719229385,1719230207,A100-SXM4-80GB,8,2,64,896,56,822
42d8ce51-7426-44bd-9f2a-f67f7b05332a,paly-qwen2-7b-sft,1719229394,1719230122,finished,1719229412,1719230122,A100-SXM4-80GB,8,1,64,896,18,710
c17cdc1f-d077-4dae-a1d7-6c881d444101,tq-embedding-xzd,1719229471,1721821732,finished,1719229492,1721821732,A100-SXM4-80GB,8,1,64,448,21,2592240
ffe2056d-db75-4a6f-a0e0-ba92ff0b2b06,txchen-train-task2,1719229592,1719272638,finished,1719229632,1719272638,A100-SXM4-80GB,8,2,64,448,40,43006
6c8bb825-8954-4c27-8fcc-f739f7b66843,geogpt-7b-50bcpt,1719229666,1719232585,finished,1719231569,1719232585,A100-SXM4-80GB,8,32,64,448,1903,1016
1d358eb3-3080-4412-9137-933c01b3e8a9,geogpt-btx-2x14b-sf4,1719230055,1719230347,finished,1719230112,1719230347,A100-SXM4-80GB,8,16,64,896,57,235
a764ebc8-44b8-4536-9c87-8e2fe220b73c,llama-factory-zj-test,1719230207,1719232577,finished,1719230264,1719232577,A100-SXM4-80GB,8,2,64,896,57,2313
ec7e70f9-d551-462a-9e55-56ecadc8ce7b,qwen1-5-7b-scihub-abstract-lr1e-4-b66cc-auto,1719230216,1719231533,finished,1719230235,1719231533,A100-SXM4-80GB,8,1,64,448,19,1298
92e57e78-abc8-4ca8-aeae-6c11f6d0bcab,geogpt-btx-2x14b-sf4,1719230347,1719230930,finished,1719230387,1719230930,A100-SXM4-80GB,8,16,64,896,40,543
e66c4945-09ff-4468-993c-4ec1570e5c74,qwen1-5-7b-scihub-abstract-lr2e-5-df2ca-auto,1719230370,1719231533,finished,1719230396,1719231533,A100-SXM4-80GB,8,1,64,448,26,1137
0bbdb70b-46f3-4753-9371-ba08ab57334f,txchen-cpu-task,1719230514,1719230662,finished,1719230533,1719230662,A100-SXM4-80GB,8,1,64,448,19,129
0b7ce4e2-60b1-44b8-be9a-5be352770e94,geogpt-72b-0618-ragdpo-90cd3-auto,1719230933,1719233503,finished,1719230953,1719233503,A100-SXM4-80GB,8,1,64,448,20,2550
c773fe19-be8c-4b33-907c-dc7f54747d8a,cft-mt-lr1e-5-14b,1719231060,1719281091,finished,1719231079,1719281091,A100-SXM4-80GB,8,1,64,448,19,50012
b268132f-54a5-4679-a233-3ff16d33d0be,qwen1-5-7b-abstract-lr1e-4-c7cc6-auto,1719231476,1719233028,finished,1719231496,1719233028,A100-SXM4-80GB,8,1,64,448,20,1532
bc355f52-3586-4a87-bd2c-9e288f95577f,llama-factory-example,1719232354,1719232756,finished,1719232614,1719232756,A100-SXM4-80GB,8,2,64,896,260,142
972e4399-41fb-440b-b955-b268d0f26083,geogpt-7b-50bcpt,1719232585,1719283095,finished,1719232622,1719283095,A100-SXM4-80GB,8,32,64,448,37,50473
50a77cbd-4874-4cbf-8b94-c46561149910,llama-factory-example,1719232813,1719233662,finished,1719232868,1719233662,A100-SXM4-80GB,8,2,64,896,55,794
9866785c-95b0-437d-b5b8-41280b05d992,qwen1-5-7b-abstract-lr2e-5-1a48d-auto,1719232878,1719234546,finished,1719232898,1719234546,A100-SXM4-80GB,8,1,64,448,20,1648
aafda36a-df83-41a3-b247-01a273a8ff78,txchen-cpu-task,1719232901,1719237948,finished,1719232920,1719237948,A100-SXM4-80GB,8,1,64,448,19,5028
9d7db9da-6d4e-4284-9362-2fc8b1655b36,ls2,1719233384,1719233662,finished,1719233403,1719233662,A100-SXM4-80GB,8,1,64,896,19,259
d966cc3c-c97e-4c34-a6fe-4ecbcb5c34aa,llama-factory-example,1719233662,1719278735,finished,1719233717,1719278735,A100-SXM4-80GB,8,2,64,896,55,45018
d0e9eb01-699b-4a85-b991-1b6cda5df3bc,geogpt-qwen2-72b-10-8bcpt2ep-sft,1719237817,1719285006,finished,1719263267,1719285006,A100-SXM4-80GB,8,40,64,448,25450,21739
7c2eb350-8197-40a5-a5b0-173634b08ce7,geogpt-btx-2x14b-sf4,1719238848,1719244714,finished,1719244156,1719244714,A100-SXM4-80GB,8,16,64,896,5308,558
d7e33c2e-df7a-4df0-8d3b-bfd19725154a,geogpt-lxz-cft-1-8m-sub-m1l3-geo-magpie-72b,1719238886,1719284177,finished,1719244216,1719284177,A100-SXM4-80GB,8,16,64,448,5330,39961
2b355f0e-08a8-4c83-aa2e-912b08176379,qwen1-5-7b-chat-05f2a-auto,1719242309,1719243889,finished,1719242329,1719243889,A100-SXM4-80GB,8,1,64,448,20,1560
62e716d4-4290-4ec1-997c-25c1433e4e5e,geogpt-btx-2x14b-sf4,1719244769,1719245332,finished,1719244825,1719245332,A100-SXM4-80GB,8,16,64,896,56,507
e423386b-40e1-442a-a02b-54fc9996e728,geogpt-btx-2x14b-sf4,1719245388,1719245955,finished,1719245427,1719245955,A100-SXM4-80GB,8,16,64,896,39,528
e026bc91-1a3a-449e-b3db-ecc0c8db2005,geogpt-btx-2x14b-sf4,1719246014,1719246549,finished,1719246051,1719246549,A100-SXM4-80GB,8,16,64,896,37,498
b0f53182-1ca6-46de-9886-0a701a62fb05,geogpt-btx-2x14b-sf4,1719246604,1719247156,finished,1719246660,1719247156,A100-SXM4-80GB,8,16,64,896,56,496
2e16cf12-744b-41fe-a5bb-db9039da1f14,geogpt-btx-2x14b-sf4,1719247212,1719247783,finished,1719247266,1719247783,A100-SXM4-80GB,8,16,64,896,54,517
bd16ec92-b398-481d-922b-59d2748ae611,geogpt-table-qwen2-72b-datav040,1719247398,1719284745,finished,1719247435,1719284745,A100-SXM4-80GB,8,4,64,896,37,37310
4e7a73d4-c0df-4287-99fb-696f0c8798e8,geogpt-btx-2x14b-sf4,1719247841,1719248428,finished,1719247895,1719248428,A100-SXM4-80GB,8,16,64,896,54,533
45bec31d-aa51-4cce-bad5-f156d873b938,geogpt-btx-2x14b-sf4,1719248484,1719248764,finished,1719248540,1719248764,A100-SXM4-80GB,8,16,64,896,56,224
4187d567-49e4-4ab9-b62d-67ea93174e38,geogpt-btx-2x14b-sf4,1719248825,1719249376,finished,1719248862,1719249376,A100-SXM4-80GB,8,16,64,896,37,514
f60d1c04-a69d-4637-b49c-ea331d1f5c6b,geogpt-btx-2x14b-sf4,1719249434,1719250004,finished,1719249489,1719250004,A100-SXM4-80GB,8,16,64,896,55,515
c0cd08fb-1e7f-41a7-a9e6-0d9c2aedc5f5,geogpt-btx-2x14b-sf4,1719250061,1719250627,finished,1719250117,1719250627,A100-SXM4-80GB,8,16,64,896,56,510
8ca303c4-0829-4a58-b965-ac090acdbf61,geogpt-btx-2x14b-sf4,1719250687,1719251221,finished,1719250723,1719251221,A100-SXM4-80GB,8,16,64,896,36,498
3fc6137f-520b-4d48-b709-f9b7eb4a4855,geogpt-btx-2x14b-sf4,1719251277,1719251830,finished,1719251333,1719251830,A100-SXM4-80GB,8,16,64,896,56,497
882b913a-bb00-4837-a87f-92116f6c53cc,geogpt-btx-2x14b-sf4,1719251884,1719252130,finished,1719251940,1719252130,A100-SXM4-80GB,8,16,64,896,56,190
326dc3ad-83f6-4fbd-945d-440374677a3e,geogpt-btx-2x14b-sf4,1719252188,1719252741,finished,1719252243,1719252741,A100-SXM4-80GB,8,16,64,896,55,498
de3ad3b9-8811-472b-af12-370b2e652961,geogpt-btx-2x14b-sf4,1719252797,1719253327,finished,1719252834,1719253327,A100-SXM4-80GB,8,16,64,896,37,493
0562ef20-d2ab-43bf-9e19-85a69e937c5a,geogpt-btx-2x14b-sf4,1719253386,1719253953,finished,1719253440,1719253953,A100-SXM4-80GB,8,16,64,896,54,513
0bf19b9c-fef7-4b44-ab55-ee12ad2eaff4,geogpt-btx-2x14b-sf4,1719254009,1719254541,finished,1719254046,1719254541,A100-SXM4-80GB,8,16,64,896,37,495
b1f80635-3763-48e3-92c6-2c8928f6d15f,geogpt-btx-2x14b-sf4,1719254600,1719255152,finished,1719254654,1719255152,A100-SXM4-80GB,8,16,64,896,54,498
76f87d09-e61f-4938-b6b5-409bd3dc4d64,geogpt-btx-2x14b-sf4,1719255207,1719255770,finished,1719255263,1719255770,A100-SXM4-80GB,8,16,64,896,56,507
e6acaa18-bbdc-4cac-9d87-b8ef1f25f974,geogpt-btx-2x14b-sf4,1719255829,1719256397,finished,1719255884,1719256397,A100-SXM4-80GB,8,16,64,896,55,513
5d7a6fed-f68f-428a-b279-d39afdd6eada,geogpt-btx-2x14b-sf4,1719256455,1719284654,finished,1719256493,1719284654,A100-SXM4-80GB,8,16,64,896,38,28161
0911f4b8-a59f-4d34-9614-730ee0a68de4,geogpt-lxz-cft-new-mix-geotable-1-8m-sub-m1l3-72b,1719263298,1719280990,finished,1719272649,1719280990,A100-SXM4-80GB,8,16,64,448,9351,8341
f7670a8a-e2df-4c39-8982-e6d0f56c81af,gpt-megatron,1719278114,1719278864,finished,1719278150,1719278864,A100-SXM4-80GB,8,2,64,448,36,714
440e8df2-db1c-4011-837e-597df7a4d8a8,qwen1-5-7b-abstract-struct-lr1e-4-5f4b1-auto,1719278649,1719283960,finished,1719278668,1719283960,A100-SXM4-80GB,8,1,64,448,19,5292
5d77c0d8-c2ac-4a57-b102-cc9ef978c4dc,qwen1-5-7b-abstract-struct-lr2e-5-d465e-auto,1719278668,1719283960,finished,1719278688,1719283960,A100-SXM4-80GB,8,1,64,448,20,5272
a60f08d9-44fa-4a2f-9aab-928007c8c853,ruler-eval-0625,1719278752,1719304092,finished,1719278771,1719304092,A100-SXM4-80GB,8,1,64,896,19,25321
5d3f7c26-3ed8-4ba5-aec6-8ce72711424f,easy-context-llama3-copy,1719279104,1719279765,finished,1719279144,1719279765,A100-SXM4-80GB,8,2,64,448,40,621
6dcb66f3-9872-45ae-b53e-00ea884255ff,gpt-megatron,1719279160,1719280513,finished,1719279800,1719280513,A100-SXM4-80GB,8,2,64,448,640,713
bb215890-84c2-4893-81f3-7b61f5271384,training-llm,1719280476,1719316903,finished,1719280550,1719316903,A100-SXM4-80GB,8,2,64,896,74,36353
dd8c7b68-e457-46dd-9db7-9efd0f78391a,qwen2-72b-11bcpt-2ep-a6936-auto,1719280995,1719285593,finished,1719283436,1719285593,A100-SXM4-80GB,8,1,64,448,2441,2157
2c817471-653b-4b91-9db6-aaba43f16c19,easy-context-llama3-copy,1719281005,1719284009,finished,1719283489,1719284009,A100-SXM4-80GB,8,2,64,448,2484,520
fc542097-20db-4f2e-8d87-2b12b578c76f,geogpt-lxz-cft-new-mix-geotable-1-8m-sub-m1l3-72b,1719281050,1719290352,finished,1719283470,1719290352,A100-SXM4-80GB,8,16,64,448,2420,6882
daf5e7d9-50f1-48c4-885e-0a0aa5c638ba,qwen2-72b-11bcpt-2ep-ff512-auto,1719281053,1719284675,finished,1719283436,1719284675,A100-SXM4-80GB,8,1,64,448,2383,1239
9ec009b3-c1e1-4f94-b836-c0fb9fe108fa,llama3-instruct-70b,1719281072,1719366751,finished,1719283434,1719366751,A100-SXM4-80GB,8,1,64,448,2362,83317
c40afe69-39e5-4531-b8df-6b7117532e26,qwen1-5-7b-c9526-auto,1719281074,1719284034,finished,1719283436,1719284034,A100-SXM4-80GB,8,1,64,448,2362,598
bbf38cbc-2c6e-46b1-a847-53c7d3e81860,qwen1-5-7b-abstract-lr1e-4-667c8-auto,1719281168,1719284016,finished,1719283436,1719284016,A100-SXM4-80GB,8,1,64,448,2268,580
8dce38db-862d-499f-8598-066499eda967,qwen1-5-7b-abstract-lr2e-5-b9a29-auto,1719281187,1719284016,finished,1719283436,1719284016,A100-SXM4-80GB,8,1,64,448,2249,580
f0aeeb24-4fea-487f-8566-5ad0fccbb0b3,qwen1-5-7b-abstract-struct-lr1e-4-5c257-auto,1719281261,1719284017,finished,1719283436,1719284017,A100-SXM4-80GB,8,1,64,448,2175,581
cdce0c83-08a1-4210-b6bb-9e4af3593760,qwen1-5-7b-abstract-struct-lr2e-5-b76bb-auto,1719281316,1719283981,finished,1719283436,1719283981,A100-SXM4-80GB,8,1,64,448,2120,545
8ce95a3f-1684-47f6-9bee-d78af19c9cbc,gpt-megatron,1719281470,1719281740,finished,1719281506,1719281740,A100-SXM4-80GB,8,2,64,448,36,234
cc47581b-003b-4304-bfb8-9247ee5016d7,geogpt-llama3-cpt1ep-sft-jsonl,1719283052,1719285344,finished,1719284283,1719285344,A100-SXM4-80GB,8,48,64,448,1231,1061
746541dd-859f-4d32-92df-0b68ef0f2f9c,gpt-megatron,1719283085,1719283239,finished,1719283120,1719283239,A100-SXM4-80GB,8,2,64,448,35,119
6503f78d-349e-44ca-a3f6-35096d99fb1c,gpt-megatron,1719283410,1719283606,finished,1719283464,1719283606,A100-SXM4-80GB,8,2,64,448,54,142
89b1a8ed-3306-4c94-9aff-1b50db10467f,rag-rank,1719283488,1719286316,finished,1719283506,1719286316,A100-SXM4-80GB,8,1,64,448,18,2810
e5ae7280-ff39-4474-8d7b-738f8eb90164,gpt-megatron,1719283724,1719283951,finished,1719283778,1719283951,A100-SXM4-80GB,8,2,64,448,54,173
c1e463c8-e548-485b-8e28-09111b46eee3,easy-context-llama3-copy,1719284171,1719285605,finished,1719284224,1719285605,A100-SXM4-80GB,8,2,64,448,53,1381
e119494a-378b-4a3c-a3a1-98ebbb065ddd,gpt-megatron,1719284239,1719285015,finished,1719284311,1719285015,A100-SXM4-80GB,8,2,64,448,72,704
79d23bd2-a3f9-4a02-a984-914fe1d2c428,geogpt-btx-2x14b-sf4,1719284713,1719285274,finished,1719284764,1719285274,A100-SXM4-80GB,8,16,64,896,51,510
debff38d-954b-4c11-9422-964201b6abb5,geogpt-qwen2-72b-10-8bcpt2ep-sft,1719285078,1719285529,finished,1719285116,1719285529,A100-SXM4-80GB,8,40,64,448,38,413
7191dfd2-18fe-4f13-bb60-ac16dd9e6945,citysora-modelv4-webvid-humanface-65-256,1719285111,1719288712,finished,1719285164,1719288712,A100-SXM4-80GB,8,4,64,896,53,3548
bc3a39bb-302e-48d5-9e00-06d9e458a659,paly-qwen2-7b-sft,1719285225,1719285687,finished,1719285243,1719285687,A100-SXM4-80GB,8,1,64,896,18,444
cde6775a-5fba-46be-83ef-813ff12e9893,geogpt-dairui-eval-code-2,1719285339,1719307462,finished,1719285358,1719307462,A100-SXM4-80GB,8,1,64,448,19,22104
6e0b3d04-d129-4c89-9ff0-1024bf01bba9,geogpt-dairui-model-merge-exp-1,1719285339,1719307500,finished,1719285358,1719307500,A100-SXM4-80GB,8,1,64,896,19,22142
b5727646-0c88-40ff-9b36-f6e4dec5cef3,geogpt-btx-2x14b-sf4,1719285341,1719285583,finished,1719285377,1719285583,A100-SXM4-80GB,8,16,64,896,36,206
dcbff29f-6432-46b7-91b4-12d61f0970b5,geogpt-llama3-cpt1ep-sft-jsonl,1719285422,1719399442,finished,1719285474,1719399442,A100-SXM4-80GB,8,48,64,448,52,113968
ed83e12b-8d14-4f31-b689-0be64a0090ad,geogpt-qwen2-cpt-dare-fusion,1719285546,1719305173,finished,1719285566,1719305173,A100-SXM4-80GB,8,1,64,448,20,19607
d34b3cc8-7089-42a1-8b2b-2b49934d33e9,gpt-megatron,1719285577,1719285791,finished,1719285621,1719285791,A100-SXM4-80GB,8,2,64,448,44,170
5c897c42-7768-4ed8-9001-e839d25f4150,easy-context-llama3-copy,1719285605,1719286727,finished,1719285645,1719286727,A100-SXM4-80GB,8,2,64,448,40,1082
457c9a9a-4b53-429f-af8b-b1778b833394,geogpt-qwen2-72b-10-8bcpt2ep-sft,1719285612,1719289031,finished,1719285653,1719289031,A100-SXM4-80GB,8,40,64,448,41,3378
5de3e2fe-29dc-4109-b0b8-fd1815b19125,geo-table-datav05-lora-5e-5,1719285699,1719298415,finished,1719285718,1719298415,A100-SXM4-80GB,8,1,64,448,19,12697
ce11c0fd-684f-41e0-b5af-c306fc233b39,geogpt-btx-2x14b-sf4,1719285737,1719286286,finished,1719285775,1719286286,A100-SXM4-80GB,8,16,64,896,38,511
01e1cb6f-cd65-462e-9f1b-5172b4730feb,citysora-modelv4-webvid-cele-laion-joint-65-256,1719285832,1719289197,finished,1719285867,1719289197,A100-SXM4-80GB,8,5,64,896,35,3330
9bb26d15-daa9-45dd-8056-fc3e607d9c9e,sfr-embedding-test,1719285934,1719365246,finished,1719285952,1719365246,A100-SXM4-80GB,8,1,64,448,18,79294
bed64430-4da1-4cdc-9981-33b5911ffb2a,llama-factory-long,1719285953,1719363539,finished,1719286006,1719363539,A100-SXM4-80GB,8,2,64,896,53,77533
1a9d9631-ec27-489f-b241-652c50f98e44,geogpt-table-qwen2-72b-datav040,1719286208,1719286822,finished,1719286340,1719286822,A100-SXM4-80GB,8,4,64,896,132,482
7128fcb2-93b7-4d72-954c-fb1282a991c8,qwen2-72b-instruct-judge,1719286273,1719459888,finished,1719286292,1719459888,A100-SXM4-40GB,8,1,32,320,19,173596
5338a892-3cb5-4865-9397-1117b4f00978,geogpt-btx-2x14b-sf4,1719286344,1719286652,finished,1719286400,1719286652,A100-SXM4-80GB,8,16,64,896,56,252
2e16e856-e972-4257-b2e0-98ce7ec2c094,geo-router-softmax-lr-1e-4,1719286478,1719286804,finished,1719286649,1719286804,A100-SXM4-80GB,8,4,64,448,171,155
a5062de4-fa6e-46b3-9243-5490a927925f,geo-router-softmax-reserved,1719286593,1719286804,finished,1719286668,1719286804,A100-SXM4-80GB,8,4,64,448,75,136
3debb72b-d0ce-4fa3-a470-2a5aac767f6b,geogpt-btx-2x14b-sf4,1719286713,1719287090,finished,1719286871,1719287090,A100-SXM4-80GB,8,16,64,896,158,219
fd1cc800-f8dd-4ae9-a5bb-826957ebec05,geo-router-block-softmax-full-atten-reserved,1719286827,1719287070,finished,1719286894,1719287070,A100-SXM4-80GB,8,4,64,448,67,176
0244c0be-912c-483a-85ec-4dfdce1b8de7,easy-context-llama3-copy,1719286843,1719288058,finished,1719286911,1719288058,A100-SXM4-80GB,8,2,64,448,68,1147
bbe142aa-2e23-4048-8cc6-3d23ffb44931,geogpt-table-qwen2-72b-datav040,1719286867,1719291643,finished,1719286934,1719291643,A100-SXM4-80GB,8,4,64,896,67,4709
49db3309-2bc7-4e78-9ddf-6bde0d2e466b,qwen2-7b-sft-alpacagpt4-chat-3epo-c26ba-auto,1719287055,1719288920,finished,1719287111,1719288920,A100-SXM4-80GB,8,1,64,448,56,1809
e08930ca-274f-469a-b154-485471750328,geogpt-btx-2x14b-sf4,1719287149,1719295378,finished,1719289049,1719295378,A100-SXM4-80GB,8,16,64,896,1900,6329
c6564e67-fb03-4c76-9e18-2b1c4f4be8f2,qwen2-7b-sft-alpaca-mosaic-chat-1epo-348bf-auto,1719287224,1719288902,finished,1719287242,1719288902,A100-SXM4-80GB,8,1,64,448,18,1660
6f78c290-9d00-4c38-8920-37b613f1c544,cft-mt-lr1e-5-14b,1719287313,1719305846,finished,1719287332,1719305846,A100-SXM4-80GB,8,1,64,448,19,18514
8e3f2129-19ca-4d57-a9d4-1aab88e54361,llama3-8b-sft-alpacagpt4-chat-3epo-420fc-auto,1719287481,1719288993,finished,1719287501,1719288993,A100-SXM4-80GB,8,1,64,448,20,1492
df8e6710-a851-422e-a8f3-cfe7c8475b68,llama3-8b-sft-alpaca-mosaic-chat-1epo-674fc-auto,1719287502,1719288975,finished,1719287521,1719288975,A100-SXM4-80GB,8,1,64,448,19,1454
56c9e1c5-607c-4b88-9004-8f5708771b12,geo-router-softmax-lr-1e-4,1719287592,1719287840,finished,1719287610,1719287840,A100-SXM4-80GB,8,1,64,448,18,230
d8158cf4-aeaf-48a8-b3d0-120b36f33930,geo-router-block-softmax-full-atten-reserved,1719287631,1719287840,finished,1719287689,1719287840,A100-SXM4-80GB,8,4,64,448,58,151
50dbd00f-42a5-4243-9706-36793325cbef,geo-router-softmax-reserved,1719287671,1719336992,finished,1719287709,1719336992,A100-SXM4-80GB,8,4,64,448,38,49283
97647f63-c29f-494a-8302-1cbfa04ca469,geo-router-block-softmax-full-atten-reserved,1719288226,1719337925,finished,1719288283,1719337925,A100-SXM4-80GB,8,4,64,448,57,49642
391dfda6-c7c9-4e93-905b-0722d5391927,easy-context-llama3-copy,1719288280,1719289041,finished,1719288338,1719289041,A100-SXM4-80GB,8,2,64,448,58,703
b3c37173-e2c5-452c-a2a5-8275893405c3,qwen1-5-7b-abstract-struct-lr1e-4-69cd8-auto,1719288309,1719300137,finished,1719288328,1719300137,A100-SXM4-80GB,8,1,64,448,19,11809
c6cb9d42-fa25-4643-8844-bd280f756f56,geo-router-softmax-lr-1e-4,1719288342,1719288530,finished,1719288399,1719288530,A100-SXM4-80GB,8,2,64,448,57,131
105c1d66-c434-40da-94d4-7446d32eda0b,qwen1-5-7b-abstract-struct-lr2e-5-ca40d-auto,1719288347,1719300115,finished,1719288367,1719300115,A100-SXM4-80GB,8,1,64,448,20,11748
f6cdbf3d-91cd-4ea6-9b91-b06d39efd0c6,geo-llamapro-8,1719288400,1719288547,finished,1719288420,1719288547,A100-SXM4-80GB,8,1,64,448,20,127
4997efc9-267e-4a1f-98a5-e4f95550e1ba,geogpt-72b-0618,1719288677,1719304626,finished,1719288698,1719304626,A100-SXM4-80GB,8,1,64,448,21,15928
f8ccb819-3d01-4bc6-9a1b-047166f35d3d,citysora-modelv4-webvid-humanface-65-256,1719288768,1719822238,finished,1719288823,1719822238,A100-SXM4-80GB,8,4,64,896,55,533415
caf6c403-17c2-45d1-85fc-194c91a067a5,geo-llamapro-8,1719288769,1719288898,finished,1719288788,1719288898,A100-SXM4-80GB,8,1,64,448,19,110
72dc6c18-6a0e-4f34-9197-49dc8a7b7243,easy-context-llama3-copy,1719289041,1719289813,finished,1719289117,1719289813,A100-SXM4-80GB,8,2,64,448,76,696
13e6a188-849a-44df-995e-fdd428845a3b,citysora-modelv4-webvid-humanface-65-128,1719289071,1719385742,finished,1719289140,1719385742,A100-SXM4-80GB,8,4,64,896,69,96602
c1e096ee-61c6-4196-90e2-7171d5299e5b,geo-llamapro-8,1719289095,1719289215,finished,1719289121,1719289215,A100-SXM4-80GB,8,1,64,448,26,94
2c32f7a0-6d84-4ede-bb96-681e89d169a1,geo-router-softmax-lr-1e-4,1719289121,1719389330,finished,1719289160,1719389330,A100-SXM4-80GB,8,2,64,448,39,100170
5c1f1c84-5a81-4344-983b-8165dd67a6ae,geogpt-qwen2-72b-10-8bcpt2ep-sft,1719289127,1719447075,finished,1719290392,1719447075,A100-SXM4-80GB,8,40,64,448,1265,156683
315343fe-21a0-4db5-82ec-c53fd561db16,citysora-modelv4-webvid-cele-laion-joint-65-256,1719289253,1719404421,finished,1719289289,1719404421,A100-SXM4-80GB,8,5,64,896,36,115132
1bb8bfe1-53ee-44fb-b426-d0c9e729530c,geo-llamapro-8,1719289525,1719289816,finished,1719289543,1719289816,A100-SXM4-80GB,8,1,64,448,18,273
d66a049c-0998-44a4-a523-f8d86b5ccf8d,qwen2-7b-sft-alpaca-mosaic-chat-1epo-v2-aca37-auto,1719289674,1719289710,finished,1719289692,1719289710,A100-SXM4-40GB,4,1,32,320,18,18
514dc715-ef47-4c01-9ff2-9457094be001,gpt-megatron,1719289774,1719289937,finished,1719289811,1719289937,A100-SXM4-80GB,8,2,64,448,37,126
82752806-52e9-4974-b37a-5be54ee7388b,qwen2-7b-sft-alpacagpt4-chat-3epo-v2-2dda0-auto,1719289801,1719289839,finished,1719289821,1719289839,A100-SXM4-40GB,4,1,32,320,20,18
92843601-7c5d-4f61-afb0-097e4334e132,geogpt-lxz-cft-new-mix-geotable-1-8m-sub-m1l3-72b,1719290422,1719298971,finished,1719291876,1719298971,A100-SXM4-80GB,8,16,64,448,1454,7095
830c2b5b-7d24-41d2-b398-dd34d21d87fb,qwen2-7b-sft-alpacagpt4-chat-3epo-v2-2dda0-auto,1719292168,1719292206,finished,1719292188,1719292206,A100-SXM4-40GB,4,1,32,320,20,18
3b2ad198-5374-4c84-acd0-683205d30d25,qwen2-7b-sft-alpaca-mosaic-chat-1epo-v2-aca37-auto,1719292187,1719292223,finished,1719292206,1719292223,A100-SXM4-40GB,4,1,32,320,19,17
dc26653e-5bac-49e3-8372-eb7c4215c072,geo-llamapro-8,1719292275,1719295455,finished,1719295375,1719295455,A100-SXM4-80GB,8,1,64,448,3100,80
1add7e3e-9bf6-4679-889f-753f8fc20a81,geo-all-weight,1719293811,1719295527,finished,1719295375,1719295527,A100-SXM4-80GB,8,1,64,448,1564,152
7501eaba-e629-46d9-bb67-8c4fc33d11ec,geo-all-weight-raw,1719293813,1719295719,finished,1719295376,1719295719,A100-SXM4-80GB,8,1,64,448,1563,343
5bd21baa-43fb-43fc-9806-56635f373352,test,1719293881,1719295609,finished,1719295390,1719295609,A100-SXM4-80GB,8,1,64,896,1509,219
a0ee396d-434a-4716-ad68-8218f077f257,gpt-megatron,1719294144,1719295767,finished,1719295429,1719295767,A100-SXM4-80GB,8,2,64,448,1285,338
755420b9-aa13-42e8-9dd8-b3ba036c9ffe,geo-router-block-weight-continued,1719294711,1719295544,finished,1719295376,1719295544,A100-SXM4-80GB,8,1,64,448,665,168
ca83bede-a3ed-44bb-a26b-d8b76ab63a20,qwen2-7b-sft-alpacagpt4-chat-3epo-v2-2dda0-auto,1719295125,1719295323,finished,1719295145,1719295323,A100-SXM4-40GB,4,1,32,320,20,178
092c676a-b6bf-4a1f-803b-2cc426abbc9f,geogpt-sft-qwen2-72b-datav081-ep1,1719295773,1719327102,finished,1719295792,1719327102,A100-SXM4-80GB,8,1,64,448,19,31310
b70fd6d6-4da9-4fcf-a272-5aacd28d605a,qwen2-72b-11bcpt-2ep-1feb6-auto,1719296155,1719300200,finished,1719296174,1719300200,A100-SXM4-80GB,8,1,64,448,19,4026
955af98a-307e-4770-84aa-dd552fcf4b40,test,1719296201,1719296309,finished,1719296219,1719296309,A100-SXM4-80GB,8,1,64,896,18,90
82c7ddf5-b2e2-4709-840e-20659dc92f32,qwen1-5-7b-5edd5-auto,1719296282,1719300180,finished,1719296299,1719300180,A100-SXM4-80GB,8,1,64,448,17,3881
e9c9f0cd-b0d3-44cf-b583-a70b9020bca7,qwen1-5-7b-abstract-lr1e-4-09c24-auto,1719296336,1719300181,finished,1719296354,1719300181,A100-SXM4-80GB,8,1,64,448,18,3827
26ea0d12-1780-47cf-a888-f2cc62e7b316,qwen1-5-7b-abstract-lr2e-5-81a22-auto,1719296373,1719300230,finished,1719296391,1719300230,A100-SXM4-80GB,8,1,64,448,18,3839
479ff6be-f7c8-4432-b189-77209ca97d1f,qwen1-5-7b-abstract-struct-lr1e-4-579c4-auto,1719296447,1719300115,finished,1719296466,1719300115,A100-SXM4-80GB,8,1,64,448,19,3649
281bb27a-f868-41fa-8b99-6160d2c8816d,qwen2-72b-sft-dpo,1719296449,1719301462,finished,1719296504,1719301462,A100-SXM4-80GB,8,4,64,896,55,4958
08b17a1c-6797-4c93-bd93-5de2dfd380c2,qwen1-5-7b-abstract-struct-lr2e-5-d52af-auto,1719296485,1719300116,finished,1719296503,1719300116,A100-SXM4-80GB,8,1,64,448,18,3613
02e7e00a-3afa-408f-94d5-cba87912d2f7,gpt-megatron,1719296897,1719297383,finished,1719296954,1719297383,A100-SXM4-80GB,8,2,64,448,57,429
30018278-ab3c-46db-8362-93edb8f37e39,test,1719297048,1719297311,finished,1719297066,1719297311,A100-SXM4-80GB,8,1,64,896,18,245
9d2d7b29-8bf3-475f-833f-0eae560efc64,docxchain-iso-002,1719297278,1719300855,finished,1719297296,1719300855,A100-SXM4-40GB,1,1,8,32,18,3559
1c9a89d6-120f-479a-b9be-1e3de7626b7d,geo-all-weight,1719297466,1719297642,finished,1719297489,1719297642,A100-SXM4-80GB,8,1,64,448,23,153
e3be0612-70c0-40d5-a867-e9a3fef0e2f4,geo-all-weight-raw,1719297467,1719297624,finished,1719297489,1719297624,A100-SXM4-80GB,8,1,64,448,22,135
d8591902-2159-438f-8db8-335a61f3a805,geo-router-block-weight-continued,1719297469,1719362799,finished,1719297489,1719362799,A100-SXM4-80GB,8,1,64,448,20,65310
1ee4c2f7-ba04-4787-9ff1-5f4ea061f0a5,geo-llamapro-8,1719297489,1719297606,finished,1719297509,1719297606,A100-SXM4-80GB,8,1,64,448,20,97
7f681411-82f1-4a9e-ad74-1ad1bfe5cee2,test,1719297601,1719297753,finished,1719297656,1719297753,A100-SXM4-80GB,8,1,64,896,55,97
e7a12772-be2a-4574-87bd-2acc1b4c289e,qwen2-7b-sft-alpacagpt4-chat-3epo-v3-859c3-auto,1719297684,1719300094,finished,1719297703,1719300094,A100-SXM4-80GB,8,1,64,448,19,2391
45194737-f104-44dd-a8f1-b6c14742b104,geo-all-weight-raw,1719297738,1719297896,finished,1719297758,1719297896,A100-SXM4-80GB,8,1,64,448,20,138
d53d1d48-e418-44b9-8df1-832415653b5b,geo-all-weight,1719297758,1719297933,finished,1719297778,1719297933,A100-SXM4-80GB,8,1,64,448,20,155
9c3d653e-9f89-4ae1-8d52-fc8487dbb9fd,qwen2-7b-sft-alpaca-mosaic-chat-1epo-v3-f369a-auto,1719297784,1719300095,finished,1719297806,1719300095,A100-SXM4-80GB,8,1,64,448,22,2289
ecb3ae00-1474-4d00-a18f-ed0947539382,lt-train,1719297796,1719300214,finished,1719297967,1719300214,A100-SXM4-80GB,8,1,64,896,171,2247
07bc6876-9d71-4163-b8bc-b635dd606ed7,geo-llamapro-8,1719297801,1719297969,finished,1719297820,1719297969,A100-SXM4-80GB,8,1,64,448,19,149
e96131c7-794f-4355-8a52-34a8c234ba5a,gpt-megatron,1719297852,1719299168,finished,1719299020,1719299168,A100-SXM4-80GB,8,2,64,448,1168,148
068fa75a-ca97-4e49-b3d9-b8c1dad2acd8,test,1719297927,1719298193,finished,1719297946,1719298193,A100-SXM4-80GB,8,1,64,896,19,247
e8930199-d7ce-40c2-9761-5ad3b2d226d6,geo-all-weight,1719298046,1719313288,finished,1719298216,1719313288,A100-SXM4-80GB,8,1,64,448,170,15072
bd6d4393-899c-490d-8249-c81dad3f0058,geo-all-weight-raw,1719298048,1719298179,finished,1719298068,1719298179,A100-SXM4-80GB,8,1,64,448,20,111
01098e49-ff2d-493f-9ac6-27ffa52e418e,geo-llamapro-8,1719298068,1719371129,finished,1719298142,1719371129,A100-SXM4-80GB,8,1,64,448,74,72987
64446e69-5b43-4a78-8946-ead6edb58b1e,geo-all-weight-raw,1719298453,1719298605,finished,1719298474,1719298605,A100-SXM4-80GB,8,1,64,448,21,131
a8069f3f-d554-4026-bf6c-fbf7eb655602,geogpt-table-qwen2-72b-datav040,1719298493,1719303563,finished,1719298986,1719303563,A100-SXM4-80GB,8,4,64,896,493,4577
0ac4210a-203c-4059-b4b2-441d06e36415,geo-all-weight-raw,1719298838,1719314059,finished,1719298857,1719314059,A100-SXM4-80GB,8,1,64,448,19,15202
32f8586f-2504-4a7d-8871-12b80ac94230,test,1719299381,1719299638,finished,1719299398,1719299638,A100-SXM4-80GB,8,1,64,896,17,240
f299ed54-d9ff-4ed7-bfba-adabe7fa54cc,qwen1-5-7b-chat-e6eb0-auto,1719299631,1719300120,finished,1719299650,1719300120,A100-SXM4-80GB,8,1,64,448,19,470
8c490656-d1c1-4cec-a81c-137187d2d10c,qwen1-5-110b,1719299812,1719300142,finished,1719299832,1719300142,A100-SXM4-80GB,8,1,64,448,20,310
5b7335c4-a86a-4359-bb50-592e6cf3d1a5,test,1719299819,1719300106,finished,1719299838,1719300106,A100-SXM4-80GB,8,1,64,896,19,268
10ecc41a-34a3-486a-a081-b9abd1783dd4,gpt-megatron,1719299819,1719300004,finished,1719299874,1719300004,A100-SXM4-80GB,8,2,64,448,55,130
9eb5411c-3c8a-400e-834c-ac64933e2dc7,qwen2-72b-chat2,1719300038,1719300403,finished,1719300087,1719300403,A100-SXM4-40GB,8,1,32,320,49,316
046dfb94-c658-48e9-8ab0-d07bafd0b351,geogpt-lxz-cft-new-mix-geotable-1-8m-sub-m1l3-72b,1719300047,1719300364,finished,1719300218,1719300364,A100-SXM4-80GB,8,16,64,448,171,146
53f3e427-21e5-4652-9de9-65ef08d24633,geogpt-lxz-cft-1-8m-sub-m1l3-geo-magpie-72b,1719300052,1719300364,finished,1719300268,1719300364,A100-SXM4-80GB,8,16,64,448,216,96
bc227139-cf35-4212-b06f-b0e2b0fccb95,test,1719300106,1719300190,finished,1719300127,1719300190,A100-SXM4-80GB,8,1,64,896,21,63
72c8ef32-eb05-4663-9060-8430566b0aa4,qwen1-5-110b,1719300143,1719300419,finished,1719300163,1719300419,A100-SXM4-80GB,8,1,64,448,20,256
052e7c3b-d043-4b91-b7be-eceaaac0a3eb,test,1719300303,1719300534,finished,1719300378,1719300534,A100-SXM4-80GB,8,1,64,896,75,156
7795a171-8562-4d7c-b56e-78ff1d1e0b2e,geogpt-btx-2x14b-sf4,1719300327,1719300543,finished,1719300434,1719300543,A100-SXM4-80GB,8,16,64,896,107,109
7528613a-0298-4537-a819-c2165c685247,geogpt-lxz-cft-1-8m-sub-m1l3-geo-magpie-72b,1719300364,1719300543,finished,1719300406,1719300543,A100-SXM4-80GB,8,16,64,448,42,137
65c24f7e-1ae6-415a-bf26-d9a351553240,gpt-megatron,1719300377,1719300557,finished,1719300398,1719300557,A100-SXM4-80GB,8,2,64,448,21,159
d764cf99-35ec-4353-bac2-89d724899698,lt-train,1719300381,1719300537,finished,1719300402,1719300537,A100-SXM4-80GB,8,1,64,896,21,135
a24ef9ea-24fb-4868-9178-8f4c87b4799e,qwen2-72b-chat2,1719300403,1719300539,finished,1719300432,1719300539,A100-SXM4-40GB,8,1,32,320,29,107
271bdda9-5ced-404d-8616-9beeb14af907,qwen1-5-110b,1719300419,1719300598,finished,1719300448,1719300598,A100-SXM4-80GB,8,1,64,448,29,150
6d8d7853-de96-4723-9b53-7b56e9e3af0d,qwen1-5-7b-chat-a74c3-auto,1719300420,1719300657,finished,1719300448,1719300657,A100-SXM4-80GB,8,1,64,448,28,209
6ec257cc-5b2e-40cc-8ce7-6fa5c3a8d912,test,1719300534,1719300663,finished,1719300557,1719300663,A100-SXM4-80GB,8,1,64,896,23,106
0c1b4b0e-6735-4324-b94c-0cf365ee5205,lt-train,1719300537,1719306232,finished,1719300561,1719306232,A100-SXM4-80GB,8,1,64,896,24,5671
a02bff04-c080-4604-aaa1-f5974938750d,qwen2-72b-chat2,1719300539,1719301095,finished,1719300563,1719301095,A100-SXM4-40GB,8,1,32,320,24,532
086caf19-2ef2-4edc-9c65-7d54af20bb35,geogpt-btx-2x14b-sf4,1719300543,1719301103,finished,1719300586,1719301103,A100-SXM4-80GB,8,16,64,896,43,517
1707c019-72a4-4080-8d1e-18106a0b380f,txchen-cpu-task,1719300551,1719308058,finished,1719300574,1719308058,A100-SXM4-80GB,8,1,64,448,23,7484
0f948e4d-0a23-4f6b-bff1-43d27eac35cc,gpt-megatron,1719300557,1719301116,finished,1719300605,1719301116,A100-SXM4-80GB,8,2,64,448,48,511
54c9267a-ba53-408c-816e-3e8e0c75d1af,qwen1-5-110b,1719300598,1719301158,finished,1719300618,1719301158,A100-SXM4-80GB,8,1,64,448,20,540
4c4625d3-88ea-4026-8daa-b9a719a01037,docxchain-iso-002,1719300856,1719300912,finished,1719300875,1719300912,A100-SXM4-40GB,1,1,8,32,19,37
0557fa3b-f23f-4c8a-bd60-b9ac590e1959,geogpt-lxz-cft-new-mix-geotable-1-8m-sub-m1l3-72b,1719300946,1719313346,finished,1719301124,1719313346,A100-SXM4-80GB,8,16,64,448,178,12222
fc670c16-b420-441d-8705-f9ed5224a276,qwen2-72b-chat2,1719301096,1719301453,finished,1719301121,1719301453,A100-SXM4-40GB,8,1,32,320,25,332
db8e6155-7bff-4cf7-bb68-d536463da0d5,geo-router-block-softmax-full-atten-reserved-lr,1719301101,1719370732,finished,1719301171,1719370732,A100-SXM4-80GB,8,2,64,448,70,69561
836cba7d-9683-4746-99f6-35cb8d156cb5,gpt-megatron,1719301116,1719301472,finished,1719301184,1719301472,A100-SXM4-80GB,8,2,64,448,68,288
1a4090de-b134-4562-9096-784a7c3c83a6,docxchain-iso-002,1719301146,1719306851,finished,1719301168,1719306851,A100-SXM4-40GB,1,1,8,32,22,5683
8a43211d-4782-41fa-9932-eeaa28e1126c,qwen1-5-110b,1719301158,1719301679,finished,1719301179,1719301679,A100-SXM4-80GB,8,1,64,448,21,500
333b83e3-7cd1-4871-a8db-88be885aee28,test,1719301410,1719301569,finished,1719301472,1719301569,A100-SXM4-80GB,8,1,64,896,62,97
48ede97d-e0e3-4f67-88a7-d6960b4df498,geogpt-btx-2x14b-sf4,1719301429,1719313921,finished,1719313364,1719313921,A100-SXM4-80GB,8,16,64,896,11935,557
7f85c73c-f8bb-4658-909e-aadd45d76d4b,geogpt-prompt-training-reft-hcx2,1719301441,1719302402,finished,1719302228,1719302402,A100-SXM4-80GB,8,1,64,896,787,174
5732d49e-66ad-4e7c-9d13-6be165a14fbb,qwen2-72b-chat2,1719301454,1719303600,finished,1719301477,1719303600,A100-SXM4-40GB,8,1,32,320,23,2123
8c72fd69-533f-451c-a460-8b20f99f3f01,geogpt-prompt-tuning-tg-infer1,1719301465,1719313414,finished,1719302422,1719313414,A100-SXM4-80GB,8,1,64,448,957,10992
f0625604-e80b-41fe-8b1b-e9b36716fbe2,gpt-megatron,1719301472,1719301666,finished,1719301512,1719301666,A100-SXM4-80GB,8,2,64,448,40,154
bd31a872-31b1-44d0-ac18-3515555e8f15,qwen1-5-110b,1719301679,1719302112,finished,1719301700,1719302112,A100-SXM4-80GB,8,1,64,448,21,412
7ddcbea4-fe79-42f5-a4f4-077f363dba26,test,1719301798,1719315551,finished,1719301817,1719315551,A100-SXM4-80GB,8,1,64,896,19,13734
90708316-641d-4f0e-9c40-24b1e7ae4193,geogpt-leonardo-shieh-dsj3,1719302208,1719370349,finished,1719313433,1719370349,A100-SXM4-80GB,8,1,64,448,11225,56916
6b8aa07c-1a28-475b-941b-49932630fa1b,qwen1-5-110b,1719302245,1719305218,finished,1719302266,1719305218,A100-SXM4-80GB,8,1,64,448,21,2952
e10d961e-1659-4325-bc06-ba3cc472c110,qwen1-5-7b-chat-b166f-auto,1719302323,1719303818,finished,1719302343,1719303818,A100-SXM4-80GB,8,1,64,448,20,1475
790d0e34-785b-4e59-bb22-05b099f044dd,reranker-hn,1719302389,1719303596,finished,1719302409,1719303596,A100-SXM4-80GB,8,1,64,448,20,1187
861ed483-0e00-40f2-9ff6-ecea5b5e05fc,data-gen-magpie,1719302606,1719303315,finished,1719302626,1719303315,A100-SXM4-80GB,8,1,64,448,20,689
6a269771-636e-41d8-9681-da148dcb87d3,paly-qwen2-7b-sft,1719302754,1719303758,finished,1719303319,1719303758,A100-SXM4-80GB,8,1,64,896,565,439
5500e6a3-4557-4bb4-b018-11592f9e413e,qwen2-72b-chat-sft-dpo,1719302913,1719304897,finished,1719303300,1719304897,A100-SXM4-80GB,8,1,64,448,387,1597
959d4b0d-c105-474f-8955-9743158a0738,reranker2-inference,1719302924,1719302959,finished,1719302942,1719302959,A100-SXM4-40GB,1,1,8,96,18,17
99cca01e-337d-4980-9fc9-e272e8395eed,sfr-embedding,1719303014,1719971283,finished,1719303597,1719971283,A100-SXM4-80GB,8,1,64,448,583,667686
95c89ff3-703a-4c9e-9129-d287f5ef207e,lzk-qwen15-7b-base-scihub-abstract-qa-sft,1719303028,1719306169,finished,1719306093,1719306169,A100-SXM4-80GB,8,1,64,448,3065,76
79a32079-481d-40cb-902c-7681e00c568e,gpt-megatron,1719303034,1719303956,finished,1719303615,1719303956,A100-SXM4-80GB,8,2,64,448,581,341
e952f48d-9bde-4b50-8f3f-6bb4b20d78df,reranker-hn2,1719303090,1719303883,finished,1719303597,1719303883,A100-SXM4-80GB,8,1,64,448,507,286
738ca4e3-2449-46af-aedf-a701d3a88739,qwen1-5-110b,1719303140,1719304068,finished,1719303572,1719304068,A100-SXM4-80GB,8,1,64,448,432,496
d74f7a98-bd84-4a9b-93f3-c4dfa305c290,reranker2-inference,1719303220,1719476568,finished,1719303597,1719476568,A100-SXM4-80GB,8,1,64,448,377,172971
60927bb6-5e18-406b-9c82-cc7fd721c217,qwen2-72b-chat2,1719303656,1719304869,finished,1719303676,1719304869,A100-SXM4-40GB,8,1,32,320,20,1193
f5ccafba-f5d5-4fc0-91c6-20d7932fcbb0,qwen1-5-7b-chat-b166f-auto,1719303818,1719305610,finished,1719303895,1719305610,A100-SXM4-80GB,8,1,64,448,77,1715
b23276fc-3730-4c1d-a87e-7f34cde95fd4,qwen2-7b-sft-alpaca-mosaic-chat-1epo-v4-12855-auto,1719303910,1719364274,finished,1719304006,1719364274,A100-SXM4-80GB,8,1,64,448,96,60268
6a9a46b3-1beb-485e-b837-5846a0075415,qwen2-7b-sft-alpacagpt4-chat-3epo-v4-8a809-auto,1719303986,1719364274,finished,1719304006,1719364274,A100-SXM4-80GB,8,1,64,448,20,60268
b249c2ed-626e-43dc-b16b-2140f70e532d,rag-rank,1719304035,1719304303,finished,1719304054,1719304303,A100-SXM4-80GB,8,1,64,448,19,249
1a7240ef-f439-40b4-b567-c9b4cf8973b6,qwen1-5-110b,1719304068,1719391236,finished,1719304087,1719391236,A100-SXM4-80GB,8,1,64,448,19,87149
ae37e645-3212-438d-9f9d-9f4f948bbcd8,paly-qwen2-7b-sft,1719304084,1719305043,finished,1719304104,1719305043,A100-SXM4-80GB,8,1,64,896,20,939
532bd45e-ff2e-432a-89c4-659d2aeaac74,ruler-eval-0625,1719304092,1719367403,finished,1719304112,1719367403,A100-SXM4-80GB,8,1,64,896,20,63291
af4451ef-e7cd-4cc0-97ad-7a6d19158656,data-gen-magpie,1719304100,1719304912,finished,1719304120,1719304912,A100-SXM4-80GB,8,1,64,448,20,792
c4eaf00f-12b2-4ede-b6d5-f9578b4f9e6e,llama-oscar,1719304115,1719304945,finished,1719304656,1719304945,A100-SXM4-80GB,8,1,64,896,541,289
d4b3e052-5958-46ed-a189-f34125b69028,geogept-gate-eval,1719304496,1719332362,finished,1719304663,1719332362,A100-SXM4-80GB,8,1,64,448,167,27699
837f74ab-fa1a-4600-89b0-754be2a49015,rag-rank,1719304925,1719305187,finished,1719304943,1719305187,A100-SXM4-80GB,8,1,64,448,18,244
23d883ab-85f5-41f3-9b83-b7a6d24f761e,geogpt-qwen2-chat-0612dpo-dare-ties-p57,1719305097,1719307885,finished,1719305117,1719307885,A100-SXM4-80GB,8,1,64,448,20,2768
af61cda3-5b86-46d1-9904-9c33f8ee6854,data-gen-magpie,1719305135,1719305755,finished,1719305155,1719305755,A100-SXM4-80GB,8,1,64,448,20,600
50404dec-2f1c-4b22-a3c2-0e9d24fd8af4,qwen2-72b-chat-sft-dpo,1719305295,1719308809,finished,1719305316,1719308809,A100-SXM4-80GB,8,1,64,448,21,3493
bb7766cc-bcc7-4174-803a-7e701a4b46c2,rag-rank,1719305346,1719305466,finished,1719305367,1719305466,A100-SXM4-80GB,8,1,64,448,21,99
0a1eabf9-4ea1-41d7-9ccd-d13a98a8b276,paly-qwen2-7b-sft,1719305377,1719306800,finished,1719305397,1719306800,A100-SXM4-80GB,8,1,64,896,20,1403
e1cacb3c-2f77-4e21-ab8f-b20578610365,llama-oscar,1719305429,1719305506,finished,1719305448,1719305506,A100-SXM4-80GB,8,1,64,896,19,58
d5fcc458-1a15-4ca2-911e-0a96707382b8,qwen1-5-7b-chat-b3afb-auto,1719305590,1719307062,finished,1719305610,1719307062,A100-SXM4-80GB,8,1,64,448,20,1452
6ec2b1b6-4cc8-4b0a-9200-1c265be06b93,llama-oscar,1719305673,1719305750,finished,1719305692,1719305750,A100-SXM4-80GB,8,1,64,896,19,58
9daac510-c935-47af-81bd-4d589e85225a,qwen2-72b-chat2,1719305731,1719364246,finished,1719305752,1719364246,A100-SXM4-40GB,8,1,32,320,21,58494
51b5ec9d-d2ea-47f9-8eca-02af4f8189d1,rag-rank,1719305785,1719305912,finished,1719305805,1719305912,A100-SXM4-80GB,8,1,64,448,20,107
a68e5cb2-3daf-496f-ad18-44556af3fe72,cft-mt-lr1e-5-14b,1719305881,1719364270,finished,1719305900,1719364270,A100-SXM4-80GB,8,1,64,448,19,58370
e1d610dc-47ac-4e2a-8028-5542cd64e34f,Llama-3-70B-58a4f-auto,1719305946,1719344202,finished,1719305965,1719344202,A100-SXM4-80GB,8,1,64,448,19,38237
6c8213fd-ccd4-4dd2-8f64-7feb38102dbd,llama-oscar,1719305955,1719306322,finished,1719305974,1719306322,A100-SXM4-80GB,8,1,64,896,19,348
f2ab6918-e9f3-4beb-99a2-ba46cc4cc20e,llama-oscar,1719306377,1719306532,finished,1719306396,1719306532,A100-SXM4-80GB,8,1,64,896,19,136
a6702430-368c-4dc9-ac3d-2d6d6ec3f93c,llama3-8b-sft-alpacagpt4-chat-3epo-v4-a040f-auto,1719306424,1719364253,finished,1719306445,1719364253,A100-SXM4-80GB,8,1,64,448,21,57808
e3c68106-9a63-4ce5-a0e2-d7c75a87b1c9,lzk-qwen15-7b-base-scihub-abstract-qa-sft,1719306430,1719307082,finished,1719306449,1719307082,A100-SXM4-80GB,8,1,64,448,19,633
2408361e-0f84-4326-984b-9da71c9127c7,rag-rank,1719306436,1719307935,finished,1719306455,1719307935,A100-SXM4-80GB,8,1,64,448,19,1480
32807b7b-3d48-4bc7-8fa0-273122091716,geo-router-block-weight-reserved,1719306718,1719372893,finished,1719307772,1719372893,A100-SXM4-80GB,8,2,64,448,1054,65121
4c47787d-8188-4ecf-83a8-0848372d24dc,gpt-megatron,1719306733,1719307180,finished,1719306790,1719307180,A100-SXM4-80GB,8,2,64,448,57,390
c9e32740-6e65-4c3d-9e33-21d1c71d27e1,docxchain-iso-002,1719306852,1719307553,finished,1719306870,1719307553,A100-SXM4-40GB,1,1,8,32,18,683
16f68e87-3a34-4678-9c4a-464478b1f59f,lzk-qwen15-7b-base-scihub-abstract-qa-sft,1719307082,1719492921,finished,1719307101,1719492921,A100-SXM4-80GB,8,1,64,448,19,185820
c43eded0-a90a-4922-ba39-9ca18ab44d91,llama-oscar,1719307183,1719307274,finished,1719307202,1719307274,A100-SXM4-80GB,8,1,64,896,19,72
7aad5d18-ec5a-4db3-a572-a0ff8f51336a,lt-train,1719307400,1719307554,finished,1719307420,1719307554,A100-SXM4-80GB,8,1,64,896,20,134
4cd52af1-554e-4073-82e2-f28d0293ff22,geogpt-dairui-eval-code,1719307441,1719307595,finished,1719307481,1719307595,A100-SXM4-80GB,8,1,64,896,40,114
4954e08f-88cd-40f9-83bf-e83c3f033e47,geogpt-dairui-model-merge-exp-1,1719307500,1719307616,finished,1719307519,1719307616,A100-SXM4-80GB,8,1,64,896,19,97
0b13d3a5-fbdd-47cf-96c0-33ac75c3abd2,docxchain-iso-002,1719307553,1719308407,finished,1719307571,1719308407,A100-SXM4-40GB,1,1,8,32,18,836
69d94226-4645-4ce5-9f96-132d8f657c4d,geogpt-dairui-eval-code,1719307595,1719307713,finished,1719307616,1719307713,A100-SXM4-80GB,8,1,64,896,21,97
ff8db990-760f-44d6-8416-b4010a26b675,lt-train,1719307632,1719307711,finished,1719307650,1719307711,A100-SXM4-80GB,8,1,64,896,18,61
193b9985-9515-4cd4-b4f6-5a8bb7e152ca,llama-oscar,1719307711,1719307900,finished,1719307730,1719307900,A100-SXM4-80GB,8,1,64,896,19,170
f8f9ea04-9ecd-40ec-bd52-e3115de6beef,lt-train,1719307769,1719310344,finished,1719307789,1719310344,A100-SXM4-80GB,8,1,64,896,20,2555
884e7326-5dde-4e40-b652-bb0cdd51d379,gpt-megatron,1719307786,1719308533,finished,1719307824,1719308533,A100-SXM4-80GB,8,2,64,448,38,709
c9b68ade-b403-41db-ad80-4f54c5979b8c,qwen2-72b-11bcpt-2ep-68760-auto,1719307888,1719332326,finished,1719307907,1719332326,A100-SXM4-80GB,8,1,64,448,19,24419
d1c1a96a-a112-41e3-8a7f-d93ac72c6593,geogpt-dairui-eval-code-2,1719308013,1719316950,finished,1719308067,1719316950,A100-SXM4-80GB,8,1,64,448,54,8883
51a9ce50-f185-4d11-abbb-3c672cdf1de9,geogpt-dairui-eval-code,1719308105,1719316950,finished,1719313305,1719316950,A100-SXM4-80GB,8,1,64,896,5200,3645
eb9da767-782e-471e-b394-1eb47ef6d437,docxchain-iso-002,1719308408,1719364124,finished,1719308425,1719364124,A100-SXM4-40GB,1,1,8,32,17,55699
61a40198-96d7-4db1-827f-c836c1f06d94,geo-seesaw-sft-code-alpaca-ultra-eval-test,1719308447,1719409760,finished,1719314076,1719409760,A100-SXM4-80GB,8,1,64,896,5629,95684
c20610b6-2baf-4823-a99b-0de707b7f661,qwen2-72b-chat-sft-dpo,1719308898,1719365566,finished,1719308916,1719365566,A100-SXM4-80GB,8,1,64,448,18,56650
c2160587-a7a7-419e-815f-8977cec4981d,geogpt-qwen2-chat-0612dpo-dare-ties-p57,1719309822,1719381255,finished,1719309842,1719381255,A100-SXM4-80GB,8,1,64,448,20,71413
ac998c38-6e1d-4d98-ac10-a329bc5ef571,lt-train,1719310436,1719310605,finished,1719310456,1719310605,A100-SXM4-80GB,8,1,64,896,20,149
024c419a-16f0-4297-a240-f70e7f79f7bb,geogpt-qwen2-chat-0612dpo-dare-ties-p17,1719310461,1719483776,finished,1719310482,1719483776,A100-SXM4-80GB,8,1,64,448,21,173294
484712c5-5b88-4322-8062-ba4948408bbc,lt-train,1719311180,1719312090,finished,1719311200,1719312090,A100-SXM4-80GB,8,1,64,896,20,890
00c4da52-a937-44e9-a50c-4074ce131e37,lt-train,1719312090,1719314057,finished,1719312109,1719314057,A100-SXM4-80GB,8,1,64,896,19,1948
1d0b4925-852f-439c-90df-b256649d2f94,geogpt-lxz-cft-new-mix-geotable-1-8m-sub-m1l3-72b,1719313408,1719318888,finished,1719313939,1719318888,A100-SXM4-80GB,8,16,64,448,531,4949
30aa342d-8524-4b6d-a7d2-5902c444c05c,geogpt-btx-2x14b-sf4,1719313986,1719319879,finished,1719319372,1719319879,A100-SXM4-80GB,8,16,64,896,5386,507
1bf76375-42d9-44d5-b2af-99f0b4504da4,geo-all-weight-raw,1719314168,1719331496,finished,1719316968,1719331496,A100-SXM4-80GB,8,1,64,448,2800,14528
eef781fe-811f-439d-aec7-c7234ff3be91,lt-train,1719314254,1719316851,finished,1719314274,1719316851,A100-SXM4-80GB,8,1,64,896,20,2577
158c24aa-2c34-41e4-a65f-436c5a607e4c,geogpt-0612,1719314532,1719401653,finished,1719314553,1719401653,A100-SXM4-80GB,8,1,64,448,21,87100
aef08d60-7dfb-45e5-bf88-3e7f947cb2df,qwen2-72b-sft-dpo,1719314929,1719319320,finished,1719318928,1719319320,A100-SXM4-80GB,8,4,64,896,3999,392
3efd7d47-5674-4e1e-b3b7-931e02a2256b,test-tq,1719315134,1719315263,finished,1719315154,1719315263,A100-SXM4-80GB,8,1,64,896,20,109
a0142838-654d-4eb7-9753-b52e51236524,qwen1-5-7b-llamapro40-6b6ef-auto,1719315214,1719336916,finished,1719315234,1719336916,A100-SXM4-80GB,8,1,64,448,20,21682
8d228641-03ab-4cd1-aa0f-b19f15d580d9,qwen1-5-7b-llamapro40-25bgeo-42a3d-auto,1719315288,1719337305,finished,1719315308,1719337305,A100-SXM4-80GB,8,1,64,448,20,21997
b90ca676-a2e7-442a-9355-54f8b21e4777,test,1719315981,1719316585,finished,1719316000,1719316585,A100-SXM4-80GB,8,1,64,896,19,585
268cbd6f-8c46-4ca9-921c-032e257adf61,Qwen2-72B-Instruct-3a6ff-auto,1719316030,1719318530,finished,1719316049,1719318530,A100-SXM4-80GB,8,1,64,448,19,2481
5af86e8b-17b7-4762-ae15-0292f8747146,Qwen1-5-110B-Chat-3a599-auto,1719316088,1719318911,finished,1719316579,1719318911,A100-SXM4-80GB,8,1,64,448,491,2332
8112cb75-df09-4b2f-bc32-e6bae7ef8e41,Llama-3-70B-Instruct-31b84-auto,1719316162,1719318780,finished,1719316878,1719318780,A100-SXM4-80GB,8,1,64,448,716,1902
17f3318e-8bff-4e57-89fb-2bd6906a0d4b,Qwen2-7B-5047d-auto,1719316524,1719364296,finished,1719316560,1719364296,A100-SXM4-80GB,8,1,64,448,36,47736
5a0910f8-bc8c-4104-9d44-c6d2cf038faf,test,1719316963,1719317441,finished,1719316983,1719317441,A100-SXM4-80GB,8,1,64,896,20,458
87508fa0-bde9-4cd1-b3dc-8289688771c9,lt-train,1719317006,1721822083,finished,1719317026,1721822083,A100-SXM4-80GB,8,1,64,896,20,2505057
e53e8b0e-a3e5-4be8-9d60-14aea3e5d1a0,geogpt-dairui-model-merge-exp-1,1719317363,1719369997,finished,1719337011,1719369997,A100-SXM4-80GB,8,1,64,896,19648,32986
71089903-a66c-4e0a-9eb8-88f42026b98d,geogpt-dairui-eval-code,1719317364,1719368832,finished,1719331515,1719368832,A100-SXM4-80GB,8,1,64,896,14151,37317
082f8d56-cdbd-4b0c-94ab-8027b2a2e88b,geogpt-dairui-eval-code-2,1719317367,1719369959,finished,1719317426,1719369959,A100-SXM4-80GB,8,1,64,448,59,52533
c1519856-ca46-4ba0-a325-ab617b720322,geogpt-7b-llamapro40-s2-sft-200k,1719317372,1719318853,finished,1719318546,1719318853,A100-SXM4-80GB,8,1,64,448,1174,307
8265f20f-a0c0-4a15-b98b-a0763bb79075,qwen2-72b,1719317376,1719405638,finished,1719318529,1719405638,A100-SXM4-80GB,8,1,64,448,1153,87109
e28baa5c-07f6-4e85-bdf7-8307f4cfdea4,test,1719317441,1719319446,finished,1719318863,1719319446,A100-SXM4-80GB,8,1,64,896,1422,583
93c489b1-1338-4588-8eb5-4bd0534c8faf,geogpt-lxz-cft-1-8m-sub-m1l3-geo-magpie-72b,1719318773,1719328053,finished,1719319918,1719328053,A100-SXM4-80GB,8,16,64,448,1145,8135
14111a2f-8ac3-4573-8887-66bf0635f370,geogpt-eval-latest,1719318849,1719614940,finished,1719318869,1719614940,A100-SXM4-80GB,8,1,64,896,20,296071
0ca55a79-4a3d-483c-8ad3-a0d7e1cb3bd4,test-tq,1719319200,1719319331,finished,1719319220,1719319331,A100-SXM4-80GB,8,1,64,896,20,111
eca6a22f-4a6a-45a7-84df-c89e31286fb9,test-tq,1719319613,1719319726,finished,1719319633,1719319726,A100-SXM4-80GB,8,1,64,896,20,93
261aca05-565b-4cc7-82f7-d2e58652c457,geogpt-btx-2x14b-sf4,1719319943,1719328581,finished,1719328089,1719328581,A100-SXM4-80GB,8,16,64,896,8146,492
2113ab85-101a-41ab-8a2c-d11fa4bdb777,geogpt-7b-llamapro40-s2-sft-200k,1719320075,1719320520,finished,1719320094,1719320520,A100-SXM4-80GB,8,1,64,448,19,426
9e9aa23b-a654-4701-a685-73d1d9bb430d,test,1719320271,1719321104,finished,1719320511,1719321104,A100-SXM4-80GB,8,1,64,896,240,593
1d9647ff-be93-4e5b-87ea-1d183b77900a,geogpt-7b-llamapro40-s2-sft-200k,1719320686,1719359928,finished,1719321113,1719359928,A100-SXM4-80GB,8,1,64,448,427,38815
b2f0fc7a-b372-4538-abcf-bb5ff01f7dd1,qwen2-72b-sft-dpo,1719321172,1719383004,finished,1719328119,1719383004,A100-SXM4-80GB,8,4,64,896,6947,54885
4c455d29-014f-4ef4-97dd-d4eeafc8e2ca,test,1719326526,1719327844,finished,1719327117,1719327844,A100-SXM4-80GB,8,1,64,896,591,727
b6171a38-b5d2-40eb-b4d1-90b5c14ce4c1,geogpt-lxz-cft-1-8m-sub-m1l3-geo-magpie-72b,1719328116,1719360584,finished,1719337553,1719360584,A100-SXM4-80GB,8,16,64,448,9437,23031
d7a837b5-0cd0-4f3e-aceb-9533a6ded1ca,test,1719328303,1719328651,finished,1719328593,1719328651,A100-SXM4-80GB,8,1,64,896,290,58
6959ee12-811b-491c-9bf3-7ebc472c71a7,geogpt-btx-2x14b-sf4,1719328639,1719337535,finished,1719336969,1719337535,A100-SXM4-80GB,8,16,64,896,8330,566
a64881a1-3563-4828-8ea7-078e07478341,geogpt-table-qwen2-72b-datav040,1719330397,1719334854,finished,1719330434,1719334854,A100-SXM4-80GB,8,4,64,896,37,4420
84d49594-8bbb-4c41-8fc3-90a5bb4e2463,test,1719331141,1719331250,finished,1719331159,1719331250,A100-SXM4-80GB,8,1,64,448,18,91
e9ac147d-ae99-47d7-b702-f3ac677022e1,test,1719331397,1719331510,finished,1719331416,1719331510,A100-SXM4-80GB,8,1,64,448,19,94
ba371fe6-fd8f-4573-8759-80a081ce097f,test,1719331730,1719331839,finished,1719331747,1719331839,A100-SXM4-80GB,8,1,64,448,17,92
b1fe1766-66ee-4cf2-8f61-9dca9f6303bd,test,1719332024,1719332133,finished,1719332042,1719332133,A100-SXM4-80GB,8,1,64,448,18,91
791cb3cb-e66b-4aca-9161-4e084ba6487c,test,1719332609,1719332717,finished,1719332627,1719332717,A100-SXM4-80GB,8,1,64,448,18,90
64dc8a29-9875-4f57-9b3e-49cf906824a7,test,1719332901,1719333011,finished,1719332919,1719333011,A100-SXM4-80GB,8,1,64,448,18,92
28aa59af-16c2-4ef5-bcfd-ffb8fc8028da,geo-seesaw-sft-gsm8k20k-code-merge,1719333072,1719349541,finished,1719337011,1719349541,A100-SXM4-80GB,8,1,64,896,3939,12530
16217cf4-8b15-497b-91d1-9961a854065c,test,1719333180,1719333289,finished,1719333199,1719333289,A100-SXM4-80GB,8,1,64,448,19,90
b0aba4e4-58d9-4b48-bc41-7b09ebcdf452,test,1719333562,1719333670,finished,1719333581,1719333670,A100-SXM4-80GB,8,1,64,448,19,89
29ee27a4-fe38-4039-9786-001bcb07fb6f,test,1719333852,1719333961,finished,1719333870,1719333961,A100-SXM4-80GB,8,1,64,448,18,91
14632057-27fa-4931-893e-fcaa81062c9a,test,1719334107,1719334216,finished,1719334125,1719334216,A100-SXM4-80GB,8,1,64,448,18,91
c54c1a92-40c9-4b9b-a683-35c7f5cb0645,test,1719334271,1719334380,finished,1719334290,1719334380,A100-SXM4-80GB,8,1,64,448,19,90
cc6ace9b-3126-4438-ae80-3eaffd84a85c,test,1719334777,1719334904,finished,1719334796,1719334904,A100-SXM4-80GB,8,1,64,448,19,108
57b04890-6416-4762-a26e-b6bef4ab8926,test,1719335015,1719335125,finished,1719335033,1719335125,A100-SXM4-80GB,8,1,64,448,18,92
595a02d7-8d6a-41d9-98ab-23734d59f7d5,test,1719335272,1719335382,finished,1719335291,1719335382,A100-SXM4-80GB,8,1,64,448,19,91
13c825ef-3b8c-4882-aee0-80a042f5f9e6,test,1719335619,1719335728,finished,1719335638,1719335728,A100-SXM4-80GB,8,1,64,448,19,90
bb823a07-3c54-4f6f-b19c-9bbfb2bdf966,test,1719335874,1719335985,finished,1719335893,1719335985,A100-SXM4-80GB,8,1,64,448,19,92
23d847d7-6f75-4224-9e33-bac95d197c3d,geogpt-btx-2x14b-sf4,1719337601,1719361121,finished,1719360620,1719361121,A100-SXM4-80GB,8,16,64,896,23019,501
43761622-9aab-452d-abbb-49e5a4bc29cb,test,1719337865,1719338101,finished,1719337882,1719338101,A100-SXM4-80GB,8,1,64,448,17,219
4b59158c-620e-4be9-9f3f-8a4c83fa7604,test,1719338409,1719338517,finished,1719338427,1719338517,A100-SXM4-80GB,8,1,64,448,18,90
ba838817-382e-4c36-96eb-33eb8ef3d7b3,geogpt-lxz-cft-1-8m-sub-m1l3-geo-magpie-72b,1719360646,1719362114,finished,1719361158,1719362114,A100-SXM4-80GB,8,16,64,448,512,956
4cc13fa4-00ac-4f5c-8df6-c9bb632073a3,geogpt-btx-2x14b-sf4,1719361183,1719362628,finished,1719362108,1719362628,A100-SXM4-80GB,8,16,64,896,925,520
fc94cb07-d91b-4547-9223-0ab267fa1417,geogpt-btx-2x14b-sf4,1719362685,1719363253,finished,1719362740,1719363253,A100-SXM4-80GB,8,16,64,896,55,513
3416ad89-611a-4d6d-a5a9-b8080484b543,gpt-megatron,1719362811,1719363574,finished,1719362865,1719363574,A100-SXM4-80GB,8,2,64,448,54,709
85caca55-9c11-4835-8d22-a01bad05b945,geogpt-btx-2x14b-sf4,1719363309,1719363866,finished,1719363363,1719363866,A100-SXM4-80GB,8,16,64,896,54,503
082ad5d2-e336-4af1-87ad-f4929afaaed5,geogpt-btx-2x14b-sf4,1719363920,1719364485,finished,1719363974,1719364485,A100-SXM4-80GB,8,16,64,896,54,511
bfccc1c2-d9cc-4861-9222-137e6e4cbc78,table-iso-002,1719364103,1719916743,finished,1719364123,1719916743,A100-SXM4-40GB,1,1,16,256,20,552620
2c215e69-e6a1-41ae-868d-13d9804c4e7d,formula-iso-002,1719364123,1719916700,finished,1719364142,1719916700,A100-SXM4-40GB,1,1,8,96,19,552558
436b798f-66dc-4a2d-9abe-810a4c1ef85f,docxchain-iso-002,1719364124,1719916744,finished,1719364142,1719916744,A100-SXM4-40GB,1,1,8,32,18,552602
eefbbc0b-e69f-4402-8035-9c0b98a8b19d,reranker-inference,1719364201,1719364423,finished,1719364242,1719364423,A100-SXM4-80GB,8,1,64,448,41,181
1e427644-b4c4-40a1-b09b-853c64445b4a,geogpt-prompt-tuning-tg-infer1,1719364233,1719381636,finished,1719370369,1719381636,A100-SXM4-80GB,8,1,64,448,6136,11267
9da5deec-9bd1-45b6-b231-199adad2727e,qwen2-72b-chat2,1719364246,1719369575,finished,1719364268,1719369575,A100-SXM4-40GB,8,1,32,320,22,5307
6f1513b1-b041-4f3b-98e6-98d2d8e5e025,cft-mt-lr1e-5-14b,1719364271,1719400351,finished,1719364291,1719400351,A100-SXM4-80GB,8,1,64,448,20,36060
11cdacc9-8118-4720-99e4-fa46b3456cf0,reranker-inference11,1719364342,1719364579,finished,1719364362,1719364579,A100-SXM4-80GB,8,1,64,448,20,217
51c3ba70-2c2c-4c46-b220-59d3fda15172,geogpt-btx-2x14b-sf4,1719364545,1719365124,finished,1719364603,1719365124,A100-SXM4-80GB,8,16,64,896,58,521
f4bc7e61-637d-4d2b-893a-2bbd0b9f7164,reranker-inference,1719364738,1719364818,finished,1719364759,1719364818,A100-SXM4-80GB,8,1,64,448,21,59
edb4a921-cf22-477f-882b-1483ef11b79e,reranker-inference11,1719364799,1719364915,finished,1719364818,1719364915,A100-SXM4-80GB,8,1,64,448,19,97
da18c53a-d263-4e96-9e71-4f47d10440b3,llama-oscar,1719364820,1719364956,finished,1719364840,1719364956,A100-SXM4-80GB,8,1,64,896,20,116
306250f2-d8fb-432e-b82f-27baf984ab24,test,1719364856,1719365137,finished,1719364876,1719365137,A100-SXM4-80GB,8,1,64,448,20,261
8e45b12e-6b98-4fd0-8b3b-eff7dd8c02f2,reranker-inference,1719365037,1719368391,finished,1719365057,1719368391,A100-SXM4-80GB,8,1,64,448,20,3334
b85e6cf9-af69-4e08-bcdb-959441342ae0,reranker-inference11,1719365057,1719375150,finished,1719365077,1719375150,A100-SXM4-80GB,8,1,64,448,20,10073
9d61edce-174e-48c3-8dde-ecc4a5b3795e,llama-oscar,1719365099,1719365286,finished,1719365120,1719365286,A100-SXM4-80GB,8,1,64,896,21,166
105b55f0-df74-4eb7-89c9-2acc3752f577,geogpt-btx-2x14b-sf4,1719365187,1719365742,finished,1719365225,1719365742,A100-SXM4-80GB,8,16,64,896,38,517
26dd5a18-00e2-49fb-afc8-b53b06ff4a7e,sfr-embedding-test,1719365246,1719451818,finished,1719365266,1719451818,A100-SXM4-80GB,8,1,64,448,20,86552
c5fbdb10-319b-4a38-b254-93dad841ae02,test,1719365283,1719365556,finished,1719365303,1719365556,A100-SXM4-80GB,8,1,64,448,20,253
10ca31e1-1b0c-46ab-8a2b-16a579283077,gpt-megatron,1719365496,1719367481,finished,1719365556,1719367481,A100-SXM4-80GB,8,2,64,448,60,1925
eae82741-8239-4ad5-bff7-ae176137159c,qwen2-72b-chat-sft-dpo,1719365626,1719365914,finished,1719365647,1719365914,A100-SXM4-80GB,8,1,64,448,21,267
30b799a1-1370-403d-8a75-ea6e85d333f8,geogpt-btx-2x14b-sf4,1719365802,1719366387,finished,1719365865,1719366387,A100-SXM4-80GB,8,16,64,896,63,522
4c721284-2b49-4ad6-8f2d-6a47f1e2f270,qwen2-72b-chat-sft-dpo,1719365972,1719366348,finished,1719365993,1719366348,A100-SXM4-80GB,8,1,64,448,21,355
cf88254f-25d4-44f1-8f95-529efbb35869,test,1719366043,1719366337,finished,1719366063,1719366337,A100-SXM4-80GB,8,1,64,448,20,274
baa1fba9-b6f5-4871-8546-da4b08ff22ef,llama-oscar,1719366124,1719366568,finished,1719366145,1719366568,A100-SXM4-80GB,8,1,64,896,21,423
944df6f5-ef15-439a-a91b-12de907d32f4,test,1719366337,1719366460,finished,1719366358,1719366460,A100-SXM4-80GB,8,1,64,448,21,102
39df767f-c16d-4f54-89be-dc6f591aed83,geogpt-btx-2x14b-sf4,1719366448,1719367007,finished,1719366487,1719367007,A100-SXM4-80GB,8,16,64,896,39,520
dc1cc88b-2ea9-4e9c-8d05-8b47b0ade626,slimorca-geo-mtm1-mt-wild-14b,1719366596,1719400307,finished,1719366616,1719400307,A100-SXM4-80GB,8,1,64,448,20,33691
3579e436-472b-4ffc-8ee5-25ba9227d092,slimorca-geo-mtm1-geotable-nt-14b,1719366676,1719400330,finished,1719366695,1719400330,A100-SXM4-80GB,8,1,64,448,19,33635
59939877-80de-45e4-b452-f6615967dbeb,llama-oscar,1719366941,1719370304,finished,1719366961,1719370304,A100-SXM4-80GB,8,1,64,896,20,3343
6b526d46-cdec-467e-93f0-5be3d957aa20,test,1719367019,1719367145,finished,1719367039,1719367145,A100-SXM4-80GB,8,1,64,448,20,106
7ca07e27-0def-45e5-8192-446aad351278,geogpt-btx-2x14b-sf4,1719367068,1719367644,finished,1719367107,1719367644,A100-SXM4-80GB,8,16,64,896,39,537
82d56a3c-0e8b-4ead-9f9e-df68043b5c98,test,1719367243,1719367363,finished,1719367263,1719367363,A100-SXM4-80GB,8,1,64,448,20,100
9a5ee06e-db80-448b-a91f-100ce3b0d8b1,qwen2-72b-chat-sft-dpo,1719367275,1719367453,finished,1719367296,1719367453,A100-SXM4-80GB,8,1,64,448,21,157
07a7d8af-6862-4cba-bdb7-af86a7f2467f,geogpt-dairui-model-merge-exp-2,1719367310,1719368250,finished,1719367329,1719368250,A100-SXM4-80GB,8,1,64,896,19,921
ed0fe2b5-2db1-4655-a8ae-f9b53bdd170d,test,1719367539,1719367616,finished,1719367558,1719367616,A100-SXM4-80GB,8,1,64,448,19,58
c8c6a13c-f1c4-4395-8800-b7568694dc79,test,1719367700,1719377788,finished,1719367721,1719377788,A100-SXM4-80GB,8,1,64,448,21,10067
9e99ca12-47ee-4287-abf0-585e71151f35,geogpt-btx-2x14b-sf4,1719367708,1719368313,finished,1719367769,1719368313,A100-SXM4-80GB,8,16,64,896,61,544
4461f140-a5f6-4f48-83ea-cfb0a0e9df7f,gpt-megatron,1719367788,1719369756,finished,1719367831,1719369756,A100-SXM4-80GB,8,2,64,448,43,1925
da8ed875-ff42-462b-8678-e5f36edf32cb,ruler-eval-0625,1719367788,1719383614,finished,1719367809,1719383614,A100-SXM4-80GB,8,1,64,896,21,15805
922c3718-c48e-4c9f-84aa-a796141bf3b1,reranker-hn,1719368245,1719370518,finished,1719368266,1719370518,A100-SXM4-80GB,8,1,64,448,21,2252
f1e2a07f-8a98-4a6e-bb98-f1d52062078e,geogpt-btx-2x14b-sf4,1719368377,1719368955,finished,1719368437,1719368955,A100-SXM4-80GB,8,16,64,896,60,518
0b27932c-5167-4318-b578-798957a663bb,qwen2-72b-chat-sft-dpo,1719368381,1719383041,finished,1719368401,1719383041,A100-SXM4-80GB,8,1,64,448,20,14640
8bc58dc5-4221-4cb7-8aa5-8855f4a2f019,geogpt-dairui-eval-code,1719368871,1719369959,finished,1719368891,1719369959,A100-SXM4-80GB,8,1,64,896,20,1068
b11842d1-2338-4fce-9512-78692ad0454a,geogpt-btx-2x14b-sf4,1719369016,1719369579,finished,1719369055,1719369579,A100-SXM4-80GB,8,16,64,896,39,524
5375abc4-6979-48d9-9c31-52659ac9377f,geogpt-btx-2x14b-sf4,1719369640,1719370223,finished,1719369718,1719370223,A100-SXM4-80GB,8,16,64,896,78,505
5d3aef05-8c95-45c3-8482-210465b6c444,gpt-megatron,1719370030,1719372014,finished,1719370091,1719372014,A100-SXM4-80GB,8,2,64,448,61,1923
b96bfc43-8f58-49a4-9b48-d0fad368ae22,geogpt-dairui-eval-code,1719370075,1719416061,finished,1719370097,1719416061,A100-SXM4-80GB,8,1,64,896,22,45964
3e02359d-764e-43be-ac36-55f1d1ea6f05,geogpt-dairui-model-merge-exp-1,1719370097,1719475386,finished,1719370118,1719475386,A100-SXM4-80GB,8,1,64,896,21,105268
1c92dc5c-cdc8-459c-a730-1876cd02db59,geogpt-dairui-eval-code-2,1719370157,1719476821,finished,1719370178,1719476821,A100-SXM4-80GB,8,1,64,448,21,106643
882f7249-cce4-4bef-ad09-66f22f684277,geo-router-block-softmax-reserved-tag-1,1719370260,1719435644,finished,1719370328,1719435644,A100-SXM4-80GB,8,2,64,448,68,65316
b6f575f7-9c88-49dc-a5e9-bd1afdbc4e28,geogpt-btx-2x14b-sf4,1719370287,1719370830,finished,1719370335,1719370830,A100-SXM4-80GB,8,16,64,896,48,495
b8dee998-9125-4ed0-95d1-708252253e3e,geo-router-block-softmax-reserved-tag-10,1719370307,1719435953,finished,1719370380,1719435953,A100-SXM4-80GB,8,2,64,448,73,65573
bb2f9d88-dd4f-4b0a-aa07-d1ee03404b43,geo-router-block-softmax-reserved-tag-10000,1719370331,1719436029,finished,1719370401,1719436029,A100-SXM4-80GB,8,2,64,448,70,65628
fea34fb5-2290-47d9-9300-5d1aeee675e7,geo-router-block-softmax-reserved-tag-10000,1719370333,1719435282,finished,1719370401,1719435282,A100-SXM4-80GB,8,2,64,448,68,64881
87b3504f-f322-4387-8cc7-8a05c058b0a3,llama-oscar,1719370398,1719372667,finished,1719370419,1719372667,A100-SXM4-80GB,8,1,64,896,21,2248
4d45788d-722f-4630-a25d-00d73a011f83,geogpt-btx-2x14b-sf4,1719370890,1719371478,finished,1719370968,1719371478,A100-SXM4-80GB,8,16,64,896,78,510
e1daf678-ae19-497d-ad82-83b1b3dc8174,geo-all-weight,1719371050,1719436455,finished,1719371109,1719436455,A100-SXM4-80GB,8,2,64,448,59,65346
e69f2149-7ebc-4008-86ab-bd18a007e06b,geogpt-7b-llamapro40-s2-sft-200k,1719371423,1719410713,finished,1719371441,1719410713,A100-SXM4-80GB,8,1,64,448,18,39272
8c5ad4a4-412f-4107-9f32-1aac8e8d5bd0,ruler-eval-0626,1719371508,1719372451,finished,1719371533,1719372451,A100-SXM4-80GB,8,1,64,896,25,918
3bd04dc2-949e-461f-809d-e8232a41692c,geogpt-btx-2x14b-sf4,1719371539,1719372107,finished,1719371597,1719372107,A100-SXM4-80GB,8,16,64,896,58,510
1fcb2252-10e7-42ac-82ba-d5058f453b03,reranker-hn,1719372078,1719374223,finished,1719372101,1719374223,A100-SXM4-80GB,8,1,64,448,23,2122
f441007e-79c6-43f1-aebd-3875a350729d,geogpt-btx-2x14b-sf4,1719372166,1719372733,finished,1719372242,1719372733,A100-SXM4-80GB,8,16,64,896,76,491
2a5c94c2-69d4-4580-9d2f-767a1eb021dd,llama-oscar-multinode,1719372550,1719372705,finished,1719372685,1719372705,A100-SXM4-80GB,8,2,64,896,135,20
81d93ef8-33a7-4bea-8498-b691bb4cf984,geogpt-btx-2x14b-sf4,1719372733,1719373314,finished,1719372793,1719373314,A100-SXM4-80GB,8,16,64,896,60,521
03b9da6f-3b1b-48f7-b766-746aa5be1579,llama-oscar-multinode,1719372749,1719372789,finished,1719372769,1719372789,A100-SXM4-80GB,8,2,64,896,20,20
f87e6287-4b2f-4dd5-bd7d-36f4d130301c,geogpt-btx-2x14b-sf4,1719373372,1719373951,finished,1719373411,1719373951,A100-SXM4-80GB,8,16,64,896,39,540
ac4e9225-3311-4dac-ba92-a738363a0c6c,geogept-gate-eval,1719373672,1719483760,finished,1719373691,1719483760,A100-SXM4-80GB,8,1,64,448,19,110069
0e2f07e6-1a12-4b1a-93be-a54b0b1c63a3,qwen2-72b-10bcpt2ep-755b5-auto,1719373807,1719382532,finished,1719373830,1719382532,A100-SXM4-80GB,8,1,64,448,23,8702
b438569c-f239-41fd-a5f8-aa24181068cd,qwen2-72b-10-8bcpt2ep-c4e93-auto,1719373910,1719405050,finished,1719373933,1719405050,A100-SXM4-80GB,8,1,64,448,23,31117
8144a108-4c4a-449d-8faa-cb817fa9cc26,lzk-qwen1-5-7b-base-0af0e-auto,1719373937,1719375435,finished,1719373958,1719375435,A100-SXM4-80GB,8,1,64,448,21,1477
ef105755-4e18-4212-a194-3f27ed1b8dc8,geogpt-btx-2x14b-sf4,1719374012,1719374569,finished,1719374051,1719374569,A100-SXM4-80GB,8,16,64,896,39,518
4342e323-61f5-4d3e-b45a-9fdc636bcf02,lzk-qwen1-5-7b-sci-abs-cpt-lr-1e-4-e2-61cb0-auto,1719374275,1719383886,finished,1719374296,1719383886,A100-SXM4-80GB,8,1,64,448,21,9590
9bf64799-595f-4a86-ad48-a33e1418fa86,lzk-qwen1-5-7b-sci-abs-cpt-lr-2e-4-e2-2701b-auto,1719374355,1719383627,finished,1719374375,1719383627,A100-SXM4-80GB,8,1,64,448,20,9252
744d8684-b7bd-40f3-af29-0b6b2af71c70,llama3-8b-alpaca-chat-3epo-07f89-auto,1719374412,1719377014,finished,1719374436,1719377014,A100-SXM4-80GB,8,1,64,448,24,2578
31afdac4-90ca-4e4b-8a64-d9596dc45ee2,test-tq,1719374428,1719374565,finished,1719374449,1719374565,A100-SXM4-80GB,8,1,64,896,21,116
14f26c23-e09c-4909-b2de-17316982e378,llama3-8b-alpacachat-mos-1ep-e7170-auto,1719374551,1719394462,finished,1719374572,1719394462,A100-SXM4-80GB,8,1,64,448,21,19890
a6f8a482-db0a-49c0-8f69-074406ece963,geogpt-btx-2x14b-sf4,1719374611,1719375625,finished,1719374674,1719375625,A100-SXM4-80GB,8,16,64,896,63,951
019f6f41-4291-4234-8c8c-922eb9bbfff5,lzk-qwen1-5-7b-sci-abs-scpt-lr-1e-4-e2-bc0a7-auto,1719374619,1719383607,finished,1719375455,1719383607,A100-SXM4-80GB,8,1,64,448,836,8152
83cab1b8-1303-4490-a6f1-0819d8064c7c,qwen2-7b-alpacachat-mos-1ep-5398c-auto,1719374636,1719460116,finished,1719374657,1719460116,A100-SXM4-80GB,8,1,64,448,21,85459
06e65086-9eb4-4231-84d7-40ba02624e0f,qwen2-7b-alpaca-chat-3epo-0dfc5-auto,1719374727,1719460116,finished,1719375451,1719460116,A100-SXM4-80GB,8,1,64,448,724,84665
de77a34a-c97a-4f31-a3c3-493ed7809c88,reranker-hn,1719374802,1719377713,finished,1719375482,1719377713,A100-SXM4-80GB,8,1,64,448,680,2231
0d4098f8-979c-4943-9bc9-53e6c524ed44,test-tq,1719375600,1719375738,finished,1719375620,1719375738,A100-SXM4-80GB,8,1,64,448,20,118
a3874199-fbd9-4bc1-bb2d-83e332e70aca,llama-oscar-multinode,1719376410,1719376450,finished,1719376431,1719376450,A100-SXM4-80GB,8,2,64,896,21,19
05b7be8d-133d-4758-9f3e-255d4f5a8c0e,geogpt-benchmark-cw-vllm-02,1719376703,1719383898,finished,1719383619,1719383898,A100-SXM4-80GB,8,1,64,896,6916,279
888b922c-4f23-41a2-9ad6-9329679213d2,reranker-hn2,1719376794,1719376891,finished,1719376814,1719376891,A100-SXM4-80GB,8,1,64,448,20,77
9865a721-a53f-48d5-a44f-82ca79286fe7,llama-oscar,1719377217,1719377387,finished,1719377243,1719377387,A100-SXM4-80GB,8,1,64,896,26,144
c21e8bb3-0e8d-4827-9aba-ed658e27b8a0,geogpt-btx-2x14b-sf4,1719377247,1719377817,finished,1719377307,1719377817,A100-SXM4-80GB,8,16,64,896,60,510
3e70eac2-a3fe-4c0e-8863-c131f8fb725f,llama-oscar,1719377485,1719381105,finished,1719377504,1719381105,A100-SXM4-80GB,8,1,64,896,19,3601
6045f063-6fa1-49cb-bd77-95ca177c5122,reranker-hn2,1719380116,1719381479,finished,1719380136,1719381479,A100-SXM4-80GB,8,1,64,448,20,1343
3ceb1dcd-4add-4614-b94c-c0ab9e21108f,reranker-hn,1719380195,1719381568,finished,1719380215,1719381568,A100-SXM4-80GB,8,1,64,448,20,1353
71ded316-2f51-420d-9882-f3d623d83d31,txchen-eval,1719380267,1719407791,finished,1719383648,1719407791,A100-SXM4-80GB,8,1,64,448,3381,24143
353e6b98-c2d1-4285-9336-29e0c899bba8,llama-oscar,1719381214,1719382491,finished,1719381233,1719382491,A100-SXM4-80GB,8,1,64,896,19,1258
3dcc8dbb-a945-41ed-8026-1994aefec453,geogpt-btx-2x14b-sf4,1719381406,1719381971,finished,1719381460,1719381971,A100-SXM4-80GB,8,16,64,896,54,511
8195ea80-9c97-42db-b395-1c11fcce0a04,gpt-megatron,1719382072,1719384046,finished,1719382128,1719384046,A100-SXM4-80GB,8,2,64,448,56,1918
419d3fec-eaa7-4337-bc6d-a1b35e9d1d9e,rag-rank,1719382129,1719385201,finished,1719382148,1719385201,A100-SXM4-80GB,8,1,64,448,19,3053
7517727e-e5e1-445f-b267-6cb30315aa11,geogpt-btx-2x14b-sf4,1719382174,1719382455,finished,1719382249,1719382455,A100-SXM4-80GB,8,16,64,896,75,206
e91b1786-f8b0-45d1-8adc-979953b4f93b,txchen-train-task,1719382237,1719397685,finished,1719383926,1719397685,A100-SXM4-80GB,8,1,64,448,1689,13759
cf943d60-dd5e-44dc-9b59-39474b3c87d4,geogpt-sft-qwen2-72b-datav081-ep1,1719382473,1719455192,finished,1719382492,1719455192,A100-SXM4-80GB,8,1,64,448,19,72700
e786f891-6739-4deb-9a30-01406f3d4ab6,llama-oscar,1719382581,1719390370,finished,1719382601,1719390370,A100-SXM4-80GB,8,1,64,896,20,7769
e78250b2-5382-4fc3-a5ee-de30f7d590db,reranker-hn,1719382655,1719384504,finished,1719382674,1719384504,A100-SXM4-80GB,8,1,64,448,19,1830
0d8e6fba-3bb6-4d32-a2d8-0765397b8d32,geogpt-prompt-eval-all,1719382776,1719382894,finished,1719382797,1719382894,A100-SXM4-80GB,8,1,64,896,21,97
9b48af37-ed14-46f3-b0ed-96b15e5e8edf,test-tq,1719382824,1719382884,finished,1719382845,1719382884,A100-SXM4-80GB,8,1,64,448,21,39
3f8bfa0f-560d-42b3-b8b1-4e06c222a0fb,megatron-gpt,1719382861,1719383143,finished,1719382937,1719383143,A100-SXM4-80GB,8,2,64,448,76,206
cb4787ae-4f9c-408c-8ef4-7e479d80a634,test-tq,1719382957,1719383089,finished,1719382978,1719383089,A100-SXM4-80GB,8,1,64,448,21,111
b983adad-a3cf-4385-8818-ae75da9101aa,xuzenghui-test,1719383066,1719383418,finished,1719383085,1719383418,A100-SXM4-80GB,8,1,64,896,19,333
c136ef3f-f646-43fc-8945-93914c2fc840,qwen2-72b-chat-sft-dpo,1719383096,1719412209,finished,1719383115,1719412209,A100-SXM4-80GB,8,1,64,448,19,29094
0798e11d-65c8-45c9-8b90-2c9e69489c1b,megatron-gpt-2nodes,1719383269,1719385990,finished,1719383310,1719385990,A100-SXM4-80GB,8,2,64,448,41,2680
84341910-1ff7-42c8-8ecc-fc5a1955c08a,geogpt-prompt-eval-all,1719383304,1719384058,finished,1719383322,1719384058,A100-SXM4-80GB,8,1,64,896,18,736
e38bbce5-0f7f-43c3-b7c7-ae1af899a0b0,ruler-eval-0626,1719383536,1719388460,finished,1719383558,1719388460,A100-SXM4-80GB,8,1,64,896,22,4902
978a4fc1-95ec-4706-82dc-cfdabc2c27e9,geogpt-btx-2x14b-sf4,1719383545,1719384112,finished,1719383592,1719384112,A100-SXM4-80GB,8,16,64,896,47,520
740faa78-f643-4356-aedf-d2727a0472e3,ruler-eval-0625,1719383614,1719388502,finished,1719383634,1719388502,A100-SXM4-80GB,8,1,64,896,20,4868
0d8e6b34-78b5-4872-8ed5-5ea983176eb1,lzk-qwen7b-cpt-lr-1e-4-e2-4e2d8-auto,1719383886,1719385557,finished,1719383907,1719385557,A100-SXM4-80GB,8,1,64,448,21,1650
e5893c36-c583-4c4d-8b67-f84e8cc0d793,qwen2-7b-chat-9f47a-auto,1719383978,1719460116,finished,1719384037,1719460116,A100-SXM4-80GB,8,1,64,448,59,76079
5c7a948b-dfca-42bd-a460-bcf010fb15a2,llama3-8b-chat-f0607-auto,1719384017,1719390086,finished,1719384037,1719390086,A100-SXM4-80GB,8,1,64,448,20,6049
c7640e60-06a8-41fa-8b2d-94225b82c24e,geogpt-prompt-eval-all,1719384058,1719385906,finished,1719384078,1719385906,A100-SXM4-80GB,8,1,64,896,20,1828
a7fb96b1-9a68-463c-8b05-1c8e7ae7ec00,geogpt-leonardo-shieh-dsj,1719384078,1719386454,finished,1719384098,1719386454,A100-SXM4-80GB,8,1,64,448,20,2356
e4822ac1-cdb7-47cf-8efd-4abeb3b2d921,qwen7b-cpt-lr-2e-4-e2-40e5c-auto,1719384137,1719391892,finished,1719390424,1719391892,A100-SXM4-80GB,8,1,64,448,6287,1468
7cec753d-ccc9-4417-bffb-c1f912d9e33a,qwen-72b-test,1719384170,1719385878,finished,1719384190,1719385878,A100-SXM4-40GB,8,1,32,320,20,1688
955fade9-f332-4779-aad6-0bd19e514d83,gpt-megatron,1719384241,1719384466,finished,1719384298,1719384466,A100-SXM4-80GB,8,2,64,448,57,168
a8ae23b6-a369-41aa-9336-6e57686a1add,intent-train-llm-lora-gpt,1719384263,1719385055,finished,1719384282,1719385055,A100-SXM4-80GB,8,1,64,448,19,773
c38f169d-07be-4481-9696-ccfbc1e435ef,test-tq,1719384377,1719419456,finished,1719384396,1719419456,A100-SXM4-80GB,8,1,64,448,19,35060
e1e5d266-6a69-4679-b74f-995e1a5ca903,qwen7b-cpt-lr-1e-5-e2-d711a-auto,1719384641,1719391025,finished,1719389360,1719391025,A100-SXM4-80GB,8,1,64,448,4719,1665
af82641a-99dc-484d-ba7c-6070251d76c2,easycontext-llama3,1719384648,1719388461,finished,1719384705,1719388461,A100-SXM4-80GB,8,12,64,448,57,3756
6ec53b58-6c91-4564-b194-687aed99b2ad,qwen7b-cpt-lr-2e-5-e2-6aa16-auto,1719384722,1719388873,finished,1719387390,1719388873,A100-SXM4-80GB,8,1,64,448,2668,1483
a813df03-e32a-4dcf-8c6d-e1104d820b69,Qwen1-5-7B-Chat-4017b-auto,1719384872,1719394727,finished,1719384894,1719394727,A100-SXM4-80GB,8,1,64,448,22,9833
2f42185f-9d49-4094-8ceb-05dc99e7c0e3,qwen7b-cpt-lr-5e-5-e2-5ba83-auto,1719384875,1719387369,finished,1719385577,1719387369,A100-SXM4-80GB,8,1,64,448,702,1792
8f8023c8-b090-484b-8e78-64a9fe1e754c,qwen7b-cpt-lr-8e-5-e2-f8882-auto,1719384897,1719390403,finished,1719388895,1719390403,A100-SXM4-80GB,8,1,64,448,3998,1508
c7a82cb9-45a4-4213-a466-5c62e8406f05,gpt-megatron,1719384921,1719385145,finished,1719384976,1719385145,A100-SXM4-80GB,8,2,64,448,55,169
bfcddbbd-c06a-464d-8501-b725e6c2de1e,reranker-hn,1719385034,1719387456,finished,1719385053,1719387456,A100-SXM4-80GB,8,1,64,448,19,2403
077c5dd5-0a6e-4a67-9a7e-d72ceecfeaea,intent-train-llm-lora-gpt,1719385337,1719386225,finished,1719385357,1719386225,A100-SXM4-80GB,8,1,64,448,20,868
2f6d664f-c569-486b-b721-1a167c4548a6,reranker-inference11,1719385486,1719385602,finished,1719385507,1719385602,A100-SXM4-80GB,8,1,64,448,21,95
ac1dab09-08e5-421e-ac35-87711ad71b13,test-51713-auto,1719385543,1719466676,finished,1719385563,1719466676,A100-SXM4-80GB,8,1,64,896,20,81113
dcc682ec-cde5-4245-9dfd-1c43a5b1267e,gpt-megatron,1719385582,1719395250,finished,1719385619,1719395250,A100-SXM4-80GB,8,2,64,448,37,9631
c84ec9e4-8152-4bce-9aec-5e5fb3aac2f6,citysora-profile,1719385703,1719386164,finished,1719385819,1719386164,A100-SXM4-80GB,8,4,64,896,116,345
21e6a620-088a-4515-b85f-dba2bb14e02c,Qwen1-5-7B-cf63d-auto,1719385751,1719412858,finished,1719385771,1719412858,A100-SXM4-80GB,8,1,64,448,20,27087
3512adfc-248a-44e8-85cc-cc63c2d04868,geogpt-prompt-eval-all,1719385906,1719799511,finished,1719385926,1719799511,A100-SXM4-80GB,8,1,64,896,20,413585
286ab208-7b53-486b-aa92-561ed218ae38,reranker-inference11,1719386010,1719472706,finished,1719386029,1719472706,A100-SXM4-80GB,8,1,64,448,19,86677
243ba77a-c160-4e11-aa7a-bfc427695aa0,geogpt-btx-2x14b-sf4,1719386189,1719386490,finished,1719386229,1719386490,A100-SXM4-80GB,8,4,64,896,40,261
9937a4c3-48de-4c79-acf2-2fc428e66af2,intent-train-llm-gpt,1719386283,1719387287,finished,1719386303,1719387287,A100-SXM4-80GB,8,1,64,448,20,984
9335c2fa-91cd-4358-9686-bf76c628cc05,qwen-72b-test,1719386382,1719387310,finished,1719386405,1719387310,A100-SXM4-40GB,8,1,32,320,23,905
d331036c-e9f4-450f-a1ec-4b8acb22772c,citysora-profile,1719386405,1719386810,finished,1719386465,1719386810,A100-SXM4-80GB,8,4,64,896,60,345
b0026e11-6fc0-4f93-8cc7-b07c0d2161c7,geogpt-btx-2x14b-sf4,1719386490,1719387291,finished,1719386559,1719387291,A100-SXM4-80GB,8,4,64,896,69,732
26df236a-3e03-442c-bdc3-6496d2fd6cd2,Qwen1-5-72B-3b067-auto,1719386643,1719433966,finished,1719386663,1719433966,A100-SXM4-80GB,8,1,64,448,20,47303
588cb20a-edaf-4f6e-a251-0c401d56a59e,Qwen1-5-110B-55d4a-auto,1719386664,1719463913,finished,1719386684,1719463913,A100-SXM4-80GB,8,1,64,448,20,77229
836a8d0e-c54e-42f0-8b45-2ec1810850ff,Llama-3-70B-0811e-auto,1719386704,1719426687,finished,1719386725,1719426687,A100-SXM4-80GB,8,1,64,448,21,39962
5f97edc4-6d14-4e75-afca-14cc0f91c757,Qwen1-5-72B-Chat-e662b-auto,1719386953,1719403570,finished,1719386972,1719403570,A100-SXM4-80GB,8,1,64,448,19,16598
7de52bcb-52fe-47e0-be46-8b0a9b8fdc5e,Qwen2-72B-Chat-f3c84-auto,1719387012,1719406141,finished,1719387033,1719406141,A100-SXM4-80GB,8,1,64,448,21,19108
d3ff99c5-e56b-4365-976b-67c0914d6770,Llama-3-70B-Instruct-a381b-auto,1719387053,1719402132,finished,1719387074,1719402132,A100-SXM4-80GB,8,1,64,448,21,15058
cdf9169b-54c3-4d34-a569-9d3f594da00a,citysora-profile,1719387086,1719387659,finished,1719387246,1719387659,A100-SXM4-80GB,8,4,64,896,160,413
15f7d556-2610-40fc-b36f-f8a3b3a52841,geogpt-btx-2x14b-sf4,1719387291,1719387878,finished,1719387356,1719387878,A100-SXM4-80GB,8,16,64,896,65,522
a8f54ad6-895d-4c28-ad72-0e7e9a007cb7,paly-qwen2-7b-sft,1719387295,1719389717,finished,1719387317,1719389717,A100-SXM4-80GB,8,1,64,896,22,2400
59fe663b-aa55-470a-9d5e-4df2d38ffab8,reranker-hn2,1719387347,1719389504,finished,1719387377,1719389504,A100-SXM4-80GB,8,1,64,448,30,2127
0a93d899-6f05-4bd3-a486-6e559412b840,qwen-72b-test,1719387351,1719387806,finished,1719387380,1719387806,A100-SXM4-40GB,8,1,32,320,29,426
1f8b352f-8dc3-4951-bd70-75c359fb0940,citysora-modelv4-webvid-humanface-65-128,1719387723,1719455054,finished,1719387786,1719455054,A100-SXM4-80GB,8,4,64,896,63,67268
c03f1522-e096-440a-9693-9a6126789d0b,reranker-hn,1719387849,1719388860,finished,1719387872,1719388860,A100-SXM4-80GB,8,1,64,448,23,988
e31bfc44-aff6-4ca6-9062-1a89da25ec27,geogpt-btx-2x14b-sf4,1719387878,1719388467,finished,1719387951,1719388467,A100-SXM4-80GB,8,16,64,896,73,516
006fc9b1-652c-47c4-b9c8-c3f6a3480726,qwen-72b-test,1719387898,1719389414,finished,1719387922,1719389414,A100-SXM4-40GB,8,1,32,320,24,1492
bf91fd4c-7a37-4206-b088-e8328dc79ce2,llama3-70b-base-914ab-auto,1719388099,1719411468,finished,1719388123,1719411468,A100-SXM4-80GB,8,1,64,896,24,23345
ce76b53c-b84f-4ef0-a86d-b20a5986cf26,txchen-train-task2,1719388116,1719394904,finished,1719389360,1719394904,A100-SXM4-80GB,8,1,64,448,1244,5544
bb11f1d3-14a8-4d56-b33c-3365b58ffbaa,long-context-upsample,1719388308,1719388730,finished,1719388330,1719388730,A100-SXM4-80GB,8,1,64,448,22,400
45cddbf9-ccb5-4597-a373-aabf17844b07,easycontext-llama3,1719388461,1719392889,finished,1719388546,1719392889,A100-SXM4-80GB,8,12,64,448,85,4343
6884ee6c-b3af-43bb-991a-056ff78315c2,geogpt-btx-2x14b-sf4,1719388531,1719389095,finished,1719388578,1719389095,A100-SXM4-80GB,8,16,64,896,47,517
135e2b49-02d6-4417-90d6-b13317dd5ddd,easy-context-llama3-copy,1719388620,1719391161,finished,1719388708,1719391161,A100-SXM4-80GB,8,2,64,448,88,2453
beb1aacb-c13c-4f12-aae1-3d86a625d041,geogpt-prompt-tuning-tg-infer1,1719388700,1719400444,finished,1719388721,1719400444,A100-SXM4-80GB,8,1,64,448,21,11723
e9fdc360-09dc-4c2b-86db-cb160b45fa77,ls2,1719388793,1719396098,finished,1719388816,1719396098,A100-SXM4-80GB,8,1,64,896,23,7282
da445add-f801-4976-b355-863368c76a94,intent-test-llm-all,1719388924,1719389642,finished,1719388945,1719389642,A100-SXM4-80GB,8,1,64,448,21,697
abf83282-aba2-4d22-8351-3fbbb436f5e0,geogpt-btx-2x14b-sf4,1719389201,1719389490,finished,1719389263,1719389490,A100-SXM4-80GB,8,16,64,896,62,227
04d92792-9658-4642-ad89-8acf8104042a,easy-context-llama3-8m,1719389369,1719391293,finished,1719389433,1719391293,A100-SXM4-80GB,8,8,64,448,64,1860
03dd5f1d-3a0a-4e6e-a170-174e9aaaeb46,long-context-upsample,1719389483,1719392960,finished,1719389505,1719392960,A100-SXM4-80GB,8,1,64,448,22,3455
af359155-4d10-4d28-93e2-9fb48787300a,geogpt-btx-2x14b-sf4,1719389490,1719389778,finished,1719389554,1719389778,A100-SXM4-80GB,8,16,64,896,64,224
a2c863db-a081-448e-b8b3-fcfab6cbde6f,qwen-72b-test,1719389709,1719510067,finished,1719389731,1719510067,A100-SXM4-40GB,8,1,32,320,22,120336
8d5c35d1-28d3-4b28-9a4f-bc1d02331c53,geogpt-btx-2x14b-sf4,1719389779,1719390287,finished,1719389841,1719390287,A100-SXM4-80GB,8,16,64,896,62,446
248a4beb-8c11-45b6-952d-3e17674bf118,qwen2-72b-base-da092-auto,1719389966,1719418571,finished,1719389989,1719418571,A100-SXM4-80GB,8,1,64,896,23,28582
8bde4359-cf15-4a6d-a55d-f2e232659fc5,qwen2-72b-instruct-extra-128k-d0ed0-auto,1719390010,1719413987,finished,1719390035,1719413987,A100-SXM4-80GB,8,1,64,896,25,23952
9f85e940-d4c2-48b1-a50d-d2291b5723fd,llama3-70b-instruct-extra-128k-5e370-auto,1719390011,1719452914,finished,1719390035,1719452914,A100-SXM4-80GB,8,1,64,896,24,62879
f3065acc-91c1-44b0-b120-59e1a371361a,llama-factory-zj-test,1719390184,1719390368,finished,1719390229,1719390368,A100-SXM4-80GB,8,2,64,896,45,139
266308ee-092a-473b-9826-69a8d33eaeb6,paly-qwen2-7b-sft,1719390194,1719392769,finished,1719390216,1719392769,A100-SXM4-80GB,8,1,64,896,22,2553
7f44cadd-3a37-4430-8a09-8c6da187c820,qwen-72b-test,1719390232,1719391317,finished,1719390284,1719391317,A100-SXM4-80GB,8,1,64,448,52,1033
93a2b66a-b1b6-44d9-85bd-23f7ecc9db1c,llama-factory-zj-test,1719390647,1719391293,finished,1719390737,1719391293,A100-SXM4-80GB,8,2,64,896,90,556
bc412f27-f3c2-4459-ae32-f40f85555519,intent-test-llm-all,1719390672,1719391404,finished,1719390694,1719391404,A100-SXM4-80GB,8,1,64,448,22,710
cd874153-0e22-43b8-85ce-705867ab603d,easy-context-llama3-8m,1719391293,1719395070,finished,1719391357,1719395070,A100-SXM4-80GB,8,8,64,448,64,3713
18e76938-6c8a-4d6c-b836-f5596c95217a,qwen-72b-test,1719391362,1719457743,finished,1719391385,1719457743,A100-SXM4-80GB,8,1,64,448,23,66358
93109777-c8b8-45e6-a9fb-abe2f9410105,llama-factory-zj-test,1719391403,1719392009,finished,1719391467,1719392009,A100-SXM4-80GB,8,2,64,896,64,542
8b271e72-08e9-464d-8f0e-222c1f0e998e,llama-oscar,1719391554,1719392077,finished,1719391577,1719392077,A100-SXM4-80GB,8,1,64,896,23,500
cf418f36-785b-4b6e-a841-d88fab1a6c20,geogpt-14b-cpt-dynamic,1719391561,1719391754,finished,1719391584,1719391754,A100-SXM4-80GB,8,1,64,448,23,170
bf0a95b0-7ceb-431e-8f84-5b7ab47f0fed,intent-test-llm-all,1719391577,1719391789,finished,1719391598,1719391789,A100-SXM4-80GB,8,1,64,448,21,191
406c05bf-44c1-4552-992b-b10363fcc1a2,geogpt-14b-cpt-dynamic,1719391754,1719394352,finished,1719391816,1719394352,A100-SXM4-80GB,8,20,64,448,62,2536
d713882f-dc47-4a7f-8517-eaf39a29cbcf,qwen7b-scpt-lr-1e-4-e2-81b64-auto,1719392001,1719393570,finished,1719392022,1719393570,A100-SXM4-80GB,8,1,64,448,21,1548
edbe3385-61a2-46f2-8315-977d0d8e6b41,qwen7b-scpt-lr-2e-4-e2-bb400-auto,1719392045,1719393481,finished,1719392068,1719393481,A100-SXM4-80GB,8,1,64,448,23,1413
2623127f-6b8e-4ad8-8cdf-5255bda4be9a,llama-multi,1719392098,1719393136,finished,1719392168,1719393136,A100-SXM4-80GB,8,2,64,896,70,968
a6ab17f4-2da9-41dd-a5bf-1a106462c660,qwen7b-scpt-lr-2e-5-e2-b6dca-auto,1719392134,1719396411,finished,1719394926,1719396411,A100-SXM4-80GB,8,1,64,448,2792,1485
702a9acd-7be5-47c2-98ff-cffd915834e9,qwen7b-scpt-lr-5e-5-e2-73179-auto,1719392136,1719395244,finished,1719393636,1719395244,A100-SXM4-80GB,8,1,64,448,1500,1608
7b40bf50-fa18-496d-9047-65c88e357833,llm-fintune,1719392142,1719392582,finished,1719392163,1719392582,A100-SXM4-80GB,8,1,64,896,21,419
14f7086f-3a7b-49d2-ad8d-6dad279db61e,llama-factory-zj-test,1719392191,1719393334,finished,1719392933,1719393334,A100-SXM4-80GB,8,2,64,896,742,401
84c64cb8-8b6a-42e5-aee4-2e23ae4988c1,qwen7b-scpt-lr-8e-5-e2-81dc1-auto,1719392209,1719395558,finished,1719393765,1719395558,A100-SXM4-80GB,8,1,64,448,1556,1793
eefa36d0-95c1-4dc8-a832-2f28b77834c7,qwen7b-rc-lr-1e-4-e2-26e17-auto,1719392212,1719398209,finished,1719396686,1719398209,A100-SXM4-80GB,8,1,64,448,4474,1523
c6683540-2240-42fe-9ff0-4de3992acb89,Qwen1-5-110B-Chat-7bf4d-auto,1719392276,1719412696,finished,1719392298,1719412696,A100-SXM4-80GB,8,1,64,448,22,20398
26eed710-5fc4-40f4-a623-dd9201006837,intent-test-llm-all,1719392309,1719393624,finished,1719392542,1719393624,A100-SXM4-80GB,8,1,64,448,233,1082
0ff7bd53-ddaf-49ff-bd67-b5281311a683,lzk-scihub-abstract-text-embedding,1719392704,1719393742,finished,1719393615,1719393742,A100-SXM4-80GB,8,1,64,448,911,127
f5320d02-5fed-4d7b-b52d-8e4225132267,easycontext-llama3,1719392890,1719449320,finished,1719392956,1719449320,A100-SXM4-80GB,8,12,64,448,66,56364
7a01ef57-a2f2-4bbd-ba8e-bd94abeac979,long-context-upsample,1719392960,1719394210,finished,1719392982,1719394210,A100-SXM4-80GB,8,1,64,448,22,1228
7e0fb82f-7eba-4840-85cf-552a3d020849,reranker-hn,1719393267,1719395229,finished,1719393291,1719395229,A100-SXM4-80GB,8,1,64,448,24,1938
8ab35fd5-b7c9-45c6-8983-d3410b0f6840,llama-multi,1719393269,1719394345,finished,1719393358,1719394345,A100-SXM4-80GB,8,2,64,896,89,987
d901ee4b-730d-4100-afd5-d43e069c80b4,geogpt-moe-alpaca-sft,1719393331,1719393726,finished,1719393399,1719393726,A100-SXM4-80GB,8,2,64,448,68,327
e5eb3e1a-baae-4e3a-b037-1f59c8080182,llama-factory-zj-test,1719393401,1719394912,finished,1719394365,1719394912,A100-SXM4-80GB,8,4,64,896,964,547
e23fe5d7-2f74-4365-a467-7aac01a76ef1,geogpt-moe-0-5B-sr12-ep1-mlp0,1719393754,1719458181,finished,1719395256,1719458181,A100-SXM4-80GB,8,1,64,896,1502,62925
ed144987-4dd0-44b9-8661-7e944122666f,lzk-scihub-abstract-text-embedding,1719394202,1719395716,finished,1719395584,1719395716,A100-SXM4-80GB,8,1,64,448,1382,132
6c125657-f9a1-4378-a734-e2c166d31915,llama-multi,1719394432,1719401084,finished,1719394498,1719401084,A100-SXM4-80GB,8,2,64,896,66,6586
05f4fea9-5be6-4a6c-b44a-9cd28c61a709,Qwen2-110B-new-12b2e-auto,1719394793,1719433908,finished,1719394817,1719433908,A100-SXM4-80GB,8,1,64,448,24,39091
d8549454-5f6f-4def-a32b-69ccb0b09419,Qwen2-72B-Chat-31b2c-auto,1719394882,1719415576,finished,1719394904,1719415576,A100-SXM4-80GB,8,1,64,448,22,20672
4af2c924-ece0-43bf-b7dd-96176b368080,easy-context-llama3-8m,1719395070,1719397304,finished,1719395136,1719397304,A100-SXM4-80GB,8,8,64,448,66,2168
34a74f61-b6eb-4644-ae06-bd23d06d93c6,long-context-upsample,1719395162,1719397174,finished,1719395184,1719397174,A100-SXM4-80GB,8,1,64,448,22,1990
278d26a2-0bff-45a2-8197-b89be5dc3ee3,geogpt-btx-2x14b-sf4,1719395415,1719396018,finished,1719395481,1719396018,A100-SXM4-80GB,8,16,64,896,66,537
b53bc2a9-a83e-48c4-8de0-41c2f2009f02,gpt-megatron,1719395565,1719396053,finished,1719395612,1719396053,A100-SXM4-80GB,8,2,64,448,47,441
35147b68-5b5f-4d17-863f-9dfde48f71c9,geogpt-benchmark-cw-vllm-02,1719395596,1719396657,finished,1719395728,1719396657,A100-SXM4-80GB,8,1,64,896,132,929
4c1ff573-b4df-41dc-8b84-5fa671266b33,lzk-scihub-abstract-text-embedding,1719395957,1719396899,finished,1719396433,1719396899,A100-SXM4-80GB,8,1,64,448,476,466
a3689eda-6608-4a65-9410-c02a29683c4a,llama-factory-zj-test,1719395965,1719396525,finished,1719396011,1719396525,A100-SXM4-80GB,8,2,64,896,46,514
3cfa973c-9798-435f-a881-77f24fda2896,lzk-scihub-abstract-text-embedding,1719396899,1719397340,finished,1719396925,1719397340,A100-SXM4-80GB,8,1,64,448,26,415
4656d5ba-caef-4a4e-8261-c0c71f2e9dd7,geogpt-btx-2x14b-sf4,1719396938,1719437295,finished,1719396982,1719437295,A100-SXM4-80GB,8,16,64,896,44,40313
412c5113-f0c9-4471-a8ad-aaa9eaf41207,easy-context-llama3-8m,1719397304,1719397954,finished,1719397347,1719397954,A100-SXM4-80GB,8,8,64,448,43,607
6ab1881f-7284-4678-ab2b-493ec37b4fd5,lzk-scihub-abstract-text-embedding,1719397642,1719397770,finished,1719397664,1719397770,A100-SXM4-80GB,8,1,64,448,22,106
1a7ea069-53bb-45e2-b868-825c96de0c75,ls2,1719397843,1719405125,finished,1719397865,1719405125,A100-SXM4-80GB,8,1,64,896,22,7260
54f6af0c-0be6-4883-b232-b897ee8c1143,lzk-scihub-abstract-text-embedding,1719397900,1719413060,finished,1719397926,1719413060,A100-SXM4-80GB,8,1,64,448,26,15134
527896fe-d8aa-4d39-b3b0-818c4850d7ad,easy-context-llama3-8m,1719397954,1719399790,finished,1719398018,1719399790,A100-SXM4-80GB,8,8,64,448,64,1772
7471ffee-b5be-4e82-ac64-9e3ce75e9d06,gpt-megatron,1719398278,1719453231,finished,1719398322,1719453231,A100-SXM4-80GB,8,2,64,448,44,54909
9ad6ea9f-34fb-41ed-909f-4fa99f5f2940,geogpt-benchmark-cw-vllm-02,1719398733,1719425837,finished,1719398755,1719425837,A100-SXM4-80GB,8,1,64,896,22,27082
5c9e85ba-f127-4995-92b8-f504aacdb126,geogpt-llm-moe-expand-0-5B-sr-12-tag,1719398864,1719475803,finished,1719398887,1719475803,A100-SXM4-80GB,8,1,64,896,23,76916
336529f5-ae41-43ee-94ce-8d38649bbb79,geogpt-llm-moe-expand-0-5B-sr-12-aux,1719398888,1719485586,finished,1719409781,1719485586,A100-SXM4-80GB,8,1,64,896,10893,75805
9ce53bbc-eecc-41af-9c9b-94e927f20183,geogpt-llama3-cpt1ep-sft-jsonl,1719399538,1719419769,finished,1719399606,1719419769,A100-SXM4-80GB,8,48,64,448,68,20163
90c3d6f6-2ba7-4905-bc95-366c094927e0,easy-context-llama3-8m,1719399790,1719405753,finished,1719399832,1719405753,A100-SXM4-80GB,8,8,64,448,42,5921
31a22b5a-0c64-4621-9e90-ad6d642fab55,long-context-upsample,1719399857,1719400621,finished,1719399879,1719400621,A100-SXM4-80GB,8,1,64,448,22,742
41dd91ae-0af9-4828-922e-56216b531f99,easy-context-llama3-8m-cp,1719400027,1719404593,finished,1719400408,1719404593,A100-SXM4-80GB,8,8,64,448,381,4185
74744ac7-d518-4d42-9359-bd10f44680ef,slimorca-geo-mtm1-funcfil2-14b,1719400458,1719573905,finished,1719400479,1719573905,A100-SXM4-80GB,8,1,64,448,21,173426
efd0e004-db42-4f55-8d8a-1ab3a943b749,data-gen-magpie,1719401237,1719401752,finished,1719401258,1719401752,A100-SXM4-80GB,8,1,64,448,21,494
1d78eb28-4938-4476-8eae-e418ec41d42a,qwen7b-cpt-lr-1e-5-e1-15735-auto,1719401352,1719409361,finished,1719407812,1719409361,A100-SXM4-80GB,8,1,64,448,6460,1549
f89625cc-5950-45fe-8571-61e2a193a26d,long-context-upsample,1719401404,1719402099,finished,1719401426,1719402099,A100-SXM4-80GB,8,1,64,448,22,673
65371fb2-fa03-4ddd-a0c9-d2705fbbc92f,qwen7b-cpt-lr-2e-5-e1-90fe5-auto,1719401461,1719430339,finished,1719428935,1719430339,A100-SXM4-80GB,8,1,64,448,27474,1404
c7daa72a-1454-4d87-9c87-4dc5bba96c98,easycontext-zj-test,1719401511,1719403344,finished,1719402142,1719403344,A100-SXM4-80GB,8,4,64,896,631,1202
fe79b7c6-378e-445d-a870-0d7f5fa018dd,qwen7b-cpt-lr-8e-5-e1-59ec8-auto,1719401527,1719437537,finished,1719435980,1719437537,A100-SXM4-80GB,8,1,64,448,34453,1557
a406159e-8ef9-47f3-9032-28bc7e44c345,geogpt-0617,1719401613,1719458950,finished,1719401634,1719458950,A100-SXM4-80GB,8,1,64,448,21,57316
16d45c69-9467-428d-80b8-395b96838840,paly-qwen2-7b-sft,1719402359,1719402819,finished,1719402381,1719402819,A100-SXM4-80GB,8,1,64,896,22,438
5500943c-5781-4de1-af73-8d8222c3e3e5,long-context-upsample,1719402500,1719402897,finished,1719402831,1719402897,A100-SXM4-80GB,8,1,64,448,331,66
49355fdc-636d-4e85-9921-78ad6f321669,geogpt-lxz-cft-1-8m-subset-m1l3-2ep-72b,1719402881,1719437337,finished,1719419826,1719437337,A100-SXM4-80GB,8,32,64,448,16945,17511
57a6fb0e-6ba7-42fd-bf3a-e55f629ebb77,geogpt-0612,1719403266,1719468577,finished,1719403290,1719468577,A100-SXM4-80GB,8,1,64,448,24,65287
66aab7b7-e6be-42ca-8bd7-23d7ce8b4f7f,easycontext-zj-test,1719403344,1719404438,finished,1719403405,1719404438,A100-SXM4-80GB,8,4,64,896,61,1033
164c290a-0b93-4433-b08e-f29d1aceb01e,long-context-upsample,1719403471,1719403684,finished,1719403601,1719403684,A100-SXM4-80GB,8,1,64,448,130,83
9be02f96-335c-48bf-8056-5860b9486d8e,cpt-data-processor,1719403542,1719501087,finished,1719403607,1719501087,A100-SXM4-80GB,8,1,64,896,65,97480
86fce98a-f173-403e-af72-5db599532ae4,long-context-upsample,1719403868,1719404525,finished,1719404416,1719404525,A100-SXM4-80GB,8,1,64,448,548,109
c4882cfc-5e97-41b3-9033-bcd0201dacfa,paly-qwen2-7b-sft,1719404024,1719405199,finished,1719404405,1719405199,A100-SXM4-80GB,8,1,64,896,381,794
4caad3ee-3be8-4df3-90b5-f8e92db5466a,data-gen-magpie,1719404148,1719404556,finished,1719404402,1719404556,A100-SXM4-80GB,8,1,64,448,254,154
cf3c95ef-5e3b-4200-a50d-f235636603f3,load-easycontext-ckpt,1719404202,1719404746,finished,1719404417,1719404746,A100-SXM4-80GB,8,1,64,448,215,329
8719ac03-14cf-4a21-b1fa-ca8670c86ac1,citysora-modelv4-cele-ppm-65-512,1719404378,1719404835,finished,1719404463,1719404835,A100-SXM4-80GB,8,5,64,896,85,372
0a5b1826-ae33-41cb-8174-6be4a635f19c,easy-context-llama3-8m-cp,1719404593,1719587535,finished,1719404658,1719587535,A100-SXM4-80GB,8,8,64,448,65,182877
84ef6106-649d-406c-90e1-7d04d4f16c9a,data-gen-magpie,1719404668,1719405258,finished,1719404689,1719405258,A100-SXM4-80GB,8,1,64,448,21,569
8dbca146-6e0a-4e8c-99ad-e2ada5eabf88,citysora-modelv4-cele-ppm-65-512,1719404835,1719419163,finished,1719404900,1719419163,A100-SXM4-80GB,8,5,64,896,65,14263
a28a8a0e-3408-4a2e-81c9-447f353fb335,long-context-upsample,1719405146,1719405273,finished,1719405168,1719405273,A100-SXM4-80GB,8,1,64,448,22,105
786c2762-a0d6-4256-a067-5d47ecfb59ed,geogpt-14b-1-8msft-merge,1719405487,1719476578,finished,1719419209,1719476578,A100-SXM4-80GB,8,16,64,448,13722,57369
dccdb2a8-26d1-467b-94da-561b17688195,easy-context-llama3-8m,1719405753,1719406150,finished,1719405814,1719406150,A100-SXM4-80GB,8,8,64,448,61,336
554bcb08-0dbe-4f45-9af6-0735cda8be48,long-context-upsample,1719405838,1719406714,finished,1719405859,1719406714,A100-SXM4-80GB,8,1,64,448,21,855
acd9410e-bf8a-48a6-9ca4-8c23e2321797,data-gen-magpie,1719405887,1719408757,finished,1719405908,1719408757,A100-SXM4-80GB,8,1,64,448,21,2849
3b0caaac-6ce5-40bb-bd4a-6ffbe9a6805c,easy-context-llama3-8m,1719406757,1719407089,finished,1719406799,1719407089,A100-SXM4-80GB,8,8,64,448,42,290
43364fd6-0e3a-447c-bb7d-fd973fa37874,geogpt-moe-0-5B-sr12-ep1-mlp-fire,1719406869,1719427945,finished,1719413151,1719427945,A100-SXM4-80GB,8,1,64,896,6282,14794
310f4ab3-a71b-484e-9dda-e54a7a4fe7b3,geogpt-moe-0-5B-sr12-ep1-mlp-small,1719406909,1719476418,finished,1719409374,1719476418,A100-SXM4-80GB,8,1,64,896,2465,67044
4c89c5a6-b491-49d2-a31f-e401013ed061,easy-context-llama3-8m,1719407372,1719562261,finished,1719407414,1719562261,A100-SXM4-80GB,8,8,64,448,42,154847
f277bdad-8de7-4a03-be44-368b587b2a55,paly-qwen2-7b-sft,1719408739,1719410573,finished,1719408760,1719410573,A100-SXM4-80GB,8,1,64,896,21,1813
9d2b3502-d420-460e-9e96-c8a8a749ce6d,ls2,1719409041,1719416330,finished,1719409062,1719416330,A100-SXM4-80GB,8,1,64,896,21,7268
c8766b84-6c51-42af-8a21-942e081e7198,geo-seesaw-sft-gsm8k20k-code-merge,1719409556,1719540181,finished,1719435663,1719540181,A100-SXM4-80GB,8,1,64,896,26107,104518
c5f2f132-ab29-454c-86a4-8ebce9bdde85,geo-seesaw-sft-code-alpaca-ultra-eval-test,1719409760,1719679460,finished,1719435300,1719679460,A100-SXM4-80GB,8,1,64,896,25540,244160
cdb705b2-6693-41a2-bedd-b589103ea93f,geo-seesaw-sft-balance-merge-7b,1719410025,1719435799,finished,1719435663,1719435799,A100-SXM4-80GB,8,1,64,896,25638,136
23331530-b7fe-4fad-9751-5709ee112059,long-context-upsample,1719411693,1719411894,finished,1719411734,1719411894,A100-SXM4-80GB,8,2,64,448,41,160
a029793b-2b7f-4263-8599-b0e22f4b3ce5,long-context-upsample,1719411998,1719412181,finished,1719412058,1719412181,A100-SXM4-80GB,8,2,64,448,60,123
10064d9b-8379-4183-a147-304f48d294b6,txchen-eval,1719412113,1719413139,finished,1719413080,1719413139,A100-SXM4-80GB,8,1,64,448,967,59
6b025fba-995b-4064-ae08-783984511452,qwen2-72b-chat-sft-dpo,1719412270,1719468784,finished,1719412291,1719468784,A100-SXM4-80GB,8,1,64,448,21,56493
c7424076-c135-4221-ac2e-3ac911f956a0,long-context-upsample,1719412302,1719412525,finished,1719412384,1719412525,A100-SXM4-80GB,8,2,64,448,82,141
4768f7f3-61ba-463f-9066-b68c7981cc51,long-context-upsample,1719412785,1719413551,finished,1719412847,1719413551,A100-SXM4-80GB,8,2,64,448,62,704
b1297db2-fc45-44a3-bebd-89f06c55a491,Qwen2-72B-57082-auto,1719413204,1719446926,finished,1719413224,1719446926,A100-SXM4-80GB,8,1,64,448,20,33702
09ddc367-971e-45c1-9b72-e9a37699a789,txchen-eval,1719413324,1719427450,finished,1719427370,1719427450,A100-SXM4-80GB,8,1,64,448,14046,80
54e21434-c160-40bf-bd24-6f9e7034eae5,long-context-upsample,1719413551,1719413968,finished,1719413593,1719413968,A100-SXM4-80GB,8,2,64,448,42,375
75b35479-fcfe-47de-945f-d17d38daa0a7,long-context-upsample,1719413968,1719414430,finished,1719414009,1719414430,A100-SXM4-80GB,8,2,64,448,41,421
0115a7e0-7513-4d91-8743-b526bb13d3a8,txchen-train-task,1719414381,1719438313,finished,1719416091,1719438313,A100-SXM4-80GB,8,1,64,448,1710,22222
dbaed0ce-fe41-4153-a472-01ed4c90439a,long-context-upsample,1719414430,1719415305,finished,1719414449,1719415305,A100-SXM4-80GB,8,1,64,448,19,856
a19d7544-7442-4a77-a36b-1101856192ec,cft-mt-lr1e-5-14b,1719414754,1719588048,finished,1719414775,1719588048,A100-SXM4-80GB,8,1,64,448,21,173273
09e73d00-dcae-4cde-94d2-05cd0c71eed1,geogpt-prompt-tuning-tg-infer1,1719414762,1719422421,finished,1719414782,1719422421,A100-SXM4-80GB,8,1,64,448,20,7639
0d5050e4-f4a7-4bd7-9c0c-de875896b6c3,long-context-upsample,1719415305,1719415780,finished,1719415325,1719415780,A100-SXM4-80GB,8,1,64,448,20,455
f982fbca-17c7-4632-9c00-cb44ddc84e3a,long-context-upsample,1719415780,1719416077,finished,1719415800,1719416077,A100-SXM4-80GB,8,1,64,448,20,277
49338531-1557-4c41-8589-37140eb3bfce,long-context-upsample,1719416077,1719416429,finished,1719416097,1719416429,A100-SXM4-80GB,8,1,64,448,20,332
7fd06006-4da8-4d71-92e4-62bcdfecf0ac,geogpt-dairui-eval-code,1719416828,1719438743,finished,1719430350,1719438743,A100-SXM4-80GB,8,1,64,896,13522,8393
13f5d3fc-8466-4c4f-9bdf-759992209983,qwen7b-scpt-lr-1e-4-e1-727b0-auto,1719418124,1719428914,finished,1719427469,1719428914,A100-SXM4-80GB,8,1,64,448,9345,1445
fcf06ddf-96be-4dc7-ae68-9d636964760d,qwen7b-scpt-lr-2e-4-e1-56cd8-auto,1719418184,1719437282,finished,1719435826,1719437282,A100-SXM4-80GB,8,1,64,448,17642,1456
b9625d7f-3b56-4b71-a766-7d0bc67082e2,qwen7b-scpt-lr-2e-5-e1-fc05c-auto,1719418265,1719436775,finished,1719435309,1719436775,A100-SXM4-80GB,8,1,64,448,17044,1466
0761c030-5b08-453d-952f-0ab5527a4d6f,qwen7b-scpt-lr-5e-5-e1-0f2b3-auto,1719418307,1719427351,finished,1719425865,1719427351,A100-SXM4-80GB,8,1,64,448,7558,1486
59e698f6-994c-4bd8-93e8-37d8e06083e2,qwen7b-scpt-lr-8e-5-e1-c0be5-auto,1719418329,1719491442,finished,1719427971,1719491442,A100-SXM4-80GB,8,1,64,448,9642,63471
1bca1d50-1760-401a-8577-dd68600e9c83,citysora-modelv4-cele-ppm-65-512,1719419163,1719818473,finished,1719419203,1719818473,A100-SXM4-80GB,8,5,64,896,40,399270
bb195b91-28f8-4bda-95e4-fa79d2776ae3,test-tq,1719420340,1720089205,finished,1719420361,1720089205,A100-SXM4-80GB,8,1,64,448,21,668844
25c20c8f-e3a7-496a-b06a-0c123f73d6d6,geogpt-lxz-cft-1-8m-subset-m1l3-2ep-72b,1719437400,1719442028,finished,1719437458,1719442028,A100-SXM4-80GB,8,32,64,448,58,4570
d4696010-0dae-4b64-819b-e1478b08f0b5,geogpt-lxz-cft-1-8m-subset-m1l3-2ep-72b,1719442088,1719443065,finished,1719442145,1719443065,A100-SXM4-80GB,8,32,64,448,57,920
72423555-1108-416e-b69b-7105b3584232,geogpt-lxz-cft-1-8m-subset-m1l3-2ep-72b,1719443124,1719444266,finished,1719443200,1719444266,A100-SXM4-80GB,8,32,64,448,76,1066
f6f4d448-fb57-4845-9ae1-0907848f832f,geogpt-lxz-cft-1-8m-subset-m1l3-2ep-72b,1719444324,1719445459,finished,1719444363,1719445459,A100-SXM4-80GB,8,32,64,448,39,1096
9522236b-492b-43b3-9e72-3cf3883f4d52,geogpt-lxz-cft-1-8m-subset-m1l3-2ep-72b,1719445518,1719446370,finished,1719445557,1719446370,A100-SXM4-80GB,8,32,64,448,39,813
d927d254-5463-4626-9558-bbf3bf8c6380,geogpt-lxz-cft-1-8m-subset-m1l3-2ep-72b,1719446431,1719447164,finished,1719446489,1719447164,A100-SXM4-80GB,8,32,64,448,58,675
07a2975b-db42-4e2b-a163-098473743361,geogpt-qwen2-72b-10-8bcpt2ep-sft,1719447167,1719470130,finished,1719447227,1719470130,A100-SXM4-80GB,8,40,64,448,60,22903
7df937aa-a678-4abd-abbc-3c0358f9a121,geogpt-lxz-cft-1-8m-subset-m1l3-2ep-72b,1719447224,1719447954,finished,1719447298,1719447954,A100-SXM4-80GB,8,32,64,448,74,656
f1a68b0e-906e-4a94-8b5c-1cc902e3b611,geogpt-lxz-cft-1-8m-subset-m1l3-2ep-72b,1719448011,1719448744,finished,1719448050,1719448744,A100-SXM4-80GB,8,32,64,448,39,694
0536bf96-21aa-4f56-8ff4-403ed6f04ebc,geogpt-lxz-cft-1-8m-subset-m1l3-2ep-72b,1719448803,1719449747,finished,1719448878,1719449747,A100-SXM4-80GB,8,32,64,448,75,869
994b1694-cbfc-4c77-9909-db3038680a89,long-context-upsample,1719449713,1719449837,finished,1719449741,1719449837,A100-SXM4-80GB,8,1,64,448,28,96
40865e70-540e-401a-aa31-65c83098d699,geogpt-lxz-cft-1-8m-subset-m1l3-2ep-72b,1719449804,1719450521,finished,1719449862,1719450521,A100-SXM4-80GB,8,32,64,448,58,659
e9556782-f260-4aec-83ac-0bfb3a754d3e,llama-multi,1719450516,1719451345,finished,1719450595,1719451345,A100-SXM4-80GB,8,2,64,896,79,750
d6bf3065-ea74-4d40-93cc-237a23a60ad9,geogpt-lxz-cft-1-8m-subset-m1l3-2ep-72b,1719450579,1719451470,finished,1719450619,1719451470,A100-SXM4-80GB,8,32,64,448,40,851
65bf36da-982f-4144-9533-52fa6ef92280,llama3-70b-base-extra-128k-defc3-auto,1719450888,1719487239,finished,1719450909,1719487239,A100-SXM4-80GB,8,1,64,896,21,36330
3152152d-4691-4957-b122-0eda3eec4db2,geogpt-lxz-cft-1-8m-subset-m1l3-2ep-72b,1719451529,1719452228,finished,1719451567,1719452228,A100-SXM4-80GB,8,32,64,448,38,661
df916fec-3f74-4b9d-abd4-3cd381dcab3f,long-context-upsample,1719452262,1719452374,finished,1719452282,1719452374,A100-SXM4-80GB,8,1,64,448,20,92
94a78d47-3c22-4bab-9615-e25dc8da5b6f,geogpt-lxz-cft-1-8m-subset-m1l3-2ep-72b,1719452289,1719453006,finished,1719452329,1719453006,A100-SXM4-80GB,8,32,64,448,40,677
6005ef19-e5d6-426a-80b9-4ea99abdf592,sfr-embedding-test,1719452583,1719452797,finished,1719452604,1719452797,A100-SXM4-80GB,8,1,64,448,21,193
0d7ff51a-334a-48da-978d-918a0068aa5d,ls2,1719452584,1719459876,finished,1719452605,1719459876,A100-SXM4-80GB,8,1,64,896,21,7271
6faaec4b-956c-417b-a3e9-17b84eaef6b6,llama3-70b-10bcpt-sft-78389-auto,1719452613,1719453242,finished,1719452634,1719453242,A100-SXM4-80GB,8,1,64,448,21,608
70eb33ab-2241-4b21-a594-34d6fa801903,sfr-embedding-test,1719452797,1719539364,finished,1719452818,1719539364,A100-SXM4-80GB,8,1,64,448,21,86546
9f08f773-419a-4d1c-abb8-548d7b21878c,long-context-upsample,1719452798,1719452956,finished,1719452819,1719452956,A100-SXM4-80GB,8,1,64,448,21,137
01e1b486-72e9-4526-ad4e-6ecbd028ae07,load-easycontext-ckpt,1719452917,1719453175,finished,1719452936,1719453175,A100-SXM4-80GB,8,1,64,448,19,239
9f161ac3-6058-4bf5-a201-c7472d8594bd,geogpt-lxz-cft-1-8m-subset-m1l3-2ep-72b,1719453067,1719453751,finished,1719453105,1719453751,A100-SXM4-80GB,8,32,64,448,38,646
8d04ff80-fce2-4e4e-aa5c-f50ea658bb98,long-context-upsample,1719453154,1719453292,finished,1719453175,1719453292,A100-SXM4-80GB,8,1,64,448,21,117
d59baf9a-65a0-4364-9c0a-53f9f55b71d9,llama3-70b-10bcpt-sft-0de3d-auto,1719453262,1719455579,finished,1719453281,1719455579,A100-SXM4-80GB,8,1,64,448,19,2298
1f08b496-87c5-4796-9e34-4ebb7ddc515b,gpt-megatron,1719453310,1719455609,finished,1719453350,1719455609,A100-SXM4-80GB,8,16,64,448,40,2259
d5593a37-a49d-4e69-8d77-f9c9b386bed1,llama3-70b-instruct-extra-128k-76c34-auto,1719453357,1719454198,finished,1719453380,1719454198,A100-SXM4-80GB,8,1,64,896,23,818
1238971a-3a19-4e7e-b6b8-b63b6f1ffddf,geogpt-0617-9d718-auto,1719453396,1719465883,finished,1719453416,1719465883,A100-SXM4-80GB,8,1,64,448,20,12467
9ae86f9c-cf2e-47ab-8102-e13ae3f24698,geogpt-table-qwen2-72b-datav050,1719453566,1719453786,finished,1719453625,1719453786,A100-SXM4-80GB,8,4,64,896,59,161
a6433fd6-ceab-47b5-9af4-c89e4ce8e761,geogpt-lxz-cft-1-8m-subset-m1l3-2ep-72b,1719453810,1719454709,finished,1719453874,1719454709,A100-SXM4-80GB,8,32,64,448,64,835
8cd04df0-60d8-4ef0-a0ee-024e802ec409,llama3-sft,1719453813,1719567562,finished,1719453835,1719567562,A100-SXM4-80GB,8,1,64,448,22,113727
84827883-41d3-4f82-bbed-167314dcef64,long-context-upsample,1719453867,1719454006,finished,1719453902,1719454006,A100-SXM4-80GB,8,1,64,448,35,104
e9abac98-43c0-4c6f-9680-eddfdf28ff4c,geogpt-table-qwen2-72b-datav050,1719453929,1719557698,finished,1719453989,1719557698,A100-SXM4-80GB,8,4,64,896,60,103709
67c2d1cf-2021-49d7-a79d-be4972d3bb60,llama3-70b-instruct-extra-128k-1e5cd-auto,1719454218,1719490352,finished,1719454240,1719490352,A100-SXM4-80GB,8,1,64,896,22,36112
8b5c3802-2c7b-4d96-b790-bc851364a6b8,long-context-upsample,1719454338,1719454520,finished,1719454378,1719454520,A100-SXM4-80GB,8,2,64,448,40,142
cf4b2746-0b81-41df-9036-7c8ee3dde999,geo-seesaw-sft-balance-merge-7b,1719454442,1719521271,finished,1719454464,1719521271,A100-SXM4-80GB,8,1,64,896,22,66807
152631ff-21a9-4e7d-8335-cd089e6c1fd3,qwen2-72b-instruct-32f9b-auto,1719454457,1719466815,finished,1719454477,1719466815,A100-SXM4-80GB,8,4,64,896,20,12338
d58e1f25-d7d4-4445-b38a-6a73ca3b0df3,intent-test-llm-all,1719454619,1719454724,finished,1719454638,1719454724,A100-SXM4-80GB,8,1,64,448,19,86
3cebb3ec-76b2-4093-b928-f3a0652e43e7,geogpt-lxz-cft-1-8m-subset-m1l3-2ep-72b,1719454768,1719455492,finished,1719454828,1719455492,A100-SXM4-80GB,8,32,64,448,60,664
801c89c9-883e-4cb2-b9f8-ccf121fbbe43,citysora-profile,1719455033,1719455384,finished,1719455114,1719455384,A100-SXM4-80GB,8,4,64,896,81,270
8c3dd492-e8e0-49b9-8d35-1c5566cb29c1,intent-test-llm-all,1719455091,1719455305,finished,1719455111,1719455305,A100-SXM4-80GB,8,1,64,448,20,194
5dab765b-c5e6-41d3-b611-6c144dac0644,citysora-profile,1719455489,1719455870,finished,1719455553,1719455870,A100-SXM4-80GB,8,4,64,896,64,317
ac9d2066-baee-4acf-ac1a-3f052ee1ce11,llama3-10bcpt-sft2ep-b345d-auto,1719455515,1719469834,finished,1719455537,1719469834,A100-SXM4-80GB,8,1,64,448,22,14297
4e4a9591-c115-4ba0-801f-9a63e6ac6811,geogpt-lxz-cft-1-8m-subset-m1l3-2ep-72b,1719455556,1719456469,finished,1719455618,1719456469,A100-SXM4-80GB,8,32,64,448,62,851
d12795fa-94c1-491a-be67-f7fd03476a78,long-context-upsample,1719455647,1719455866,finished,1719455728,1719455866,A100-SXM4-80GB,8,2,64,448,81,138
3d9e67ad-afb8-4fe3-b8dc-870ed4d25362,paly-qwen2-7b-sft,1719455676,1719456955,finished,1719455698,1719456955,A100-SXM4-80GB,8,1,64,896,22,1257
a028668d-8d40-4e30-b15f-ed39efb06b24,geogpt-moe-alpaca-sft,1719455685,1719455943,finished,1719455746,1719455943,A100-SXM4-80GB,8,2,64,448,61,197
1dfabf38-ce2d-412e-8ac2-cb4f21af907a,geogpt-moe-alpaca-sft,1719455746,1719456139,finished,1719455983,1719456139,A100-SXM4-80GB,8,2,64,448,237,156
78c30e2d-23ec-4f18-8618-f9c516104d49,qwen2-72b-llamapro84-init-0b5bb-auto,1719455817,1719480690,finished,1719455836,1719480690,A100-SXM4-80GB,8,1,64,448,19,24854
10ee34be-8b2d-4b32-ba06-b73aae0e6ee9,citysora-profile,1719455929,1719456262,finished,1719456007,1719456262,A100-SXM4-80GB,8,4,64,896,78,255
c1a688b8-8baa-45bf-9025-ef58cb4ed557,intent-test-llm-all,1719456084,1719456699,finished,1719456105,1719456699,A100-SXM4-80GB,8,1,64,448,21,594
3edd723c-6180-485d-92ed-c0078cfea031,long-context-upsample,1719456166,1719456584,finished,1719456232,1719456584,A100-SXM4-80GB,8,2,64,448,66,352
8ed72f6c-3852-48a6-aee5-f9317e2019ad,gpt-megatron,1719456185,1719458438,finished,1719456225,1719458438,A100-SXM4-80GB,8,16,64,448,40,2213
377e989c-0372-44ef-a940-30ac6334047e,citysora-modelv4-webvid-humanface-65-128,1719456343,1719479465,finished,1719456382,1719479465,A100-SXM4-80GB,8,4,64,896,39,23083
cd94802d-232f-4a51-9b1d-64f79310b776,geogpt-lxz-cft-1-8m-subset-m1l3-2ep-72b,1719456529,1719502635,finished,1719456590,1719502635,A100-SXM4-80GB,8,32,64,448,61,46045
2dc9075c-4853-45df-a680-954b3d57e65f,txchen-eval,1719457037,1719463784,finished,1719457060,1719463784,A100-SXM4-80GB,8,1,64,448,23,6724
5da2a6ee-f2a6-461e-b47d-6276606466fc,long-context-upsample,1719457046,1719457818,finished,1719457108,1719457818,A100-SXM4-80GB,8,2,64,448,62,710
01c8ad38-600e-4087-8277-5870109781d2,intent-test-llm-all,1719457089,1719457304,finished,1719457109,1719457304,A100-SXM4-80GB,8,1,64,448,20,195
113de360-c31f-4ff7-980d-eab193c16bca,qwen7b-sft-syn-it-lr-1e-5-e2-eeade-auto,1719457469,1719459170,finished,1719457490,1719459170,A100-SXM4-80GB,8,1,64,448,21,1680
c5f30f64-030e-4597-92d4-575aaaedbe98,qwen7b-sft-syn-it-lr-1e-5-e1-4a96c-auto,1719457470,1719459170,finished,1719457490,1719459170,A100-SXM4-80GB,8,1,64,448,20,1680
8c12d5ae-c667-4a70-9599-de6776f02643,intent-test-llm-all,1719457520,1719458283,finished,1719457543,1719458283,A100-SXM4-80GB,8,1,64,448,23,740
78e102fe-ce73-407d-b934-bcb66583d93e,geogpt-moe-alpaca-sft,1719457537,1719457776,finished,1719457580,1719457776,A100-SXM4-80GB,8,2,64,448,43,196
0ebc11c2-2a96-47e1-b549-14b4ed9c44bd,txchen-lm-eval2,1719457674,1719465438,finished,1719457694,1719465438,A100-SXM4-80GB,8,1,64,448,20,7744
1488748e-a09b-4d0d-a09e-ebbe92770021,qwen-72b-test,1719457801,1719490515,finished,1719457821,1719490515,A100-SXM4-80GB,8,1,64,448,20,32694
3e5884bc-9cff-4ba5-b89f-997e94c99892,geo-llamapro-5-behind,1719457881,1719458098,finished,1719457919,1719458098,A100-SXM4-80GB,8,4,64,448,38,179
3d00c276-c855-45c9-997b-a211bda34814,llama-multi,1719458093,1719474869,finished,1719458154,1719474869,A100-SXM4-80GB,8,2,64,448,61,16715
b61250a7-5845-4331-a493-52de5bddaf54,geo-base-offline-eval,1719458158,1719458484,finished,1719458180,1719458484,A100-SXM4-80GB,8,1,64,448,22,304
03c7439b-e2ad-4feb-80d4-a651e61c6b6d,geo-router-block-weight-reserved,1719458181,1719523456,finished,1719458246,1719523456,A100-SXM4-80GB,8,2,64,448,65,65210
2a85b61e-2d83-43fb-a71d-c6d0de20befd,fusion-tqgw-cli-f5468-auto,1719458205,1719459085,finished,1719458227,1719459085,A100-SXM4-80GB,8,1,64,448,22,858
73667ff8-0256-4fc0-9445-c55b7242d768,intent-test-llm-all,1719458461,1719459220,finished,1719458481,1719459220,A100-SXM4-80GB,8,1,64,448,20,739
18d45fa7-bc8b-4f3e-8fcc-2eab814ce65b,geo-llamapro-5-behind,1719458629,1719475944,finished,1719458688,1719475944,A100-SXM4-80GB,8,4,64,448,59,17256
50ec7426-623e-479b-94bb-236515742ad8,qwen1-5-7b-chat-91fe3-auto,1719458715,1719460350,finished,1719458735,1719460350,A100-SXM4-80GB,8,1,64,448,20,1615
156b1ec0-c60b-4ae0-8159-a0e76bdefde7,gpt-megatron,1719458870,1719520579,finished,1719458930,1719520579,A100-SXM4-80GB,8,16,64,448,60,61649
af1038db-cb1e-4cb2-8548-76d9163eb3e5,qwen1-5-72b-base,1719459190,1719459772,finished,1719459212,1719459772,A100-SXM4-80GB,8,1,64,448,22,560
c5ce6353-1b01-434e-bd95-564803141a91,geogpt-btx-2x14b-sf4,1719459246,1719459595,finished,1719459326,1719459595,A100-SXM4-80GB,8,16,64,896,80,269
458073aa-f13d-4169-8d22-175ac8d41f49,load-easycontext-ckpt,1719459387,1719459469,finished,1719459407,1719459469,A100-SXM4-80GB,8,1,64,448,20,62
1a79e5b7-ba66-4192-a15b-60de3552376c,geo-base-offline-eval,1719459431,1719462829,finished,1719459451,1719462829,A100-SXM4-80GB,8,1,64,448,20,3378
77d642dc-eea3-4899-8d5a-6ee5965f4971,load-easycontext-ckpt,1719459589,1719459674,finished,1719459609,1719459674,A100-SXM4-80GB,8,1,64,448,20,65
5aab7291-af92-4355-8ca4-527787f77a45,geogpt-btx-2x14b-sf4,1719459659,1719459942,finished,1719459700,1719459942,A100-SXM4-80GB,8,16,64,896,41,242
f7ae3db6-3336-454a-85e4-704fc8e38bed,qwen1-5-7b-chat-63643-auto,1719459904,1719469813,finished,1719459925,1719469813,A100-SXM4-80GB,8,1,64,448,21,9888
3af6acd8-902c-4a62-b5b0-941a3e4161fe,qwen2-72b-instruct-judge,1719459948,1719589139,finished,1719459967,1719589139,A100-SXM4-40GB,8,1,32,320,19,129172
fa37e975-d5b7-4ea5-b8df-3521c2046e59,geogpt-btx-2x14b-sf4,1719460005,1719460328,finished,1719460066,1719460328,A100-SXM4-80GB,8,16,64,896,61,262
f7011635-9cf3-4e9b-9007-9a5e18e0096f,load-easycontext-ckpt,1719460167,1719460245,finished,1719460187,1719460245,A100-SXM4-80GB,8,1,64,448,20,58
fdd42923-d2e1-4620-8410-30a3a71565ae,data-gen-magpie,1719460372,1719460882,finished,1719460391,1719460882,A100-SXM4-80GB,8,1,64,448,19,491
b08142c2-72e4-4ca1-9e35-2c53202e73bb,geogpt-btx-2x14b-sf4,1719460391,1719460730,finished,1719460453,1719460730,A100-SXM4-80GB,8,16,64,896,62,277
7794ef56-fdde-47ca-b28d-130b2f5e6a6e,load-easycontext-ckpt,1719460447,1719460529,finished,1719460472,1719460529,A100-SXM4-80GB,8,1,64,448,25,57
51afdc89-0601-43bf-8374-2942b15bdda4,load-easycontext-ckpt,1719460703,1719460831,finished,1719460724,1719460831,A100-SXM4-80GB,8,1,64,448,21,107
7a1dea01-1748-4ac9-ab67-16036a4a7980,geo-router-block-softmax-reserved-tag-1,1719460728,1719597932,finished,1719460816,1719597932,A100-SXM4-80GB,8,2,64,448,88,137116
3e788505-4a22-425a-93d2-4732af7c851e,lzk-qwen15-7b-scpt-8e-5-sci-abs-qa-sft,1719460781,1719493496,finished,1719463803,1719493496,A100-SXM4-80GB,8,1,64,448,3022,29693
fa7636d2-6f16-4021-9baa-2f91c7ea08a7,geogpt-btx-2x14b-sf4,1719460794,1719461099,finished,1719460856,1719461099,A100-SXM4-80GB,8,16,64,896,62,243
d86b515c-bf4c-4295-99df-75ac8813eb1f,lzk-qwen15-7b-scpt-2e-5-sci-abs-qa-sft,1719460801,1719493534,finished,1719476230,1719493534,A100-SXM4-80GB,8,1,64,448,15429,17304
cecdffcd-5e74-4094-867d-f11824c4b481,txchen-train-task2,1719461085,1719486490,finished,1719465456,1719486490,A100-SXM4-80GB,8,1,64,448,4371,21034
2ddabaaf-681b-43c3-bce2-d7dc09627fb3,load-easycontext-ckpt,1719461092,1719461176,finished,1719461112,1719461176,A100-SXM4-80GB,8,1,64,448,20,64
af4d41a6-beba-489f-8fb1-207e21727849,geogpt-btx-2x14b-sf4,1719461162,1719461440,finished,1719461201,1719461440,A100-SXM4-80GB,8,16,64,896,39,239
e85b4acc-8bae-45f4-b7c5-071f2fab7a51,data-gen-magpie,1719461323,1719462461,finished,1719461343,1719462461,A100-SXM4-80GB,8,1,64,448,20,1118
4bd74f55-4426-4e2d-8fc5-df443d61e821,geogpt-gate-chat-eval,1719461463,1719461571,finished,1719461487,1719461571,A100-SXM4-80GB,8,1,64,448,24,84
7d4b01dd-e754-471c-9ec1-71c8758035c2,geogpt-btx-2x14b-sf4,1719461503,1719461776,finished,1719461543,1719461776,A100-SXM4-80GB,8,16,64,896,40,233
f427820a-0252-466f-b08c-139161b72e80,geogpt-btx-2x14b-sf4,1719461841,1719462155,finished,1719461919,1719462155,A100-SXM4-80GB,8,16,64,896,78,236
da1a6708-7e88-414f-97a2-491a44763746,geogpt-btx-2x14b-sf4,1719462221,1719462634,finished,1719462280,1719462634,A100-SXM4-80GB,8,16,64,896,59,354
3ae6ce71-61ee-4c07-8391-66f42263f340,geogpt-gate-chat-eval,1719462223,1719560900,finished,1719462242,1719560900,A100-SXM4-80GB,8,1,64,448,19,98658
ba607c5c-50d6-4aaf-8755-94cefef95ddb,geogept-gate-chat-eval-geo,1719462243,1719463909,finished,1719462263,1719463909,A100-SXM4-80GB,8,1,64,448,20,1646
1f5dd7e1-4a18-4571-9fe2-88686276ef98,commonbench-chat-vllm,1719462486,1719463592,finished,1719462622,1719463592,A100-SXM4-80GB,8,1,64,448,136,970
060fa0ec-af34-497c-8986-81d17633f555,geogpt-btx-2x14b-sf4,1719462697,1719463066,finished,1719462851,1719463066,A100-SXM4-80GB,8,16,64,896,154,215
335d93fa-c606-41fe-97ba-dacff992e1f9,geogpt-btx-2x14b-sf4,1719463129,1719463421,finished,1719463187,1719463421,A100-SXM4-80GB,8,16,64,896,58,234
7d21f685-58cd-4589-b5c6-9ee3871f15c4,geogpt-btx-2x14b-sf4,1719463484,1719463778,finished,1719463542,1719463778,A100-SXM4-80GB,8,16,64,896,58,236
edf28084-1cc6-4f09-a317-c6235dd95466,geogpt-btx-2x14b-sf4,1719463841,1719464134,finished,1719463900,1719464134,A100-SXM4-80GB,8,16,64,896,59,234
80ed5c6b-9e0b-4ae8-af23-3af23316209d,geogpt-btx-2x14b-sf4,1719464195,1719464505,finished,1719464271,1719464505,A100-SXM4-80GB,8,16,64,896,76,234
8fc67461-d020-4a6f-8347-985f4005ba6d,geogpt-btx-2x14b-sf4,1719464565,1719464840,finished,1719464622,1719464840,A100-SXM4-80GB,8,16,64,896,57,218
00808163-e092-4ea0-a63e-d0417479923f,commonbench-chat-vllm,1719464788,1719465792,finished,1719464807,1719465792,A100-SXM4-80GB,8,1,64,448,19,985
0443ef23-7c84-4c97-baab-d4e7724e7fcf,geogpt-btx-2x14b-sf4,1719464902,1719465192,finished,1719464960,1719465192,A100-SXM4-80GB,8,16,64,896,58,232
5ac94c0b-3e80-41c5-ad12-8fc9f976d118,load-easycontext-ckpt,1719465206,1719465325,finished,1719465225,1719465325,A100-SXM4-80GB,8,1,64,448,19,100
ed6cf2cb-ce26-46bd-ab7f-b67495022bba,geogpt-btx-2x14b-sf4,1719465255,1719465565,finished,1719465331,1719465565,A100-SXM4-80GB,8,16,64,896,76,234
3d477840-156f-4c48-b44e-8e91935bf1af,geogpt-btx-2x14b-sf4,1719465627,1719465918,finished,1719465685,1719465918,A100-SXM4-80GB,8,16,64,896,58,233
ad4fcd94-83c7-4168-abf8-8333d41bfcbd,geogpt-btx-2x14b-sf4,1719465979,1719466271,finished,1719466037,1719466271,A100-SXM4-80GB,8,16,64,896,58,234
5bd2e331-6799-4009-837c-bdf101b8bbb9,txchen-train-task,1719466164,1719493112,finished,1719475833,1719493112,A100-SXM4-80GB,8,1,64,448,9669,17279
08fa8b77-b20d-44c6-881b-864f17d4e211,geogpt-btx-2x14b-sf4,1719466330,1719466603,finished,1719466369,1719466603,A100-SXM4-80GB,8,16,64,896,39,234
225c1c09-5547-4264-a3fd-83ccb4e94ea7,long-context-upsample,1719466482,1719466761,finished,1719466501,1719466761,A100-SXM4-80GB,8,1,64,448,19,260
dace941d-df41-447b-ae3d-d304e5589dda,geogpt-btx-2x14b-sf4,1719466664,1719466955,finished,1719466720,1719466955,A100-SXM4-80GB,8,16,64,896,56,235
2e31e4b6-4983-40d1-8c4a-2f77f4690403,long-context-upsample,1719466761,1719466969,finished,1719466781,1719466969,A100-SXM4-80GB,8,1,64,448,20,188
6c790bf3-c9b9-4308-9a0f-dbd50e9e2232,geogpt-btx-2x14b-sf4,1719467015,1719467320,finished,1719467094,1719467320,A100-SXM4-80GB,8,16,64,896,79,226
5c925911-23ad-49ff-bd69-541914824783,qwen2-72b-instruct-e7797-auto,1719467065,1719547310,finished,1719467086,1719547310,A100-SXM4-80GB,8,4,64,896,21,80224
fe7e18dc-966f-4fb3-90e2-16de9fede27d,geogpt-moe-alpaca-sft,1719467130,1719467376,finished,1719467171,1719467376,A100-SXM4-80GB,8,2,64,448,41,205
51a434c4-e47d-44de-bc46-b1145cb8993b,qwen2-72b-base-ff8a8-auto,1719467172,1719547310,finished,1719467192,1719547310,A100-SXM4-80GB,8,4,64,896,20,80118
f5fc02d7-8aaf-4411-bc6f-361d56dc7742,commonbench-chat-vllm,1719467247,1719468219,finished,1719467305,1719468219,A100-SXM4-80GB,8,1,64,448,58,914
434cb1e7-0f9c-4e6c-a43b-8b5cee9d0d21,llm-fintune,1719467253,1719467745,finished,1719467312,1719467745,A100-SXM4-80GB,8,1,64,448,59,433
7c10bb07-ee4d-410f-b4a7-29598750bbb7,geogpt-btx-2x14b-sf4,1719467383,1719468427,finished,1719467727,1719468427,A100-SXM4-80GB,8,16,64,896,344,700
30b25db5-23f5-4d18-870f-c3cf06fa725d,geogept-gate-chat-eval-geo,1719467669,1719468271,finished,1719467689,1719468271,A100-SXM4-80GB,8,1,64,448,20,582
c9882384-91a2-4c74-bb9d-b24031eeee18,qwen2-72b-10cpt2ep-sft1ep-268c5-auto,1719467914,1719480549,finished,1719468409,1719480549,A100-SXM4-80GB,8,1,64,448,495,12140
b96e7d1c-8d19-42d4-b0a5-de318722bef2,Qwen1-5-72B-2-4-0-40ab8-auto,1719468060,1719472779,finished,1719468295,1719472779,A100-SXM4-80GB,8,1,64,448,235,4484
54b0992e-6435-4bfd-8134-53ff9fa64cf8,long-context-upsample,1719468069,1719468459,finished,1719468283,1719468459,A100-SXM4-80GB,8,1,64,448,214,176
01981498-a8e9-40a8-b180-a5bd9eb4eebd,geogpt-moe-alpaca-sft,1719468339,1719468985,finished,1719468439,1719468985,A100-SXM4-80GB,8,2,64,448,100,546
427ab939-907d-46ff-adfb-7ed2fcac9ff5,commonbench-chat-vllm,1719468413,1719469294,finished,1719468432,1719469294,A100-SXM4-80GB,8,1,64,448,19,862
1c9de2a2-ac26-4141-a858-44428a62cfaf,Qwen-72B,1719468476,1719501208,finished,1719468499,1719501208,A100-SXM4-80GB,8,1,64,448,23,32709
9b566cfc-3b6f-4751-88ca-7600d2b2477c,reranker-inference,1719468485,1719538892,finished,1719468506,1719538892,A100-SXM4-80GB,8,1,64,448,21,70386
a88ed9f6-f5c2-475e-a6f2-b6e915200e5d,geogpt-btx-2x14b-sf4,1719468493,1719470463,finished,1719470145,1719470463,A100-SXM4-80GB,8,16,64,896,1652,318
68863a03-98b3-41fb-abd6-81d8f28c025c,llama3-10bcpt-sft2ep-eac31-auto,1719468573,1719473126,finished,1719468592,1719473126,A100-SXM4-80GB,8,1,64,448,19,4534
7a11fa74-0813-4fe7-95a1-018cba608d2a,long-context-upsample,1719468660,1719468794,finished,1719468680,1719468794,A100-SXM4-80GB,8,1,64,448,20,114
5cd189d1-ae3a-4293-970c-19c68f93dcb0,long-context-upsample,1719468870,1719469007,finished,1719468888,1719469007,A100-SXM4-80GB,8,1,64,448,18,119
1afc971c-d5fd-4993-bc93-98436b7e2b0f,qwen2-72b-chat-sft-dpo,1719468898,1719555789,finished,1719468918,1719555789,A100-SXM4-80GB,8,1,64,448,20,86871
4246fee6-1076-43d5-9ad2-db51f3bdd8f3,reranker-hn,1719469006,1719470955,finished,1719469026,1719470955,A100-SXM4-80GB,8,1,64,448,20,1929
9aef3fba-8ed1-4ef1-9bcd-42b662640d83,qwen1-5-7b-llamapro40-s2-sft-31f22-auto,1719469290,1719480549,finished,1719469312,1719480549,A100-SXM4-80GB,8,1,64,448,22,11237
10226cd0-4c82-4bed-bb64-ae1ccef0cca6,long-context-upsample,1719469324,1719469441,finished,1719469344,1719469441,A100-SXM4-80GB,8,1,64,448,20,97
05065356-8d86-4cac-901c-e20c1b0997da,long-context-upsample,1719469845,1719469988,finished,1719469864,1719469988,A100-SXM4-80GB,8,1,64,448,19,124
560a28ec-79c5-4ad9-9b37-0d4a5b8579ab,commonbench-chat-vllm,1719469917,1719470811,finished,1719469939,1719470811,A100-SXM4-80GB,8,1,64,448,22,872
50e04280-bfc3-4475-b793-129d8c0e0f60,long-context-upsample,1719470100,1719470372,finished,1719470121,1719470372,A100-SXM4-80GB,8,1,64,448,21,251
b9b3e4d8-c27e-467b-a888-559ec2686916,geogpt-qwen2-72b-10-8bcpt2ep-sft,1719470130,1719473826,finished,1719470193,1719473826,A100-SXM4-80GB,8,40,64,448,63,3633
76a86020-5792-4770-a50b-c062ed2ac02f,geogpt-mixtral-test,1719470524,1719470724,finished,1719470568,1719470724,A100-SXM4-80GB,8,4,64,896,44,156
5c4757eb-0e53-4d88-b8eb-2b48e447ccbd,long-context-upsample,1719470561,1719470934,finished,1719470582,1719470934,A100-SXM4-80GB,8,1,64,448,21,352
68bbf1dc-107a-438e-949f-3fca177c7fa8,geogpt-mixtral-test,1719470764,1719474334,finished,1719470804,1719474334,A100-SXM4-80GB,8,4,64,896,40,3530
fb47d965-cfb1-4dbb-8544-7c9d11706acf,load-easycontext-ckpt-8b,1719470934,1719471172,finished,1719470956,1719471172,A100-SXM4-80GB,8,1,64,448,22,216
1457acd2-e302-490f-80b4-1b8e41ae1136,commonbench-chat-vllm,1719471125,1719475872,finished,1719471145,1719475872,A100-SXM4-80GB,8,1,64,448,20,4727
bbc50cbe-4c60-46a4-a551-bc936b4cbf9e,sfr-eval-mteb,1719471572,1719471862,finished,1719471592,1719471862,A100-SXM4-80GB,8,1,64,448,20,270
49bf3ccc-bc9d-463d-8769-3d0a040fe1c7,sfr-eval-mteb,1719471862,1719472394,finished,1719471881,1719472394,A100-SXM4-80GB,8,1,64,448,19,513
fe0eae4d-a389-4cff-814a-a81bf6e067ac,data-gen-magpie,1719472692,1719475946,finished,1719472714,1719475946,A100-SXM4-80GB,8,1,64,448,22,3232
5cac6182-9584-41a8-95b5-263b12fe3fcb,reranker-inference11,1719472706,1719538932,finished,1719472727,1719538932,A100-SXM4-80GB,8,1,64,448,21,66205
b9fab844-b653-461b-bf70-c37b5a4c0dfe,sfr-eval-mteb,1719472727,1719473159,finished,1719472747,1719473159,A100-SXM4-80GB,8,1,64,448,20,412
682a7977-6919-4c25-b7b8-3a5c48285fb8,geogpt-q72b-chat-0612dpo-dare-ties-p97-7a733-auto,1719473024,1719482690,finished,1719473043,1719482690,A100-SXM4-80GB,8,1,64,448,19,9647
e37fb6a0-6447-41d7-b90a-d8c69a4675dd,long-context-upsample,1719473037,1719473140,finished,1719473058,1719473140,A100-SXM4-80GB,8,1,64,448,21,82
283ed9e2-5f5f-4215-bacf-f1db9235426b,reranker-base,1719473056,1719538833,finished,1719473079,1719538833,A100-SXM4-80GB,8,1,64,896,23,65754
88272233-bfad-4890-8252-d4f9823cf77f,geogpt-q72b-chat-0612dpo-dare-ties-p17-8175a-auto,1719473066,1719482667,finished,1719473086,1719482667,A100-SXM4-80GB,8,1,64,448,20,9581
d1939ac9-0439-4978-a60f-73eb34b15198,rag-tq-embedding-mistral,1719473138,1719646194,finished,1719473158,1719646194,A100-SXM4-80GB,8,1,64,448,20,173036
879560d7-8c68-45d9-ad71-2e2c3a8b0c68,long-context-upsample,1719473392,1719473511,finished,1719473412,1719473511,A100-SXM4-80GB,8,1,64,448,20,99
c1369a25-9814-47b8-a74d-5977aebd3b54,sfr-eval-mteb,1719473628,1719473980,finished,1719473648,1719473980,A100-SXM4-80GB,8,1,64,448,20,332
3562fa21-cec2-44ef-a150-ee365756afe9,ls2,1719473788,1719481143,finished,1719473817,1719481143,A100-SXM4-80GB,8,1,64,896,29,7326
f4b44f9b-ef41-41cd-9354-8c64038d6bbd,geogpt-qwen2-72b-10-8bcpt2ep-sft,1719473826,1719629911,finished,1719473888,1719629911,A100-SXM4-80GB,8,40,64,448,62,156023
736007d1-da00-4c13-99d6-e90cd9018d8a,geogpt-q72b-chat-0612dpo-dare-ties-p17-57330-auto,1719473885,1719473967,finished,1719473922,1719473967,A100-SXM4-80GB,8,1,64,448,37,45
d23089fe-3d97-4d34-b601-9049b11bb041,geogpt-q72b-chat-0612dpo-dare-ties-p99-c1344-auto,1719473944,1719482668,finished,1719473968,1719482668,A100-SXM4-80GB,8,1,64,448,24,8700
e90c8f9b-0b43-475b-b2d2-7dd3a959ea87,geogpt-q72b-chat-0612dpo-dare-ties-p95-2963d-auto,1719473945,1719482668,finished,1719473968,1719482668,A100-SXM4-80GB,8,1,64,448,23,8700
08c595b1-6a11-499f-b604-38cc41ba561e,test,1719474060,1719474647,finished,1719474083,1719474647,A100-SXM4-80GB,8,1,64,896,23,564
b2a9748d-f87d-4f2c-bcd6-11a59ab6a10e,geo-llamapro-1-8B,1719474070,1719476201,finished,1719476002,1719476201,A100-SXM4-80GB,8,4,64,448,1932,199
ec6b9e15-49fd-4e0d-86ce-6ef366b05067,long-context-upsample,1719474107,1719475523,finished,1719474128,1719475523,A100-SXM4-80GB,8,1,64,448,21,1395
2bfc1f3f-83f8-4fd6-9af8-f56a08098745,txchen-eval,1719474319,1719554919,finished,1719475414,1719554919,A100-SXM4-80GB,8,1,64,448,1095,79505
144e762f-f854-4619-9124-66a933f9880e,geogpt-mixtral-test,1719474334,1719475745,finished,1719474392,1719475745,A100-SXM4-80GB,8,4,64,896,58,1353
9dbcdc73-4273-4ca1-b2b9-f4c05dde49f6,geogpt-q72b-chat-0612dpo-dare-ties-p95-1ed2c-auto,1719474609,1719482669,finished,1719474634,1719482669,A100-SXM4-80GB,8,1,64,448,25,8035
7820079b-6693-496e-84c0-a46ebab66e50,geogpt-q72b-chat-0612dpo-dare-ties-p99-bcb56-auto,1719474611,1719482669,finished,1719474634,1719482669,A100-SXM4-80GB,8,1,64,448,23,8035
b6790044-d27c-4b36-bb67-b0e4f8f3e0fe,geogpt-q72b-chat-0612dpo-dare-ties-p97-71239-auto,1719474614,1719482670,finished,1719474634,1719482670,A100-SXM4-80GB,8,1,64,448,20,8036
9f2e39e8-de39-44e3-be69-3819263699ac,geogpt-q72b-chat-0612dpo-dare-ties-p17-d1cfc-auto,1719474635,1719482670,finished,1719474655,1719482670,A100-SXM4-80GB,8,1,64,448,20,8015
3ea47277-0fd2-413f-9ad2-86cf65ff0cc9,test,1719474767,1719475005,finished,1719474787,1719475005,A100-SXM4-80GB,8,1,64,896,20,218
b3aea71b-033a-4840-bd85-d04521ad826d,llama-multi,1719474966,1719479936,finished,1719475007,1719479936,A100-SXM4-80GB,8,2,64,448,41,4929
a0208294-7aa7-4786-b2ce-b93552204c17,geogpt-moe-alpaca-sft,1719475023,1719476035,finished,1719475065,1719476035,A100-SXM4-80GB,8,2,64,448,42,970
82ff377b-c4b0-4fab-89b7-dfeb77de0743,test,1719475224,1719476970,finished,1719475244,1719476970,A100-SXM4-80GB,8,1,64,896,20,1726
5a0f3e74-db97-44ff-b51c-05064e6aa25c,reranker-hn2,1719475462,1719479480,finished,1719475482,1719479480,A100-SXM4-80GB,8,1,64,448,20,3998
61fe49cc-185a-42a0-93ea-ccf7198d284d,long-context-upsample,1719475524,1719475601,finished,1719475543,1719475601,A100-SXM4-80GB,8,1,64,896,19,58
82d29c89-32ab-4f62-a312-baa716e100b7,geogpt-mixtral-test,1719475745,1719475984,finished,1719475825,1719475984,A100-SXM4-80GB,8,4,64,896,80,159
60803a7f-c171-40e3-a048-3b71348cab2d,commonbench-chat-vllm,1719475872,1719477252,finished,1719475892,1719477252,A100-SXM4-80GB,8,1,64,448,20,1360
79ced978-0b5a-4899-8aed-d9d561de1630,geogpt-mixtral-test,1719476084,1719476613,finished,1719476143,1719476613,A100-SXM4-80GB,8,4,64,896,59,470
dd5162b9-b063-4a74-ad82-957561c1026b,sfr-eval-mteb,1719476216,1719477169,finished,1719476236,1719477169,A100-SXM4-80GB,8,1,64,448,20,933
8bafc446-b4d1-4a60-8bc8-04e3e4073f29,data-gen-magpie,1719476303,1719476785,finished,1719476323,1719476785,A100-SXM4-80GB,8,1,64,448,20,462
9ee33b39-9222-42dd-b377-5a1273dab9c5,geogpt-mixtral-test,1719476613,1719477333,finished,1719476670,1719477333,A100-SXM4-80GB,8,4,64,896,57,663
c5340e6f-49a7-441f-9df5-37b0fd11099b,data-gen-magpie,1719476997,1719477133,finished,1719477017,1719477133,A100-SXM4-80GB,8,1,64,448,20,116
33e911ee-f5d0-428c-8d74-dc601710ddec,test,1719477190,1719538951,finished,1719477214,1719538951,A100-SXM4-80GB,8,1,64,896,24,61737
d0b00d3f-2f49-43ad-8fce-8b49ae87316a,long-context-upsample,1719477216,1719477664,finished,1719477239,1719477664,A100-SXM4-80GB,8,1,64,896,23,425
367ac000-5205-4ba1-be75-c4c0e0a26b8a,data-gen-magpie,1719477223,1719477710,finished,1719477246,1719477710,A100-SXM4-80GB,8,1,64,448,23,464
21b8565d-1985-4369-88ad-170814d6ee3b,commonbench-chat-vllm,1719477252,1719480068,finished,1719477273,1719480068,A100-SXM4-80GB,8,1,64,448,21,2795
fe8051ee-2f53-4a16-beea-4497a573e052,sfr-eval-mteb,1719477305,1719478469,finished,1719477325,1719478469,A100-SXM4-80GB,8,1,64,448,20,1144
957816d2-9f74-4788-8ca0-8d9e4bc168c3,geogpt-mixtral-test,1719477333,1719479013,finished,1719477396,1719479013,A100-SXM4-80GB,8,16,64,896,63,1617
d23b6dad-6b1e-4baf-b2ea-ba252ba7117c,easycontext-zj-test,1719477623,1719478835,finished,1719477684,1719478835,A100-SXM4-80GB,8,4,64,896,61,1151
5848f1d9-3881-43ce-bff8-6b46a305737c,infer-llama3-ckpt,1719477801,1719477902,finished,1719477821,1719477902,A100-SXM4-80GB,8,1,64,448,20,81
af7ab07d-14f6-4a53-814f-d1f633ef7ddc,data-gen-magpie,1719477986,1719486810,finished,1719478006,1719486810,A100-SXM4-80GB,8,1,64,448,20,8804
c685c5ab-e20c-4934-8a29-1e14f1927f08,infer-llama3-ckpt,1719478059,1719478156,finished,1719478079,1719478156,A100-SXM4-80GB,8,1,64,448,20,77
00ab0eb0-b2a2-45c3-b4eb-d85fa94b5361,infer-llama3-ckpt,1719478371,1719479545,finished,1719478392,1719479545,A100-SXM4-80GB,8,1,64,448,21,1153
25634ebb-d9d4-48ad-9bfd-56ecd02cd6ce,geogpt-moe-alpaca-sft,1719478467,1719479791,finished,1719478529,1719479791,A100-SXM4-80GB,8,2,64,448,62,1262
e40242d5-a5f4-418e-80fe-510a8d646956,sfr-ft-4,1719479219,1719578111,finished,1719479238,1719578111,A100-SXM4-80GB,8,1,64,448,19,98873
492a918d-ce38-42db-8e36-63e3eea1cd3e,geogpt-qwen2-chat-0612dpo-linear-w55,1719479382,1719566266,finished,1719479402,1719566266,A100-SXM4-80GB,8,1,64,448,20,86864
a2d9c19b-abb1-4263-9d3a-b62c779e23e2,citysora-modelv4-cele-ppm-121-512,1719479443,1719479612,finished,1719479507,1719479612,A100-SXM4-80GB,8,4,64,896,64,105
da13fea9-3141-4cc8-89ae-6b45dc7a9354,geo-base-offline-eval,1719479464,1719480245,finished,1719479486,1719480245,A100-SXM4-80GB,8,1,64,448,22,759
913d3bb4-17dd-48c0-9549-7d775a3c8304,rag-rank,1719479502,1719484248,finished,1719479523,1719484248,A100-SXM4-80GB,8,1,64,448,21,4725
e248a1bf-c1a7-4ded-b0a5-ccaf414d5602,infer-llama3-ckpt,1719479545,1719479629,finished,1719479566,1719479629,A100-SXM4-80GB,8,1,64,448,21,63
79bf31f5-79cb-4948-bc92-345156c503ff,txchen-lm-eval2,1719479601,1719482832,finished,1719479621,1719482832,A100-SXM4-80GB,8,1,64,448,20,3211
6a06dce1-e121-49ec-a3b1-d0ece243a1ca,citysora-modelv4-cele-ppm-121-512,1719479612,1719826670,finished,1719479673,1719826670,A100-SXM4-80GB,8,4,64,896,61,346997
5e8f9d15-4047-4ac0-89f7-c1a580a0edc3,rag-rank,1719479689,1719482558,finished,1719479710,1719482558,A100-SXM4-80GB,8,1,64,448,21,2848
ece2dd7d-930c-438b-92ea-5d199ca1615b,infer-llama3-ckpt,1719479751,1719481829,finished,1719479773,1719481829,A100-SXM4-80GB,8,1,64,448,22,2056
d2e55f87-0e7a-4eae-8cbe-9cced5d1b375,sfr-eval-mteb,1719479815,1719481221,finished,1719479835,1719481221,A100-SXM4-80GB,8,1,64,448,20,1386
8bbdfd41-13a6-4b11-aa8a-21f1340b46d0,qwen1-5-14b-merge-sft2ep-eb748-auto,1719479983,1719483567,finished,1719480006,1719483567,A100-SXM4-80GB,8,1,64,448,23,3561
5eab25d1-6f5a-46f0-9f28-7a242e1d4ee1,llama-multi,1719479997,1719480844,finished,1719480039,1719480844,A100-SXM4-80GB,8,2,64,448,42,805
af5ea969-8968-4059-b7cc-efeae54dcde6,commonbench-chat-vllm,1719480068,1719481616,finished,1719480088,1719481616,A100-SXM4-80GB,8,1,64,448,20,1528
d6fa710c-5c70-4151-ac04-2cd197888e2b,easycontext-zj-test,1719480139,1719481007,finished,1719480220,1719481007,A100-SXM4-80GB,8,2,64,896,81,787
4df389d7-7f5e-4644-aec9-319df7dba68e,geogpt-moe-alpaca-sft,1719480158,1719482033,finished,1719480217,1719482033,A100-SXM4-80GB,8,2,64,448,59,1816
8dcb14e7-440f-4f02-9ea5-875322ee68bf,geo-base-offline-eval,1719480245,1719480785,finished,1719480264,1719480785,A100-SXM4-80GB,8,1,64,448,19,521
b6b49a8a-5978-4d3c-abff-0c67649cc73c,geo-llamapro-1-8B,1719480585,1719480867,finished,1719480625,1719480867,A100-SXM4-80GB,8,4,64,448,40,242
5ba97711-3562-4a53-b34c-d74c1f014087,geo-base-offline-eval,1719480785,1719481733,finished,1719480806,1719481733,A100-SXM4-80GB,8,1,64,448,21,927
36fbe6c6-f638-4e54-a52e-07277f7968ee,reranker-hn,1719480905,1719484417,finished,1719480927,1719484417,A100-SXM4-80GB,8,1,64,448,22,3490
220f1e10-7c36-4b8f-83d3-417e5eb396c7,llama-multi,1719480909,1719574327,finished,1719480970,1719574327,A100-SXM4-80GB,8,2,64,448,61,93357
b5bc8e91-25c0-4184-802f-9ab5c6683aca,ls2,1719481181,1719488464,finished,1719481202,1719488464,A100-SXM4-80GB,8,1,64,896,21,7262
59fff967-1a75-43a5-9c10-617aa5843020,commonbench-chat-vllm,1719481616,1719495062,finished,1719481638,1719495062,A100-SXM4-80GB,8,1,64,448,22,13424
5212db44-19b2-4c8c-ab28-2b6b9a400b22,easycontext-zj-test,1719481687,1719482617,finished,1719481749,1719482617,A100-SXM4-80GB,8,2,64,896,62,868
6c03b606-a066-4d4b-aac3-7b8a8c2e338f,geo-base-offline-eval,1719481733,1719482198,finished,1719481753,1719482198,A100-SXM4-80GB,8,1,64,448,20,445
e718ee58-ac79-4b44-a7c9-323bd7dc2c86,geogpt-smoe-eval,1719481894,1719482061,finished,1719481914,1719482061,A100-SXM4-80GB,8,1,64,448,20,147
f65af0b4-fdfe-4d1c-968d-eb50166b68b1,geogpt-qwen2-72b-llamapro84-6bcpt,1719481918,1719482102,finished,1719481957,1719482102,A100-SXM4-80GB,8,20,64,448,39,145
b385167c-72fb-4049-a16d-b47b93b79fce,geo-base-offline-eval,1719482199,1719493122,finished,1719482218,1719493122,A100-SXM4-80GB,8,1,64,448,19,10904
350bd3ca-ff0c-45cb-bf39-db535b1d3c10,geogpt-qwen2-72b-llamapro84-6bcpt,1719482204,1719483235,finished,1719482262,1719483235,A100-SXM4-80GB,8,20,64,448,58,973
3093fc5e-22c5-46c0-ada9-f3fe6b873ed6,geogpt-smoe-eval,1719482565,1719488110,finished,1719482586,1719488110,A100-SXM4-80GB,8,1,64,448,21,5524
66ce78d6-9095-459a-b2fe-282f3faa240c,geo-llamapro-1-8B,1719483386,1719523093,finished,1719483425,1719523093,A100-SXM4-80GB,8,4,64,448,39,39668
ecada79b-1ce3-47e6-b7ce-544521a58a02,txchen-lm-eval2,1719484127,1719485272,finished,1719484147,1719485272,A100-SXM4-80GB,8,1,64,448,20,1125
ffed767a-b08e-4767-8967-6f58b49b85b3,geogpt-qwen2-72b-llamapro84-6bcpt,1719484730,1719696862,finished,1719484806,1719696862,A100-SXM4-80GB,8,20,64,448,76,212056
2ec1f1d1-52a4-4375-9472-140cf63d5fcd,easycontext-zj-test,1719486363,1719487338,finished,1719486440,1719487338,A100-SXM4-80GB,8,2,64,896,77,898
8cc23181-da9b-420e-a677-4b981543c9ee,txchen-lm-eval2,1719486569,1719491612,finished,1719486589,1719491612,A100-SXM4-80GB,8,1,64,448,20,5023
adfb6d87-0f46-4066-8ece-9a3c6c8fdfbe,easycontext-zj-test,1719487338,1719488390,finished,1719487377,1719488390,A100-SXM4-80GB,8,2,64,896,39,1013
e4883c50-2e0e-4a8e-9d46-50ba12c542a3,data-gen-magpie,1719487931,1719524377,finished,1719487951,1719524377,A100-SXM4-80GB,8,1,64,448,20,36426
c1c1bc1f-fb20-4835-9bb6-755cd9632ff7,geogpt-7b-llamapro40-s2-regate,1719488049,1719489936,finished,1719488069,1719489936,A100-SXM4-80GB,8,1,64,448,20,1867
964ac26f-1f1c-4ef9-af71-4397b0470b29,llama3-70b-instruct-ffc90-auto,1719488502,1719547111,finished,1719488524,1719547111,A100-SXM4-80GB,8,4,64,896,22,58587
dfc3a574-9e02-463f-b36b-e52401ffdcc8,llama3-70b-base-d3d65-auto,1719488503,1719547197,finished,1719488524,1719547197,A100-SXM4-80GB,8,4,64,896,21,58673
c2bb2c83-cd28-4982-9cf5-c27479f708df,data-gen-magpie-2,1719488911,1719489217,finished,1719488931,1719489217,A100-SXM4-80GB,8,1,64,448,20,286
5dab64f4-ab4d-48df-8411-4202b733ecef,easy-context-llama3-copy,1719489559,1719505326,finished,1719502692,1719505326,A100-SXM4-80GB,8,8,64,448,13133,2634
8c060283-b671-4812-9178-242d04d8b513,geogpt-7b-llamapro40-s2-regate,1719489936,1719705049,finished,1719489994,1719705049,A100-SXM4-80GB,8,4,64,448,58,215055
abef6810-bca2-4515-aa1d-4beec99b4396,data-gen-magpie-2,1719490069,1719609265,finished,1719490499,1719609265,A100-SXM4-80GB,8,1,64,448,430,118766
2e880c50-a741-4ee7-be90-d7da56ee2816,data-gen-magpie-3,1719490282,1719539924,finished,1719490361,1719539924,A100-SXM4-80GB,8,1,64,448,79,49563
ceb9eee9-12ca-4eb8-8b35-091a4f09e666,qwen-72b-test,1719490554,1719505348,finished,1719491452,1719505348,A100-SXM4-80GB,8,1,64,448,898,13896
fdf465d5-3e18-4bfa-8046-34c820d1d179,linux-env,1719490805,1719506290,finished,1719491618,1719506290,A100-SXM4-80GB,8,1,64,448,813,14672
61f87b46-c6d1-4ff3-8ffc-3d51442e51d7,txchen-train-task2,1719492179,1719493034,finished,1719492902,1719493034,A100-SXM4-80GB,8,1,64,448,723,132
6bc1f2f5-b343-4d87-8f32-7793b30c66a3,lzk-qwen15-7b-scihub-abstract-cpt,1719492823,1719738516,finished,1719493015,1719738516,A100-SXM4-80GB,8,1,64,448,192,245501
8e9c3c3f-e15c-42b6-99a1-34f63d0905fa,lzk-qwen15-7b-scihub-abstract-scpt,1719493435,1719493610,finished,1719493457,1719493610,A100-SXM4-80GB,8,1,64,448,22,153
366f8a31-9651-4313-a325-2f88b7f9f4b6,lzk-qwen15-7b-scihub-abstract-scpt,1719493709,1719503578,finished,1719493730,1719503578,A100-SXM4-80GB,8,1,64,448,21,9848
6f567b8c-56b3-4e61-81bf-466a398de116,qwen2-72b-10-8bcpt2ep-sft1ep-cc37c-auto,1719493782,1719541125,finished,1719493803,1719541125,A100-SXM4-80GB,8,1,64,448,21,47322
5bf853ae-51ee-47d9-a04f-4361389d0444,qwen2-72b-10-8bcpt2ep-sft1ep-bf00b-auto,1719493842,1719541165,finished,1719493861,1719541165,A100-SXM4-80GB,8,1,64,448,19,47304
b0866018-4954-42ab-a1bf-aa80b7f06f08,qwen2-72b-10-8bcpt2ep-sft1ep-15003-auto,1719493919,1719541105,finished,1719493940,1719541105,A100-SXM4-80GB,8,1,64,448,21,47165
ad7e07a6-06a0-4d7a-b0cd-de76990d9f38,txchen-train-task2,1719494042,1719537489,finished,1719495062,1719537489,A100-SXM4-80GB,8,1,64,448,1020,42427
340696d3-888d-4866-be8d-39de9a3b7116,lzk-qwen15-7b-scihub-abstract-cpt-patch,1719497599,1719501209,finished,1719501094,1719501209,A100-SXM4-80GB,8,1,64,448,3495,115
6634269b-6fbd-4c31-a016-8b872d605f08,txchen-lm-eval2,1719498184,1719508279,finished,1719501113,1719508279,A100-SXM4-80GB,8,1,64,448,2929,7166
a458f974-cc4c-480e-93a3-a7dc7d685687,geogpt-mixtral-test,1719501068,1719503905,finished,1719502673,1719503905,A100-SXM4-80GB,8,16,64,896,1605,1232
650ac7c2-1983-4014-8303-9f67d693b695,lzk-qwen15-7b-scihub-abstract-cpt-patch,1719502898,1719510175,finished,1719502917,1719510175,A100-SXM4-80GB,8,1,64,448,19,7258
ae40b12f-3aa7-4db8-9937-c9d52cb747cc,Qwen2-72B-fcc82-auto,1719503032,1719503176,finished,1719503053,1719503176,A100-SXM4-80GB,8,1,64,448,21,123
140cdc67-7d14-406a-8789-4b13dc1192f0,Qwen1-5-110B-64aae-auto,1719503053,1719547378,finished,1719503072,1719547378,A100-SXM4-80GB,8,1,64,448,19,44306
e11b2c54-e755-44be-86f9-9fc834cc2e94,Qwen2-72B-c9e06-auto,1719503115,1719547398,finished,1719503136,1719547398,A100-SXM4-80GB,8,1,64,448,21,44262
d1767319-ef74-4f4b-a72c-b316a7f8d1da,Qwen1-5-72B-9f862-auto,1719503156,1719547398,finished,1719503177,1719547398,A100-SXM4-80GB,8,1,64,448,21,44221
a388cd75-a3ea-4f63-b984-64be4ed0d45a,Llama-3-70B-b4747-auto,1719503215,1719504010,finished,1719503235,1719504010,A100-SXM4-80GB,8,1,64,448,20,775
53706488-8131-45d5-a8ce-043069182d35,commonbench-chat-vllm,1719503273,1719503672,finished,1719503294,1719503672,A100-SXM4-80GB,8,1,64,448,21,378
42ab93c1-733f-422b-94ef-1f257d27550d,commonbench-chat-vllm-bs1,1719503672,1719607969,finished,1719503692,1719607969,A100-SXM4-80GB,8,1,64,448,20,104277
826007bf-5460-40b8-a299-fd397783b8a0,commonbench-base-vllm,1719503729,1719504144,finished,1719503751,1719504144,A100-SXM4-80GB,8,1,64,448,22,393
72761b2b-52c1-4713-9f2a-653c3ae18148,geogpt-mixtral-test,1719503905,1719503964,finished,1719503924,1719503964,A100-SXM4-80GB,8,16,64,896,19,40
5b00c941-89fa-4bdd-ba4d-2a37cf197403,llama3-extra-infer,1719505027,1719537476,finished,1719505050,1719537476,A100-SXM4-80GB,8,1,64,448,23,32426
10a22246-679b-43cb-9209-aeb19ec30992,lzk-qwen15-7b-scihub-abstract-scpt,1719505042,1719509938,finished,1719505063,1719509938,A100-SXM4-80GB,8,1,64,448,21,4875
3f18c281-0954-4e31-92a6-b8a68d3208ef,easy-context-llama3-copy,1719505326,1719506461,finished,1719505385,1719506461,A100-SXM4-80GB,8,12,64,448,59,1076
f93113f7-9cf8-416d-92a3-7a9bb4b422bf,qwen-72b-test,1719505548,1719508193,finished,1719505568,1719508193,A100-SXM4-80GB,8,1,64,448,20,2625
12eee881-010a-44ae-ad20-2e9e76130815,llama3-ntk-21-infer,1719506249,1719537476,finished,1719506271,1719537476,A100-SXM4-80GB,8,1,64,448,22,31205
1bbdb9fc-2e31-4fae-80e2-2e93a1331805,easy-context-llama3-copy,1719506598,1719507652,finished,1719506675,1719507652,A100-SXM4-80GB,8,12,64,448,77,977
92f259af-8f87-49cd-8a29-4bf994a20cf1,geogpt-mixtral-test,1719506840,1719563406,finished,1719507678,1719563406,A100-SXM4-80GB,8,16,64,896,838,55728
efec028f-c1e0-40b3-8e4f-d491ea985488,qwen-72b-test,1719508496,1719508957,finished,1719508516,1719508957,A100-SXM4-80GB,8,1,64,448,20,441
ce487905-0571-4df4-ac2a-a8697b395f9b,qwen15-7b-chat-442a7-auto,1719508848,1719510931,finished,1719508869,1719510931,A100-SXM4-80GB,8,1,64,448,21,2062
1e680c33-4e7a-4afb-bb5b-2a243dab01ee,qwen15-7b-base-syn-it-sft-c52e6-auto,1719508928,1719515228,finished,1719508947,1719515228,A100-SXM4-80GB,8,1,64,448,19,6281
bc08b011-8e3d-46bd-9159-3c446d55f0e5,qwen-72b-test,1719509301,1719509749,finished,1719509322,1719509749,A100-SXM4-80GB,8,1,64,448,21,427
40415371-f9d2-43c6-8b5c-688a3229908d,qwen-72b-test,1719509886,1719510632,finished,1719509909,1719510632,A100-SXM4-80GB,8,1,64,448,23,723
2b0c3e57-6759-4785-8221-2b4bace451b7,lzk-qwen15-7b-scihub-abstract-scpt,1719509938,1719519301,finished,1719509959,1719519301,A100-SXM4-80GB,8,1,64,448,21,9342
77737540-4577-4a7f-bd60-edbff77c7ce6,qwen-72b-test,1719510127,1719563982,finished,1719510147,1719563982,A100-SXM4-40GB,8,1,32,320,20,53835
d59fa13f-bac6-4d1c-911a-6ed3feeddae4,lzk-qwen15-7b-scihub-abstract-cpt-patch,1719510175,1719518359,finished,1719510196,1719518359,A100-SXM4-80GB,8,1,64,448,21,8163
d6e03415-2a34-406c-92a8-6de53628aaf7,qwen-72b-test,1719510690,1719511573,finished,1719510710,1719511573,A100-SXM4-80GB,8,1,64,448,20,863
ff6b4753-1a35-4789-a8ee-dd739dde273d,qwen-72b-test,1719511613,1719512230,finished,1719511633,1719512230,A100-SXM4-80GB,8,1,64,448,20,597
8fbeb73b-a4da-48d0-9ed2-459515fb8dc8,qwen-72b-test,1719512289,1719639396,finished,1719512309,1719639396,A100-SXM4-80GB,8,1,64,448,20,127087
051ff969-fb39-4eb8-9135-94a3149de265,gpt-megatron,1719520655,1719549201,finished,1719520696,1719549201,A100-SXM4-80GB,8,16,64,448,41,28505
f881f4d1-cc81-4331-9d34-3b462d292fbb,linux-env,1719537455,1719544801,finished,1719537476,1719544801,A100-SXM4-80GB,8,1,64,448,21,7325
b1e661a2-a793-4571-81be-b2b14170fa6e,qwen2-72b-instruct-extra-128k-18652-auto,1719538351,1719547111,finished,1719538373,1719547111,A100-SXM4-80GB,8,4,64,896,22,8738
f1da8f03-d0f8-4df2-98f6-7822270fde8d,llama3-70b-base-extra-128k-31c72-auto,1719538457,1719546883,finished,1719538478,1719546883,A100-SXM4-80GB,8,4,64,896,21,8405
613b9520-1b11-47c2-ab56-ed22b5ca5d8b,llama3-70b-instruct-extra-128k-1d5e0-auto,1719538479,1719546568,finished,1719538500,1719546568,A100-SXM4-80GB,8,4,64,896,21,8068
5eded635-9559-4f9c-b991-e9ca0bdc0c77,reranker-base,1719538834,1719538952,finished,1719538853,1719538952,A100-SXM4-80GB,8,1,64,896,19,99
adfaedb9-a987-479d-9907-c347f58fcd2c,reranker-inference,1719538892,1719539055,finished,1719538914,1719539055,A100-SXM4-80GB,8,1,64,448,22,141
49fef0a3-4f9b-41a8-9d72-c41fa02c84fb,reranker-inference11,1719538933,1719544775,finished,1719538952,1719544775,A100-SXM4-80GB,8,1,64,448,19,5823
a1291c68-9459-4bf2-9958-2ac57024ede1,test,1719538988,1719540872,finished,1719539009,1719540872,A100-SXM4-80GB,8,1,64,896,21,1863
176c16d4-0d9e-4a81-8b76-51e24556ee8a,reranker-base,1719539011,1719542393,finished,1719539035,1719542393,A100-SXM4-80GB,8,1,64,896,24,3358
7fd28b75-c35b-4187-8fc5-6c9bab18191c,easy-context-llama3-copy,1719539036,1719542649,finished,1719539113,1719542649,A100-SXM4-80GB,8,12,64,448,77,3536
13a4dbf0-819f-49eb-b316-3e0ef9fab633,reranker-inference,1719539055,1719566065,finished,1719539074,1719566065,A100-SXM4-80GB,8,1,64,448,19,26991
7ded8d50-385b-4c8a-85cd-225dd5a01a63,sfr-eval-mteb,1719540038,1719540337,finished,1719540057,1719540337,A100-SXM4-80GB,8,1,64,448,19,280
2648e83e-57f9-4b10-986e-56217114dd61,reranker-hn2,1719540256,1719540516,finished,1719540277,1719540516,A100-SXM4-80GB,8,1,64,448,21,239
ed0b6c32-c401-49aa-9bb4-7209296e67a6,geogpt-dairui-model-merge-exp-1,1719540460,1719581616,finished,1719540481,1719581616,A100-SXM4-80GB,8,1,64,896,21,41135
85aeb768-f69c-43f6-bcf3-37322160f4be,test,1719541074,1719543446,finished,1719541094,1719543446,A100-SXM4-80GB,8,1,64,896,20,2352
c229c20e-4a76-4648-8a90-2f8a4207951f,reranker-hn2,1719541335,1719541796,finished,1719541355,1719541796,A100-SXM4-80GB,8,1,64,448,20,441
8ee8855b-d46e-49e8-90c1-c83827e60a86,reranker-hn,1719541418,1719541694,finished,1719541441,1719541694,A100-SXM4-80GB,8,1,64,448,23,253
b448e238-b97b-43d8-8db5-965ec658122a,sfr-embedding-test,1719541626,1719628563,finished,1719541651,1719628563,A100-SXM4-80GB,8,1,64,448,25,86912
cb6e0fb2-9f58-421e-bc6b-2bdc68f1c308,intent-train-llm-gpt,1719541630,1719542335,finished,1719541653,1719542335,A100-SXM4-80GB,8,1,64,448,23,682
1765dc38-a6cd-4805-b1e1-f5155e383245,data-gen-magpie,1719541659,1719542023,finished,1719541681,1719542023,A100-SXM4-80GB,8,1,64,448,22,342
7c242b2c-08b6-46b2-bbf2-b26d8285e641,ls2,1719541695,1719548991,finished,1719541717,1719548991,A100-SXM4-80GB,8,1,64,896,22,7274
b3fa8d33-8cd5-48c0-bc54-2abb9ed2d78d,geo-table-datav05-lora-5e-5,1719541801,1719561412,finished,1719541822,1719561412,A100-SXM4-80GB,8,1,64,448,21,19590
af12be06-9875-4d8f-be01-9451b245bbca,commonbench-base-vllm,1719542029,1719542900,finished,1719542049,1719542900,A100-SXM4-80GB,8,1,64,448,20,851
cc9d042b-cd65-4589-82cb-5e6c3ba4fc26,reranker-hn,1719542141,1719543059,finished,1719542162,1719543059,A100-SXM4-80GB,8,1,64,448,21,897
7274d615-ae4d-4b4f-bd12-acf78f02e2db,q72b-chat-0612dpo-linear-w73-8e4d7-auto,1719542172,1719543497,finished,1719542403,1719543497,A100-SXM4-80GB,8,1,64,448,231,1094
6164920f-a239-4399-b146-fdbfd2fd8075,q72b-chat-0612dpo-linear-w91-78adc-auto,1719542193,1719543411,finished,1719542319,1719543411,A100-SXM4-80GB,8,1,64,448,126,1092
79a1c0c7-0a7a-4ce6-b263-b4b84d25a35f,q72b-chat-0612dpo-linear-w19-3ede0-auto,1719542195,1719543497,finished,1719542635,1719543497,A100-SXM4-80GB,8,1,64,448,440,862
772f03d7-571f-41d4-b629-808edb62ad0c,q72b-chat-0612dpo-linear-w37-75674-auto,1719542197,1719543651,finished,1719542424,1719543651,A100-SXM4-80GB,8,1,64,448,227,1227
86cc032c-5fd0-4665-938f-234ef5f09748,rag-rank,1719542332,1719544120,finished,1719542648,1719544120,A100-SXM4-80GB,8,1,64,448,316,1472
ac7a38a7-d9fe-48a5-860a-05282f960d22,reranker-base,1719542393,1719549266,finished,1719542648,1719549266,A100-SXM4-80GB,8,1,64,896,255,6618
917b076f-f9a2-4d58-abbb-6cd40a0bbaf8,intent-train-llm-gpt,1719542417,1719543018,finished,1719542651,1719543018,A100-SXM4-80GB,8,1,64,448,234,367
098d3f5d-006e-41ee-b396-e4bae2974390,linux-env-cp,1719542580,1719542692,finished,1719542649,1719542692,A100-SXM4-80GB,8,1,64,448,69,43
d7019975-849d-44ef-b016-39ebb1f6a7d6,qwen2-72b-10-8bcpt2ep-sft1ep-814d4-auto,1719542724,1719547324,finished,1719542746,1719547324,A100-SXM4-80GB,8,1,64,448,22,4578
4c140980-845e-445e-bac0-f96161168e87,geo-base-offline-eval,1719542741,1719547389,finished,1719542762,1719547389,A100-SXM4-80GB,8,1,64,448,21,4627
831f3b18-fc97-4587-961e-d43cc11851c5,qwen2-72b-10-8bcpt2ep-sft1ep-2d0ed-auto,1719542788,1719543522,finished,1719542810,1719543522,A100-SXM4-80GB,8,1,64,448,22,712
561e8de5-5cc7-4805-bfc4-f65ddeb2a70d,qwen2-72b-10-8bcpt2ep-sft1ep-35b80-auto,1719542873,1719547225,finished,1719542897,1719547225,A100-SXM4-80GB,8,1,64,448,24,4328
ad571f00-adbf-42bb-aff2-2855657c303a,linux-env-cp,1719542887,1721104090,finished,1719542909,1721104090,A100-SXM4-80GB,8,1,64,448,22,1561181
738e9a54-a823-4e87-b53d-18a812e78816,sfr-eval-mteb,1719543166,1719547840,finished,1719543188,1719547840,A100-SXM4-80GB,8,1,64,448,22,4652
d070a042-06fd-4e5e-a381-1fd475186a53,intent-train-llm-gpt,1719543339,1719547575,finished,1719543361,1719547575,A100-SXM4-80GB,8,1,64,448,22,4214
75bb777d-3395-4ce3-828c-d76e01b3f0a9,test,1719543532,1719547198,finished,1719543554,1719547198,A100-SXM4-80GB,8,1,64,896,22,3644
d4b3d6e8-5bd6-4405-bfd3-010167db1559,geo-MoD-1-8B,1719543605,1719543773,finished,1719543628,1719543773,A100-SXM4-80GB,8,1,64,448,23,145
3eb49a27-f751-4b62-8bd0-777c785395b6,llama3-cpt-extra-infer,1719543747,1719544645,finished,1719543768,1719544645,A100-SXM4-80GB,8,1,64,448,21,877
95611765-880b-4de6-8b45-8be01b52124b,geo-MoD-1-8B,1719543878,1719544044,finished,1719543899,1719544044,A100-SXM4-80GB,8,1,64,448,21,145
77af2d2b-896d-4ff6-bc0b-97c4d487ea46,geo-MoD-1-8B,1719544146,1719544314,finished,1719544167,1719544314,A100-SXM4-80GB,8,1,64,448,21,147
3da411a1-0ee2-4fa2-a2b9-cbaea5fc1a9b,commonbench-base-vllm,1719544260,1719545425,finished,1719544282,1719545425,A100-SXM4-80GB,8,1,64,448,22,1143
b104f5c1-9e2c-45ef-bcff-87adde84560d,geo-cpt-1-8B,1719544336,1719544483,finished,1719544400,1719544483,A100-SXM4-80GB,8,2,64,896,64,83
dc17b428-3cbf-4cd7-89ad-8d135fdbb482,llama3-cpt-extra-infer,1719544645,1719553180,finished,1719544668,1719553180,A100-SXM4-80GB,8,1,64,448,23,8512
a69592d0-66aa-45ef-8334-b196a372e884,rag-rank,1719544687,1719548474,finished,1719544708,1719548474,A100-SXM4-80GB,8,1,64,448,21,3766
bada49d9-62d3-4d13-9cd9-c1377bc7e800,geo-MoD-1-8B,1719544759,1719545246,finished,1719544806,1719545246,A100-SXM4-80GB,8,4,64,448,47,440
6aeb1e85-9e9b-4307-8f02-2bbb62ab8ffd,reranker-inference11,1719544775,1719566184,finished,1719544801,1719566184,A100-SXM4-80GB,8,1,64,448,26,21383
3d4f2c2f-322d-40fc-9b41-b434efe40521,lzk-qwen15-7b-scihub-abstract-cpt-patch,1719544817,1719551112,finished,1719544838,1719551112,A100-SXM4-80GB,8,1,64,448,21,6274
a2b19a3b-a632-4486-a669-e7e8d630b28b,lzk-qwen15-7b-scihub-abstract-scpt,1719544817,1719550812,finished,1719544838,1719550812,A100-SXM4-80GB,8,1,64,448,21,5974
a266eed3-7dbe-4018-a750-766e1f1d0bd7,geo-MoD-1-8B,1719545246,1719646310,finished,1719545310,1719646310,A100-SXM4-80GB,8,4,64,448,64,101000
36d0018c-e344-46e7-a731-a45d407c50db,q72b-chat-0612dpo-linear-w19-27cbf-auto,1719545711,1719547210,finished,1719545735,1719547210,A100-SXM4-80GB,8,1,64,448,24,1475
5d2b35a3-1b0c-4b8d-9215-41f1329959f1,q72b-chat-0612dpo-linear-w73-b61d0-auto,1719545712,1719547210,finished,1719545759,1719547210,A100-SXM4-80GB,8,1,64,448,47,1451
d35aa7da-c545-4990-abc8-cbf2b85da4a1,q72b-chat-0612dpo-linear-w37-bd4e7-auto,1719545715,1719547211,finished,1719546031,1719547211,A100-SXM4-80GB,8,1,64,448,316,1180
a2f1bd59-22eb-40b4-8a03-84db008b790a,q72b-chat-0612dpo-vec-w73-5870d-auto,1719545760,1719547213,finished,1719545943,1719547213,A100-SXM4-80GB,8,1,64,448,183,1270
f85c71a2-5f75-4ad7-b452-fa6c81741a4e,q72b-chat-0612dpo-linear-w91-77d4b-auto,1719545763,1719547213,finished,1719546076,1719547213,A100-SXM4-80GB,8,1,64,448,313,1137
41115990-6710-4d65-ae66-19b59766e34f,geogpt-eval-common-latest,1719545764,1719545901,finished,1719545785,1719545901,A100-SXM4-80GB,8,1,64,896,21,116
c93f6eb5-ca56-44f3-bccd-cb468ca15179,q72b-chat-0612dpo-vec-w91-bc125-auto,1719545808,1719547215,finished,1719546009,1719547215,A100-SXM4-80GB,8,1,64,448,201,1206
bdf18d4d-6f34-46b0-ab9e-0c62b1962a69,q72b-chat-0612dpo-vec-w55-ae243-auto,1719545809,1719547215,finished,1719545964,1719547215,A100-SXM4-80GB,8,1,64,448,155,1251
c6320f87-1375-4d5c-a321-89224059de58,q72b-chat-0612dpo-vec-w19-34820-auto,1719545813,1719547216,finished,1719545986,1719547216,A100-SXM4-80GB,8,1,64,448,173,1230
e175e4d6-68c8-4727-9f5d-d57fae60fbe1,q72b-chat-0612dpo-vec-w37-077f7-auto,1719545814,1719547218,finished,1719546055,1719547218,A100-SXM4-80GB,8,1,64,448,241,1163
7df4a806-2b87-42fa-ab77-0d4b3ec19af4,geogpt-llama3-70b-0521,1719545906,1719962786,finished,1719545928,1719962786,A100-SXM4-40GB,8,1,32,320,22,416858
71eaa0ed-744e-49eb-abeb-44be095d2cfa,geogpt-eval-common-latest,1719546296,1719547210,finished,1719546318,1719547210,A100-SXM4-80GB,8,1,64,896,22,892
666e98a7-6f25-46e6-b9d1-12b5501c8239,megatron-gpt-2nodes,1719547118,1719553786,finished,1719547405,1719553786,A100-SXM4-80GB,8,16,64,448,287,6381
4c77430d-d988-416d-9b1e-e141bf56ef98,easycontext-zj-test,1719547122,1719548136,finished,1719547237,1719548136,A100-SXM4-80GB,8,2,64,896,115,899
96906690-2070-45fd-94b4-e82abccdc20f,geo-cpt-1-8B,1719547141,1719547363,finished,1719547270,1719547363,A100-SXM4-80GB,8,2,64,896,129,93
d78c2bd9-f378-4ec6-a356-8d10bd832820,geogpt-lxz-cft-1-8m-subset-m1l3-2ep-72b,1719547147,1719606315,finished,1719553820,1719606315,A100-SXM4-80GB,8,32,64,448,6673,52495
d0a45d8d-b897-42ef-a8a2-15ebbd74e7ff,geogpt-lxz-sft-magpie-qwen2-pro-2ep-72b,1719547150,1719547616,finished,1719547365,1719547616,A100-SXM4-80GB,8,16,64,448,215,251
8e468bba-92bb-430e-878b-c19dd0cb8045,q72b-chat-0612dpo-linear-w37-c0d73-auto,1719547163,1719547295,finished,1719547218,1719547295,A100-SXM4-80GB,8,1,64,448,55,77
35f5ab60-8e12-4aaf-bf00-2412a5b6b650,q72b-chat-0612dpo-linear-w19-39620-auto,1719547168,1719547296,finished,1719547219,1719547296,A100-SXM4-80GB,8,1,64,448,51,77
db5e4174-d6e4-4e5a-96cf-76d973f122e5,q72b-chat-0612dpo-vec-w55-77806-auto,1719547172,1719547296,finished,1719547220,1719547296,A100-SXM4-80GB,8,1,64,448,48,76
7bc07e11-01eb-45c8-997b-e657f2d92671,q72b-chat-0612dpo-vec-w37-b23f3-auto,1719547175,1719547296,finished,1719547220,1719547296,A100-SXM4-80GB,8,1,64,448,45,76
21baf2b5-b736-4a45-a2d3-f6e51dea0a19,geogpt-eval-common-latest,1719547210,1719630754,finished,1719547244,1719630754,A100-SXM4-80GB,8,1,64,896,34,83510
c1d324a9-788c-4185-a289-7ae610424319,data-gen-magpie,1719547320,1719559566,finished,1719547345,1719559566,A100-SXM4-80GB,8,1,64,448,25,12221
e5c729f5-54d6-4e60-ac30-264d1b030ed8,qwen2-72b-10-8bcpt2ep-sft1ep-a6545-auto,1719547522,1719549815,finished,1719547562,1719549815,A100-SXM4-80GB,8,1,64,448,40,2253
e6f454c1-593c-4cfa-8166-d5ae3a1b65c5,geogpt-lxz-sft-magpie-qwen2-pro-2ep-72b,1719547680,1719547903,finished,1719547721,1719547903,A100-SXM4-80GB,8,16,64,448,41,182
ee72c397-9a7c-40d7-a4ef-b8a9c6bae0e2,intent-test-llm-all,1719547695,1719548476,finished,1719547714,1719548476,A100-SXM4-80GB,8,1,64,448,19,762
c2db82c8-1423-4bf5-84f1-1d41508d59b6,geogpt-llm-moe-expand-0-5B-sr-12-tag-1,1719547719,1719624945,finished,1719547845,1719624945,A100-SXM4-80GB,8,1,64,896,126,77100
3776afa1-5f6a-4b0d-b031-0ecc2fa8319a,lzk-qwen15-7b-scihub-abstract-scpt-path,1719547735,1719556204,finished,1719547833,1719556204,A100-SXM4-80GB,8,1,64,448,98,8371
f5a365c7-41bb-4fba-bf7a-747dfe2611df,sfr-eval-mteb,1719547840,1719550393,finished,1719547897,1719550393,A100-SXM4-80GB,8,1,64,448,57,2496
81c835ee-3f2e-439a-9985-f95cb11ffa83,test,1719547963,1719551617,finished,1719547984,1719551617,A100-SXM4-80GB,8,1,64,896,21,3633
5562a25f-00ab-4f7b-b783-018af1a67961,geogpt-lxz-sft-magpie-qwen2-pro-2ep-72b,1719547971,1719548657,finished,1719548481,1719548657,A100-SXM4-80GB,8,16,64,448,510,176
6cb8594f-85c7-47f6-98c4-2d738bc822bf,txchen-lm-eval2,1719547978,1719548211,finished,1719547998,1719548211,A100-SXM4-80GB,8,1,64,448,20,213
291fe872-77bb-44d9-8b65-7a0b9c9a8481,txchen-lm-eval2,1719548211,1719551612,finished,1719548231,1719551612,A100-SXM4-80GB,8,1,64,448,20,3381
1a586182-56be-4771-9266-18af3c23b71e,geogpt-moe-0-5B-sr12-ep1-mlp-fire,1719548580,1719567745,finished,1719548636,1719567745,A100-SXM4-80GB,8,1,64,896,56,19109
3ab2c1e3-d0b5-4555-b4ec-125821bd33e5,ruler-eval-0628-qwen2-70b,1719548687,1719874452,finished,1719548713,1719874452,A100-SXM4-80GB,8,1,64,896,26,325739
c59e1bdd-0bc7-4f4e-af0a-f4e25c7f7409,geogpt-lxz-sft-magpie-qwen2-pro-2ep-72b,1719548721,1719549479,finished,1719549248,1719549479,A100-SXM4-80GB,8,16,64,448,527,231
bb25f7da-15b1-40db-ba6d-a1ac520c4830,geogpt-moe-0-5B-sr12-ep1-mlp0,1719548760,1719611097,finished,1719548780,1719611097,A100-SXM4-80GB,8,1,64,896,20,62317
493f3a95-d6dd-4e62-b9fd-edc6e42ad947,ruler-eval-0628-qwen2-70b-instruct-extra-128k,1719548850,1719887028,finished,1719548870,1719887028,A100-SXM4-80GB,8,1,64,896,20,338158
b63f091b-6a6e-48e3-9b4c-0360de60d1a0,ruler-eval-0628-llama3-70b,1719548870,1719568456,finished,1719548890,1719568456,A100-SXM4-80GB,8,1,64,896,20,19566
f85227db-560d-4e23-94a2-82af58da63e5,ruler-eval-0628-llama3-70b-extra-128k,1719548910,1719851910,finished,1719548931,1719851910,A100-SXM4-80GB,8,1,64,896,21,302979
24f5e20f-9bdd-4e56-9d1e-b31746de5a31,ruler-eval-0628-llama3-70b-instruct-extra-128k,1719548949,1719549160,finished,1719548970,1719549160,A100-SXM4-80GB,8,1,64,896,21,190
e0bd6437-6081-463e-ba3f-4cb5496fbc51,rag-rank,1719549160,1719550338,finished,1719549182,1719550338,A100-SXM4-80GB,8,1,64,448,22,1156
7ed52902-af71-4b5f-8aef-d8097ebe34bf,reranker-base,1719549266,1719550606,finished,1719549285,1719550606,A100-SXM4-80GB,8,1,64,896,19,1321
a1ef8135-e0b9-46e3-8d6d-51910d4b3491,geogpt-moe-sr12-ep1-tag-1-mlp-6,1719549439,1719615652,finished,1719549458,1719615652,A100-SXM4-80GB,8,1,64,896,19,66194
7fd60148-5d33-49b9-83d1-af7dc2112736,geogpt-lxz-sft-magpie-qwen2-pro-2ep-72b,1719549541,1719549869,finished,1719549619,1719549869,A100-SXM4-80GB,8,16,64,448,78,250
df11128e-7bff-451f-95ff-1b469e574347,geogpt-moe-sr12-ep1-tag-1-mlp-5,1719549560,1719616633,finished,1719549580,1719616633,A100-SXM4-80GB,8,1,64,896,20,67053
b0888d1d-7fb5-4041-aa35-4a80d4dddcc9,geogpt-lxz-sft-magpie-qwen2-pro-2ep-72b,1719549931,1719550182,finished,1719549988,1719550182,A100-SXM4-80GB,8,16,64,448,57,194
05e76a43-33f4-4c86-9e56-ed44bb8a85dc,ruler-eval-0628-llama3-70b-instruct-extra-128k,1719549942,1719550430,finished,1719549962,1719550430,A100-SXM4-80GB,8,1,64,896,20,468
a489e43e-c542-4898-9754-90deae21847e,geogpt-lxz-sft-magpie-qwen2-pro-2ep-72b,1719550244,1719550513,finished,1719550320,1719550513,A100-SXM4-80GB,8,16,64,448,76,193
39c80cc2-eb12-429c-b102-7967bc31060d,ruler-eval-0628-llama3-70b-instruct-extra-128k,1719550485,1719855110,finished,1719550505,1719855110,A100-SXM4-80GB,8,1,64,896,20,304605
0ebfd733-f5da-4864-a48f-285a2c3f5bff,geogpt-lxz-sft-magpie-qwen2-pro-2ep-72b,1719550573,1719550824,finished,1719550631,1719550824,A100-SXM4-80GB,8,16,64,448,58,193
4135d234-186d-4f02-8b97-4dae31c76d06,reranker-base,1719550607,1719553090,finished,1719550625,1719553090,A100-SXM4-80GB,8,1,64,896,18,2465
ba51af12-8c20-4134-bc44-6893e43ad86c,rag-rank,1719550856,1719552053,finished,1719550880,1719552053,A100-SXM4-80GB,8,1,64,448,24,1173
a88dd8f2-344f-4799-b746-6a2297ef8161,geogpt-lxz-sft-magpie-qwen2-pro-2ep-72b,1719550888,1719551124,finished,1719550944,1719551124,A100-SXM4-80GB,8,16,64,448,56,180
b9cd80a8-ed51-4424-a52f-b7c6293dfd9a,geogpt-lxz-sft-magpie-qwen2-pro-2ep-72b,1719551185,1719551451,finished,1719551243,1719551451,A100-SXM4-80GB,8,16,64,448,58,208
fadfe36b-c28d-4b65-bafc-0cae66bbe751,q72b-chat-0612dpo-vec-w19-485fd-auto,1719551308,1719552267,finished,1719551327,1719552267,A100-SXM4-80GB,8,1,64,448,19,940
200bee72-6443-4c66-ab1a-ad7ac442e705,q72b-chat-0612dpo-vec-w55-c0e58-auto,1719551348,1719552244,finished,1719551371,1719552244,A100-SXM4-80GB,8,1,64,448,23,873
89078901-33c0-4cb5-b7e2-9035aff385dd,q72b-chat-0612dpo-vec-w37-30e19-auto,1719551373,1719552360,finished,1719551396,1719552360,A100-SXM4-80GB,8,1,64,448,23,964
945a8ae6-b145-482f-bf73-8f9bb90497f5,q72b-chat-0612dpo-vec-w73-ed2ce-auto,1719551374,1719552360,finished,1719551396,1719552360,A100-SXM4-80GB,8,1,64,448,22,964
1552dafd-8e89-4455-8810-55841afd6baf,q72b-chat-0612dpo-vec-w55-8ebc5-auto,1719551397,1719563843,finished,1719551422,1719563843,A100-SXM4-80GB,8,1,64,448,25,12421
e16e726d-571f-455c-b1fe-d430c8d25bba,q72b-chat-0612dpo-linear-w19-3b199-auto,1719551399,1719562760,finished,1719551422,1719562760,A100-SXM4-80GB,8,1,64,448,23,11338
5e23f997-14e6-4e91-a04d-d17267cc4506,q72b-chat-0612dpo-vec-w73-62bb5-auto,1719551424,1719564787,finished,1719551451,1719564787,A100-SXM4-80GB,8,1,64,448,27,13336
daf92dad-6945-4a08-9f62-a7fe690d4e3a,q72b-chat-0612dpo-linear-w73-e5d46-auto,1719551426,1719564472,finished,1719551451,1719564472,A100-SXM4-80GB,8,1,64,448,25,13021
898f9bfa-03d6-4c71-83df-f039e86a7395,q72b-chat-0612dpo-linear-w37-b391d-auto,1719551427,1719562761,finished,1719551451,1719562761,A100-SXM4-80GB,8,1,64,448,24,11310
ef0660a0-ad58-4def-b084-d8f144edc2fb,q72b-chat-0612dpo-vec-w37-b8110-auto,1719551430,1719551749,finished,1719551451,1719551749,A100-SXM4-80GB,8,1,64,448,21,298
edb8b1d3-c95b-492e-b5a8-c9d463194dbc,q72b-chat-0612dpo-vec-w19-e9488-auto,1719551432,1719563265,finished,1719551451,1719563265,A100-SXM4-80GB,8,1,64,448,19,11814
22d52c74-6f48-4868-9281-d98a33f300fb,q72b-chat-0612dpo-vec-w37-0cd9f-auto,1719551453,1719553303,finished,1719551472,1719553303,A100-SXM4-80GB,8,1,64,448,19,1831
89693a7f-5786-4369-985a-915fc511d484,q72b-chat-0612dpo-vec-w19-4ed0e-auto,1719551473,1719553504,finished,1719551502,1719553504,A100-SXM4-80GB,8,1,64,448,29,2002
302a8825-9c15-478f-aa97-c514901eaec5,q72b-chat-0612dpo-vec-w73-c9614-auto,1719551476,1719553527,finished,1719551502,1719553527,A100-SXM4-80GB,8,1,64,448,26,2025
e2c2079a-e5b7-4494-ae9b-e8e7812f1117,q72b-chat-0612dpo-linear-w73-e5333-auto,1719551477,1719553528,finished,1719551503,1719553528,A100-SXM4-80GB,8,1,64,448,26,2025
46701c7a-9245-45cc-b28a-47bff711b275,q72b-chat-0612dpo-linear-w37-a27b0-auto,1719551480,1719553505,finished,1719551503,1719553505,A100-SXM4-80GB,8,1,64,448,23,2002
05cfb165-4b89-45f6-9be0-76ef26edce90,q72b-chat-0612dpo-vec-w55-e5612-auto,1719551482,1719553506,finished,1719551503,1719553506,A100-SXM4-80GB,8,1,64,448,21,2003
e7199e62-c403-438e-8507-54736e035c1e,q72b-chat-0612dpo-linear-w19-8a423-auto,1719551484,1719553327,finished,1719551503,1719553327,A100-SXM4-80GB,8,1,64,448,19,1824
e1078880-5d22-466e-82c9-07aac66df909,geogpt-lxz-sft-magpie-qwen2-pro-2ep-72b,1719551526,1719553748,finished,1719553550,1719553748,A100-SXM4-80GB,8,16,64,448,2024,198
7f900d65-050c-46d5-b83b-c2cd684d1e51,geo-base-offline-eval,1719551663,1719558846,finished,1719551683,1719558846,A100-SXM4-80GB,8,1,64,448,20,7163
09b7d908-f8b9-4dc3-bac3-7ad6ca677858,sfr-eval-mteb,1719552006,1719554684,finished,1719552030,1719554684,A100-SXM4-80GB,8,1,64,448,24,2654
92652508-28ce-4081-8f53-1ad09864944f,geo-cpt-1-8B,1719552265,1719552447,finished,1719552336,1719552447,A100-SXM4-80GB,8,2,64,896,71,111
24ab9c73-2a89-47c2-8118-ae3d4bd7d84a,geo-llamapro-1-5B,1719552669,1719552935,finished,1719552737,1719552935,A100-SXM4-80GB,8,4,64,448,68,198
f9da117b-0848-4211-94ad-a732384f5aa3,geo-cpt-1-8B,1719553002,1719553184,finished,1719553049,1719553184,A100-SXM4-80GB,8,2,64,896,47,135
4947bc3f-a7ad-445b-af64-661b62959ee8,reranker-base,1719553090,1719726067,finished,1719553112,1719726067,A100-SXM4-80GB,8,1,64,896,22,172955
10d89b22-3024-4a74-ab68-034ea82dd2b4,geo-llamapro-1-5B,1719553095,1719591284,finished,1719553232,1719591284,A100-SXM4-80GB,8,4,64,448,137,38052
34190c21-0419-4880-ba09-5e28625ede81,geo-72B-test,1719553477,1719584116,finished,1719582996,1719584116,A100-SXM4-80GB,8,2,64,896,29519,1120
347fb3d3-d524-4d40-808e-a5106cd56b87,intent-train-llm-gpt,1719553718,1719554977,finished,1719553742,1719554977,A100-SXM4-80GB,8,1,64,448,24,1235
7f1e4cc8-7687-4959-a60e-8d5de94d8074,lzk-qwen15-7b-scihub-abstract-cpt-patch,1719553756,1719555896,finished,1719555814,1719555896,A100-SXM4-80GB,8,1,64,448,2058,82
2e3fda94-0f7e-41d5-9100-c9f63742ade5,lzk-qwen15-7b-scihub-abstract-scpt,1719553756,1719555793,finished,1719555543,1719555793,A100-SXM4-80GB,8,1,64,448,1787,250
e97988db-82e6-465c-8064-dbb3a0504716,megatron-gpt-2nodes,1719553786,1719555651,finished,1719553892,1719555651,A100-SXM4-80GB,8,16,64,448,106,1759
9168cf47-a409-4f09-af66-ba82c7b4e810,geogpt-lxz-sft-magpie-qwen2-pro-2ep-72b,1719553833,1719563661,finished,1719563406,1719563661,A100-SXM4-80GB,8,16,64,448,9573,255
cedc07df-e3e3-4ffe-8c2d-0068cecc4fb0,q72b-chat-0612dpo-vec-w37-a9aba-auto,1719553880,1719567235,finished,1719555558,1719567235,A100-SXM4-80GB,8,1,64,448,1678,11677
4059ce55-8468-4807-b377-d613229cd4e8,qwen2-72b-10-8bcpt2ep-sft1ep-34e26-auto,1719554301,1719567675,finished,1719555539,1719567675,A100-SXM4-80GB,8,1,64,448,1238,12136
bd368137-1723-44c6-a026-4976ed093fee,txchen-train-task2,1719554581,1719556371,finished,1719556225,1719556371,A100-SXM4-80GB,8,1,64,448,1644,146
2f78c344-e99d-475b-b9e5-c1c341bdc9f8,commonbench-base-vllm,1719554848,1719559847,finished,1719555542,1719559847,A100-SXM4-80GB,8,1,64,448,694,4305
b2a77581-d83d-4e86-90fd-a446372dba1b,Llama-3-70B-f52e9-auto,1719554943,1719591343,finished,1719555563,1719591343,A100-SXM4-80GB,8,1,64,448,620,35780
5d1fa700-b66f-4085-b56a-28b98e64893d,intent-train-llm-gpt,1719555346,1719557134,finished,1719555551,1719557134,A100-SXM4-80GB,8,1,64,448,205,1583
dfb01f23-00a6-4a8d-a309-f748672429bc,megatron-gpt-2nodes,1719555775,1719566007,finished,1719563727,1719566007,A100-SXM4-80GB,8,16,64,448,7952,2280
9736ca41-fa1e-4edd-b879-7100b50a1ec4,lzk-qwen15-7b-scihub-abstract-scpt,1719555793,1719592650,finished,1719555917,1719592650,A100-SXM4-80GB,8,1,64,448,124,36733
a73f3639-f37e-471d-8ff4-6cafe68f790d,qwen2-72b-10-8bcpt2ep-sft1ep-860b6-auto,1719556221,1719560073,finished,1719556242,1719560073,A100-SXM4-80GB,8,1,64,448,21,3831
6cf178b4-3d70-4672-97df-3273d5106f20,llm-trainer,1719556310,1719559071,finished,1719557130,1719559071,A100-SXM4-80GB,8,1,64,448,820,1941
ccc40a77-fa6c-4876-8bbc-9f77c407afbb,test,1719556418,1719560868,finished,1719557151,1719560868,A100-SXM4-80GB,8,1,64,896,733,3717
8cd116c8-7f7c-4619-a1ee-29fbd3798640,sfr-eval-mteb,1719557549,1719558529,finished,1719557717,1719558529,A100-SXM4-80GB,8,1,64,448,168,812
3fa410c7-7c3b-4b23-a770-211256d498d1,qwen7b-total-cpt-lr-2e-5-e1-b1d58-auto,1719558189,1719559890,finished,1719558211,1719559890,A100-SXM4-80GB,8,1,64,448,22,1679
283fe328-3231-4eaf-97b6-600bc1bc8ceb,intent-test-llm-all,1719558510,1719559262,finished,1719558531,1719559262,A100-SXM4-80GB,8,1,64,448,21,731
b6524bff-06df-4dbd-b973-18d44a3307b5,sfr-eval-mteb,1719558760,1719563236,finished,1719558780,1719563236,A100-SXM4-80GB,8,1,64,448,20,4456
2d266b19-6fae-46da-baa1-006458e5fc43,geo-base-offline-eval,1719558952,1719563636,finished,1719558973,1719563636,A100-SXM4-80GB,8,1,64,448,21,4663
50cff702-3277-4145-9551-abe9015163fd,qwen2-72b-10-8bcpt2ep-sft1ep,1719559439,1719733093,finished,1719559462,1719733093,A100-SXM4-80GB,8,1,64,448,23,173631
91822de5-78bb-4fcd-9526-ed29b7319e1f,rag-rank,1719559745,1719564166,finished,1719559767,1719564166,A100-SXM4-80GB,8,1,64,448,22,4399
c8ac607c-0869-4254-b6f5-686db4cc3130,rag-rank,1719559897,1719565775,finished,1719559918,1719565775,A100-SXM4-80GB,8,1,64,448,21,5857
2ce94cfb-66e4-4e7d-9d24-204699a2b5ab,geo-base-offline-eval2,1719560277,1719567652,finished,1719560299,1719567652,A100-SXM4-80GB,8,1,64,448,22,7353
e5fcc01a-a35b-4c33-a644-37e4f8c34795,reranker2-inference,1719560539,1719733638,finished,1719560560,1719733638,A100-SXM4-80GB,8,1,64,448,21,173078
5edb8532-3f3a-4d08-82f5-d1f2633c5882,qwen1-5-14b-42bcpt-5b119-auto,1719560696,1719561443,finished,1719560717,1719561443,A100-SXM4-80GB,8,1,64,448,21,726
0e9a8514-c888-4559-a1d4-bcb5e5c71d17,qwen1-5-14b-40bcpt-fc4f8-auto,1719560717,1719561757,finished,1719560863,1719561757,A100-SXM4-80GB,8,1,64,448,146,894
531a2b96-940f-41b7-8509-86bb1675be48,lzk-qwen15-7b-scihub-abstract-cpt-patch,1719560719,1719560947,finished,1719560883,1719560947,A100-SXM4-80GB,8,1,64,448,164,64
7210c68c-ed3a-4a05-ad87-259582178a84,intent-test-llm-all,1719561079,1719562115,finished,1719561099,1719562115,A100-SXM4-80GB,8,1,64,448,20,1016
64bd193b-c805-423e-a86c-27b71c092a6d,lzk-qwen15-7b-scihub-abstract-cpt-patch,1719561277,1719561966,finished,1719561465,1719561966,A100-SXM4-80GB,8,1,64,448,188,501
47d7ed07-f534-4146-ae6b-4d4373385c05,commonbench-base-vllm,1719561339,1719608447,finished,1719561443,1719608447,A100-SXM4-80GB,8,1,64,448,104,47004
011597ce-fa96-4d26-a041-fa2a793b5e2f,geo-table-datav05-lora-5e-5,1719561454,1719648971,finished,1719561475,1719648971,A100-SXM4-80GB,8,1,64,448,21,87496
fcf6b994-44e4-4c8e-bc05-b4c5aeb28bb0,lzk-qwen15-7b-scihub-abstract-cpt-patch,1719561966,1719584704,finished,1719583464,1719584704,A100-SXM4-80GB,8,1,64,448,21498,1240
3e2fcae2-73da-4c2e-be12-c556b754d429,txchen-train-task2,1719561966,1719566831,finished,1719562088,1719566831,A100-SXM4-80GB,8,1,64,448,122,4743
ddf61b40-2f61-46dd-8c15-3a832bd5c5da,easy-context-llama3-copy,1719562240,1719564424,finished,1719563468,1719564424,A100-SXM4-80GB,8,12,64,448,1228,956
139215f3-0cce-4a03-8ad3-bd37043f7cc9,easy-context-llama3-8m,1719562261,1719562714,finished,1719562302,1719562714,A100-SXM4-80GB,8,8,64,448,41,412
19ada917-3693-4b90-81f9-f3f1b50c0dd2,easycontext-debug-2nodes,1719563196,1719563694,finished,1719563257,1719563694,A100-SXM4-80GB,8,2,64,448,61,437
c94b70f8-c83e-426b-9b17-92e9c2702e67,sfr-eval-mteb,1719563237,1719563467,finished,1719563257,1719563467,A100-SXM4-80GB,8,1,64,448,20,210
6eeafcfa-6c99-4aa8-a31b-57839d5fe219,sfr-eval-mteb,1719563467,1719563955,finished,1719563492,1719563955,A100-SXM4-80GB,8,1,64,448,25,463
145a7eaa-2955-4e43-9093-0a9fd33f77f0,geogpt-btx-2x14b-sf4,1719563661,1719636769,finished,1719563702,1719636769,A100-SXM4-80GB,8,16,64,896,41,73067
b4221568-ea39-4f88-b427-5d9c7ef961ac,easycontext-debug-2nodes,1719563694,1719566470,finished,1719564445,1719566470,A100-SXM4-80GB,8,4,64,448,751,2025
1012e1fa-8988-405e-8d72-1f3d25f200ee,geogpt-lxz-sft-magpie-qwen2-pro-2ep-72b,1719563743,1719567389,finished,1719567120,1719567389,A100-SXM4-80GB,8,16,64,448,3377,269
f11a0360-ae39-4932-bc93-4f28493eb932,qwen-72b-test,1719564032,1719639415,finished,1719564055,1719639415,A100-SXM4-40GB,8,1,32,320,23,75360
3a3dc948-3646-4640-b355-b00f49d59c70,easy-context-llama3-copy,1719564424,1719567114,finished,1719566085,1719567114,A100-SXM4-80GB,8,8,64,448,1661,1029
6c1c22e9-524e-4eaa-8831-1a6b3b69c173,ls2,1719564941,1719573327,finished,1719566027,1719573327,A100-SXM4-80GB,8,1,64,896,1086,7300
9674360e-0d80-4249-8008-67f98d6482a3,geogpt-eval-deductive,1719565764,1719566097,finished,1719566017,1719566097,A100-SXM4-80GB,8,1,64,896,253,80
d4b161c1-8b4f-4616-8d8c-b46ab20b8347,megatron-gpt-2nodes,1719566007,1719796448,finished,1719567971,1719796448,A100-SXM4-80GB,8,16,64,448,1964,228477
8f3513e4-0d8d-496d-b27d-220fb6f1dab4,reranker-inference,1719566065,1719739036,finished,1719566084,1719739036,A100-SXM4-80GB,8,1,64,448,19,172952
924dfbd5-7e5f-420a-accc-897ca0e70903,reranker-inference11,1719566184,1719566298,finished,1719566203,1719566298,A100-SXM4-80GB,8,1,64,448,19,95
93ab0ace-332f-4462-8504-abebee33624c,paly-qwen2-7b-sft,1719566233,1719567600,finished,1719566251,1719567600,A100-SXM4-80GB,8,1,64,896,18,1349
b3e9fe9b-e055-4762-b058-2fdbb9d13405,geogpt-eval-deductive,1719566327,1719566636,finished,1719566346,1719566636,A100-SXM4-80GB,8,1,64,896,19,290
5efead81-f40e-4cd2-80eb-e4a96cba6d10,reranker-inference11,1719566452,1719739423,finished,1719566470,1719739423,A100-SXM4-80GB,8,1,64,448,18,172953
9a1d4253-ee7f-4379-a13f-89c351a879a2,geo-seesaw-ssft-head-ablation-7b-code,1719566477,1719572003,finished,1719566842,1719572003,A100-SXM4-80GB,8,1,64,896,365,5161
ab6728f6-15d1-42bd-961e-be1c773e4c0f,sfr-eval-mteb,1719566587,1719786867,finished,1719566607,1719786867,A100-SXM4-80GB,8,1,64,448,20,220260
ce039750-52c3-4aa9-b176-39d9d9624b3c,geogpt-eval-deductive,1719566636,1719566828,finished,1719566656,1719566828,A100-SXM4-80GB,8,1,64,896,20,172
6c688555-a863-4918-a458-f977d1c576db,test,1719566682,1719567110,finished,1719566702,1719567110,A100-SXM4-80GB,8,1,64,448,20,408
98ef6fee-d56d-49c5-8060-2a02b713e7ab,sfr-synthetize-data,1719566722,1719567159,finished,1719566742,1719567159,A100-SXM4-80GB,8,1,64,448,20,417
4f88bbc3-1701-4e52-a14f-7dce5e413353,geogpt-eval-deductive,1719566962,1719567101,finished,1719566980,1719567101,A100-SXM4-80GB,8,1,64,896,18,121
cef0d3fe-a0af-4491-b264-79e427a5de20,geogpt-dynamic-fewshot-generation,1719567075,1719583436,finished,1719567764,1719583436,A100-SXM4-80GB,8,1,64,896,689,15672
ff4f4b5d-095a-4d11-8ae3-cb76d1ef56a4,easycontext4debug,1719567113,1719567893,finished,1719567177,1719567893,A100-SXM4-80GB,8,12,64,448,64,716
750c17d5-f9a3-4119-8e7f-25773cf19af9,qwen1-5-7b-chat-c8fb7-auto,1719567148,1719568333,finished,1719567372,1719568333,A100-SXM4-80GB,8,1,64,448,224,961
41741988-0fd1-46b2-830f-92b5b983bef3,llama3-70b-v11-0628-dpo,1719567216,1719582962,finished,1719567951,1719582962,A100-SXM4-80GB,8,16,64,448,735,15011
3fd98c18-6819-440c-bf21-7196a70600d5,qwen2-72b-v13-0628-dpo,1719567283,1719574026,finished,1719567947,1719574026,A100-SXM4-80GB,8,16,64,448,664,6079
ea8c421f-16d2-4e9e-bf1e-349fe923d519,test,1719567339,1719568430,finished,1719567381,1719568430,A100-SXM4-80GB,8,1,64,448,42,1049
83791945-ad79-42ba-9584-ab00a633a549,geogpt-mixtral-eval,1719567900,1719649048,finished,1719567921,1719649048,A100-SXM4-80GB,8,1,64,896,21,81127
f761dfc6-700e-4404-af49-65610e1cf73b,llama3-10bcpt-sft2ep-fix-9b29c-auto,1719567903,1719571978,finished,1719567923,1719571978,A100-SXM4-80GB,8,1,64,448,20,4055
c8e3cbf2-0640-4a94-bdcc-a8a5504f8a49,easycontext4debug,1719567978,1719610760,finished,1719587597,1719610760,A100-SXM4-80GB,8,12,64,448,19619,23163
0c0440e0-a066-474c-8109-af22f3880ca0,llama3-sft,1719567993,1719630813,finished,1719582944,1719630813,A100-SXM4-80GB,8,1,64,448,14951,47869
8ca7b17f-2305-4a4a-b598-5ce7c79ef451,geogpt-eval-deductive,1719568502,1719583169,finished,1719582945,1719583169,A100-SXM4-80GB,8,1,64,896,14443,224
6b5b3e88-0cbb-40a0-9e97-346b5d9c2f37,llama3-70b-10bcpt-sft2ep-fix-4d35c-auto,1719576493,1719585205,finished,1719582944,1719585205,A100-SXM4-80GB,8,1,64,448,6451,2261
0a787396-7c52-477e-b3d0-13b65b578c41,geogpt-lxz-sft-magpie-llama3-pro-2ep-72b,1719576653,1719588287,finished,1719587579,1719588287,A100-SXM4-80GB,8,16,64,448,10926,708
be84cd72-8838-402c-b4ee-4c9a9f47f0bd,geogpt-mixtral-eval-common,1719581403,1719662748,finished,1719582942,1719662748,A100-SXM4-80GB,8,1,64,896,1539,79806
7dc4e28c-228b-4d53-8e94-4405fbbdb37a,geogpt-dynamic-fewshot-generation-cw-01,1719583718,1719607240,finished,1719584134,1719607240,A100-SXM4-80GB,8,1,64,896,416,23106
e64fcdde-04d9-4b95-b7b1-c7c486ca9b90,geogpt-dynamic-fewshot-generation-cw-02,1719583739,1719607723,finished,1719584715,1719607723,A100-SXM4-80GB,8,1,64,896,976,23008
288dc84b-6c0f-4f30-94f2-b1430f7f3320,geogpt-dynamic-fewshot-generation-cw-03,1719583778,1719607561,finished,1719584134,1719607561,A100-SXM4-80GB,8,1,64,896,356,23427
a204d03e-21ed-4400-8569-dd18279a68c5,test-sft-xiaodian,1719584783,1719590025,finished,1719584802,1719590025,A100-SXM4-80GB,8,1,64,896,19,5223
b3d0554c-0082-4b81-89d5-25b884d06001,test-sft-xiaodian1,1719585119,1719585789,finished,1719585138,1719585789,A100-SXM4-80GB,8,1,64,448,19,651
ec805a7e-92e2-4866-b6c9-0f093009b568,easycontext-debug-2nodes,1719586900,1719587479,finished,1719586960,1719587479,A100-SXM4-80GB,8,2,64,448,60,519
ad42fcd6-6af3-4183-8784-310528c398ff,geogpt-eval-deductive,1719588328,1719588553,finished,1719588347,1719588553,A100-SXM4-80GB,8,1,64,896,19,206
69b25def-320f-46fe-96dc-42b1089917d6,geogpt-eval-deductive,1719588553,1719588745,finished,1719588572,1719588745,A100-SXM4-80GB,8,1,64,896,19,173
11ba6580-1d8e-4fac-b669-a47aebb68ed2,geogpt-eval-deductive,1719588745,1719588892,finished,1719588763,1719588892,A100-SXM4-80GB,8,1,64,896,18,129
4f0fbda9-98d2-40ca-9c37-690cb1055a3a,geogpt-eval-deductive,1719589098,1719589286,finished,1719589117,1719589286,A100-SXM4-80GB,8,1,64,896,19,169
b53af802-01fb-45c3-abf8-b1a75eb0be09,qwen2-72b-instruct-judge,1719589194,1719803732,finished,1719589213,1719803732,A100-SXM4-40GB,8,1,32,320,19,214519
f6125208-8242-46d4-8711-592699bf79e0,Qwen2-72B-Instruct-9d894-auto,1719589250,1719591344,finished,1719589271,1719591344,A100-SXM4-80GB,8,1,64,448,21,2073
3e836aa9-e15e-44da-ad2b-418b138442b7,geogpt-0612-merge-w37,1719589474,1719678159,finished,1719589493,1719678159,A100-SXM4-80GB,8,1,64,448,19,88666
085bd0d7-6182-495c-a064-7e1ed0a8e616,geogpt-0612,1719589549,1719623370,finished,1719589570,1719623370,A100-SXM4-80GB,8,1,64,448,21,33800
03e7402a-d2a5-4050-86d5-c402316842ae,geogpt-72b-1215,1719589718,1719623273,finished,1719589738,1719623273,A100-SXM4-80GB,8,1,64,448,20,33535
ba219027-4afb-4994-b1c9-8d743ca0191f,geogpt-72b-0206,1719589757,1719623273,finished,1719589777,1719623273,A100-SXM4-80GB,8,1,64,448,20,33496
7641724b-6403-4dbf-ac88-bb7a9a429303,geogpt-eval-deductive,1719589925,1719590265,finished,1719590037,1719590265,A100-SXM4-80GB,8,1,64,896,112,228
9ac194eb-99a6-4bdf-bd41-0517a00cf29b,geogpt-eval-deductive,1719590924,1719639743,finished,1719590944,1719639743,A100-SXM4-80GB,8,1,64,896,20,48799
830c14b0-3b6d-4668-89e5-22ac9e2bbe06,easy-context-llama3-copy,1719591196,1719619001,finished,1719606808,1719619001,A100-SXM4-80GB,8,16,64,448,15612,12193
3cc32e3e-ebb8-4dcf-8796-f3156210c967,easycontext-debug-14nodes,1719591198,1719606767,finished,1719606329,1719606767,A100-SXM4-80GB,8,14,64,448,15131,438
994a7948-bf75-4a2c-bb7f-711896c43a8a,geo-cpt-1-8B,1719591211,1719667079,finished,1719609968,1719667079,A100-SXM4-80GB,8,2,64,896,18757,57111
dc1bdba0-a88a-4c2a-8a28-242c7b9e9a91,geo-72B-test,1719591214,1719616269,finished,1719615130,1719616269,A100-SXM4-80GB,8,2,64,896,23916,1139
ec04e3ca-70ca-41b8-967a-120818129374,geo-cpt-1-5B,1719591216,1719667097,finished,1719616331,1719667097,A100-SXM4-80GB,8,2,64,896,25115,50766
73b4bc67-a3e7-4eb1-8107-de2d3ff755c3,geo-cpt-1-5B-geo-common,1719591218,1719667097,finished,1719606339,1719667097,A100-SXM4-80GB,8,2,64,896,15121,60758
5d7b5a3c-70cc-475e-8358-386c9b2482dc,geo-cpt-05B-geo-common,1719591220,1719668848,finished,1719591356,1719668848,A100-SXM4-80GB,8,2,64,896,136,77492
bddddf92-7dcc-4f93-94ca-570f79814115,geogpt-dynamic-fewshot-generation-cw-04,1719591223,1719621437,finished,1719598541,1719621437,A100-SXM4-80GB,8,1,64,896,7318,22896
0ee5e734-e232-4394-806c-77b353c77eee,geogpt-lxz-sft-magpie-qwen2-pro-2ep-72b,1719591228,1719606648,finished,1719606361,1719606648,A100-SXM4-80GB,8,16,64,448,15133,287
47cf514c-0fe5-492f-b82f-7f41b661d6ea,geogpt-72b-0412,1719591242,1719623273,finished,1719591268,1719623273,A100-SXM4-80GB,8,1,64,448,26,32005
1f5aaf22-9130-4cdb-bef8-16f88a78d7c0,lzk-qwen15-7b-scihub-abstract-cpt-patch,1719591248,1719592732,finished,1719591323,1719592732,A100-SXM4-80GB,8,1,64,448,75,1409
e999ea02-3277-49c0-b23e-41fb43ec6a3a,txchen-lm-eval2,1719591271,1719615097,finished,1719607269,1719615097,A100-SXM4-80GB,8,1,64,448,15998,7828
1bc5c820-7d9c-43a2-860e-46efc505865f,geogpt-110b-0521,1719591320,1719623252,finished,1719591365,1719623252,A100-SXM4-80GB,8,1,64,448,45,31887
bccace11-81ad-427a-bb00-1f9371a2acc7,lzk-qwen15-7b-scihub-abstract-cpt-patch,1719592732,1719594207,finished,1719592752,1719594207,A100-SXM4-80GB,8,1,64,448,20,1455
35475d70-c7d2-4d4b-9fcb-fcda940557cc,test,1719594009,1719595077,finished,1719594213,1719595077,A100-SXM4-80GB,8,1,64,448,204,864
ff468b34-219b-457b-ba2a-760d8a23b24f,lzk-qwen15-7b-scihub-abstract-cpt-patch,1719594207,1719609891,finished,1719607590,1719609891,A100-SXM4-80GB,8,1,64,448,13383,2301
1f9be21f-cf21-4988-9d4a-23b30029a98f,lzk-qwen15-7b-scihub-abstract-scpt,1719594331,1719634142,finished,1719595072,1719634142,A100-SXM4-80GB,8,1,64,448,741,39070
4d0af719-16dc-4de6-9cd7-195f3e0b8c42,geo-seesaw-ssft-head-ablation-7b-code,1719595145,1719668076,finished,1719597911,1719668076,A100-SXM4-80GB,8,1,64,896,2766,70165
a35fb629-f64d-4c59-a990-c69ee540ad0d,test,1719595909,1719598555,finished,1719597927,1719598555,A100-SXM4-80GB,8,1,64,448,2018,628
98bd74a1-970f-49e3-90c2-d790017f8fe7,geogpt-lxz-sft-magpie-qwen2-pro-2ep-72b,1719606711,1719609472,finished,1719609285,1719609472,A100-SXM4-80GB,8,16,64,448,2574,187
c3ab1f36-5a1b-49e0-bbe4-0c62519d14aa,geogpt-lxz-sft-magpie-qwen2-pro-2ep-72b,1719609536,1719609800,finished,1719609615,1719609800,A100-SXM4-80GB,8,16,64,448,79,185
a84f5049-af20-4d27-928c-da237ba22d16,geogpt-lxz-sft-magpie-qwen2-pro-2ep-72b,1719609864,1719610111,finished,1719609924,1719610111,A100-SXM4-80GB,8,16,64,448,60,187
86d6854a-2332-4b0f-a4ed-9789ddd9c15f,geogpt-lxz-sft-magpie-qwen2-pro-2ep-72b,1719610176,1719611037,finished,1719610786,1719611037,A100-SXM4-80GB,8,16,64,448,610,251
2ebe57d6-3326-44bf-a5cd-9f9137e781fc,geogpt-lxz-sft-magpie-qwen2-pro-2ep-72b,1719611099,1719611345,finished,1719611159,1719611345,A100-SXM4-80GB,8,16,64,448,60,186
19d304fe-9564-4b41-a6e8-fd7d5509a3f2,geogpt-lxz-sft-magpie-qwen2-pro-2ep-72b,1719611410,1719611658,finished,1719611470,1719611658,A100-SXM4-80GB,8,16,64,448,60,188
87c8185c-ad59-4605-b627-bf2cd4fc36d3,geogpt-lxz-sft-magpie-qwen2-pro-2ep-72b,1719611722,1719612030,finished,1719611782,1719612030,A100-SXM4-80GB,8,16,64,448,60,248
4546b9df-97fb-4b18-b657-1f3ef82b0f9a,geogpt-lxz-sft-magpie-qwen2-pro-2ep-72b,1719612094,1719612342,finished,1719612154,1719612342,A100-SXM4-80GB,8,16,64,448,60,188
9afec6fe-7a28-4b75-919a-28e8936191a4,geogpt-lxz-sft-magpie-qwen2-pro-2ep-72b,1719612406,1719612632,finished,1719612447,1719612632,A100-SXM4-80GB,8,16,64,448,41,185
e35f624a-745f-41df-95fa-8fa003b645ac,geogpt-lxz-sft-magpie-qwen2-pro-2ep-72b,1719612696,1719612942,finished,1719612757,1719612942,A100-SXM4-80GB,8,16,64,448,61,185
e3d2fda6-f074-4868-bf13-dc340d2dd2e6,geogpt-lxz-sft-magpie-qwen2-pro-2ep-72b,1719613007,1719613257,finished,1719613069,1719613257,A100-SXM4-80GB,8,16,64,448,62,188
cac63420-ff53-4467-a1f7-41f372178cf2,gpt-megatron,1719613088,1719614300,finished,1719613269,1719614300,A100-SXM4-80GB,8,16,64,448,181,1031
f64ad82e-a7ef-4229-a5bc-c77479590882,geogpt-lxz-sft-magpie-qwen2-pro-2ep-72b,1719613333,1719614515,finished,1719614327,1719614515,A100-SXM4-80GB,8,16,64,448,994,188
f18455cf-5dce-495f-bce6-ba91447e7874,gpt-megatron,1719614366,1719614699,finished,1719614573,1719614699,A100-SXM4-80GB,8,16,64,448,207,126
840010c2-f255-4242-9a05-d7ec4fc83bae,geogpt-lxz-sft-magpie-qwen2-pro-2ep-72b,1719614586,1719614960,finished,1719614770,1719614960,A100-SXM4-80GB,8,16,64,448,184,190
96dcdcab-05b2-4be4-966f-eb25361a0d02,gpt-megatron,1719614831,1719667667,finished,1719615017,1719667667,A100-SXM4-80GB,8,16,64,448,186,52650
d9fa3b6a-3853-44cd-94bc-d00adebe12b1,geogpt-lxz-sft-magpie-qwen2-pro-2ep-72b,1719615030,1719619401,finished,1719619027,1719619401,A100-SXM4-80GB,8,16,64,448,3997,374
595f6d34-b325-46d9-81ac-0bda894ca6be,geo-72B-test,1719616373,1719617811,finished,1719616693,1719617811,A100-SXM4-80GB,8,2,64,896,320,1118
00e30623-0299-4acc-b30e-b37ff9ee2af4,geo-72B-test,1719617922,1719619113,finished,1719617982,1719619113,A100-SXM4-80GB,8,2,64,896,60,1131
f8d36346-c5d3-440d-acbe-0ece408c03b1,easy-context-llama3-copy,1719619001,1719621049,finished,1719619459,1719621049,A100-SXM4-80GB,8,16,64,448,458,1590
978462a4-a0fc-4d15-97a0-0e5d9e9f109f,easycontext-debug-2nodes,1719619047,1719619563,finished,1719619109,1719619563,A100-SXM4-80GB,8,2,64,448,62,454
86e0f19d-f8e6-488e-8435-b3affd396455,geo-72B-test,1719619216,1719620370,finished,1719619277,1719620370,A100-SXM4-80GB,8,2,64,896,61,1093
45ccaebf-27b1-40d4-81b9-0baae2c06f24,geogpt-lxz-sft-magpie-qwen2-pro-2ep-72b,1719619472,1719621399,finished,1719621095,1719621399,A100-SXM4-80GB,8,16,64,448,1623,304
fb97a2d7-2135-4d5f-8613-8377912a2ecc,easycontext-debug-2nodes,1719619745,1719620609,finished,1719619806,1719620609,A100-SXM4-80GB,8,2,64,448,61,803
47dc2cdc-ac36-4955-8087-1581357f4d0a,geo-72B-test,1719620472,1719621629,finished,1719620533,1719621629,A100-SXM4-80GB,8,2,64,896,61,1096
93f9831e-eda0-4859-8eb7-95780767b2ee,geogpt-lxz-sft-magpie-qwen2-pro-2ep-72b,1719621465,1719621901,finished,1719621525,1719621901,A100-SXM4-80GB,8,16,64,448,60,376
a3006f71-86b3-4c2f-aea0-ab378839eb1f,easycontext-debug-2nodes,1719621666,1719622692,finished,1719621730,1719622692,A100-SXM4-80GB,8,2,64,448,64,962
1219b85e-063c-4f18-8ef7-770e293af67e,geo-72B-test,1719621735,1719622886,finished,1719621796,1719622886,A100-SXM4-80GB,8,2,64,896,61,1090
7c3b5f3e-9c23-44ff-9d6f-5c50f6315837,geogpt-lxz-sft-magpie-qwen2-pro-2ep-72b,1719621966,1719622314,finished,1719622006,1719622314,A100-SXM4-80GB,8,16,64,448,40,308
b40b99dc-ef6c-42f6-b768-a9622656c5dd,geogpt-lxz-sft-magpie-qwen2-pro-2ep-72b,1719622379,1719622628,finished,1719622439,1719622628,A100-SXM4-80GB,8,16,64,448,60,189
bfe068f3-4d27-401c-9fbc-a081c00d80d5,easycontext-debug-2nodes,1719622693,1719623511,finished,1719622760,1719623511,A100-SXM4-80GB,8,2,64,448,67,751
ab61c692-3a8a-45f6-a734-0b09684970ab,geogpt-lxz-sft-magpie-qwen2-pro-2ep-72b,1719622699,1719623010,finished,1719622741,1719623010,A100-SXM4-80GB,8,16,64,448,42,269
c1e28daf-b973-4580-83f0-ba72f84f2b82,easy-context-llama3-copy,1719622714,1719633358,finished,1719623071,1719633358,A100-SXM4-80GB,8,12,64,448,357,10287
9d1d4456-2bb5-4f3f-9a9a-f8b0b3f5680f,geo-72B-test,1719622987,1719624087,finished,1719623030,1719624087,A100-SXM4-80GB,8,2,64,896,43,1057
cbde1a67-4b8b-4bad-a6ce-f54de4066a87,geo-base-offline-eval,1719623050,1719630087,finished,1719623079,1719630087,A100-SXM4-80GB,8,1,64,448,29,7008
0820902f-bebb-4deb-a6b5-1dfe1637e155,geogpt-lxz-sft-magpie-qwen2-pro-2ep-72b,1719623082,1719624187,finished,1719624107,1719624187,A100-SXM4-80GB,8,16,64,448,1025,80
fca3ae47-55e3-4021-a5a6-8d2a14fb0fa2,geogpt-lxz-sft-magpie-qwen2-pro-2ep-72b,1719624187,1719624411,finished,1719624232,1719624411,A100-SXM4-80GB,8,16,64,448,45,179
2ccb38aa-4dc6-4b33-aae8-64a3c6045f8c,geo-72B-test,1719624231,1719625416,finished,1719624294,1719625416,A100-SXM4-80GB,8,2,64,896,63,1122
dd72a834-dc55-452a-bb79-aff4ffde9388,geogpt-lxz-sft-magpie-qwen2-pro-2ep-72b,1719624473,1719624784,finished,1719624530,1719624784,A100-SXM4-80GB,8,16,64,448,57,254
b6f4bbaa-d63f-4812-a53a-eaf559a86b66,geogpt-lxz-sft-magpie-qwen2-pro-2ep-72b,1719624845,1719625081,finished,1719624884,1719625081,A100-SXM4-80GB,8,16,64,448,39,197
53676b6c-bb78-41ef-bfaa-ae9426fa9b69,geogpt-lxz-sft-magpie-qwen2-pro-2ep-72b,1719625143,1719625379,finished,1719625200,1719625379,A100-SXM4-80GB,8,16,64,448,57,179
e6b9e842-f3e6-4613-9c3a-91933747e9bd,geogpt-lxz-sft-magpie-qwen2-pro-2ep-72b,1719625442,1719625682,finished,1719625482,1719625682,A100-SXM4-80GB,8,16,64,448,40,200
d3a44b73-1880-4ee9-a702-4b7e74cec620,geo-72B-test,1719625526,1719626709,finished,1719625585,1719626709,A100-SXM4-80GB,8,2,64,896,59,1124
7d6b9bab-c747-4a38-9246-45e133dbb62b,geogpt-lxz-sft-magpie-qwen2-pro-2ep-72b,1719625744,1719626039,finished,1719625820,1719626039,A100-SXM4-80GB,8,16,64,448,76,219
1f3dbd11-52d7-4ae8-a752-827d0f6a48d2,easycontext-debug-14nodes,1719625880,1719626221,finished,1719626052,1719626221,A100-SXM4-80GB,8,14,64,448,172,169
5b6010c3-3ff2-4944-b5ba-2f6f1b6d0e67,geogpt-lxz-sft-magpie-qwen2-pro-2ep-72b,1719626106,1719626434,finished,1719626202,1719626434,A100-SXM4-80GB,8,16,64,448,96,232
2949cdf5-41d2-4965-874e-dfc5793b10be,geogpt-lxz-sft-magpie-qwen2-pro-2ep-72b,1719626496,1719626750,finished,1719626553,1719626750,A100-SXM4-80GB,8,16,64,448,57,197
3a55d7d0-5f3c-4937-b959-5b817d8f8d25,geo-72B-test,1719626812,1719627956,finished,1719626869,1719627956,A100-SXM4-80GB,8,2,64,896,57,1087
679afa1a-2c39-4b67-aa03-2903ded95157,geogpt-lxz-sft-magpie-qwen2-pro-2ep-72b,1719626814,1719627070,finished,1719626891,1719627070,A100-SXM4-80GB,8,16,64,448,77,179
5d436033-8b23-48c2-9494-cf8db20f6ee7,geogpt-lxz-sft-magpie-qwen2-pro-2ep-72b,1719627131,1719627385,finished,1719627188,1719627385,A100-SXM4-80GB,8,16,64,448,57,197
66b02881-f803-4567-af14-2549d05d7948,geogpt-lxz-sft-magpie-qwen2-pro-2ep-72b,1719627447,1719627678,finished,1719627503,1719627678,A100-SXM4-80GB,8,16,64,448,56,175
fa5c2dab-63c4-4a57-84ca-f0754f44cd13,geogpt-lxz-sft-magpie-qwen2-pro-2ep-72b,1719627742,1719627976,finished,1719627799,1719627976,A100-SXM4-80GB,8,16,64,448,57,177
e3acb8bb-66f3-4843-a906-842c30198187,test,1719627773,1719628431,finished,1719627791,1719628431,A100-SXM4-80GB,8,1,64,448,18,640
f9f6fa32-0e35-4729-a13f-de90862fc807,geogpt-lxz-sft-magpie-qwen2-pro-2ep-72b,1719628040,1719628294,finished,1719628099,1719628294,A100-SXM4-80GB,8,16,64,448,59,195
325150b4-36e1-4253-aaa9-b7c4c688bcf6,geo-72B-test,1719628058,1719629248,finished,1719628097,1719629248,A100-SXM4-80GB,8,2,64,896,39,1151
9be4cc3a-5f21-411b-bcca-d1cad4708028,geogpt-lxz-sft-magpie-qwen2-pro-2ep-72b,1719628355,1719628607,finished,1719628413,1719628607,A100-SXM4-80GB,8,16,64,448,58,194
886267c3-c8cb-45d0-9810-e61d088ecb2e,test,1719628661,1719629279,finished,1719628679,1719629279,A100-SXM4-80GB,8,1,64,448,18,600
b545757d-faef-4522-ad0d-50bb5909b58e,geogpt-lxz-sft-magpie-qwen2-pro-2ep-72b,1719628668,1719628898,finished,1719628724,1719628898,A100-SXM4-80GB,8,16,64,448,56,174
d237cbac-c5ca-4076-8303-d628c5480239,geogpt-lxz-sft-magpie-qwen2-pro-2ep-72b,1719628958,1719629211,finished,1719629034,1719629211,A100-SXM4-80GB,8,16,64,448,76,177
f175fbdf-9189-4afd-883b-3845e138c49e,geo-72B-test,1719629343,1719630504,finished,1719629400,1719630504,A100-SXM4-80GB,8,2,64,896,57,1104
9dcc545a-4fdd-4cd7-aadf-dca85ae434b6,test,1719629755,1719630384,finished,1719629774,1719630384,A100-SXM4-80GB,8,1,64,448,19,610
b2dcb1d8-012f-4290-b04c-c3e89cd84148,geogpt-lxz-sft-magpie-qwen2-pro-2ep-72b,1719629840,1719692797,finished,1719629883,1719692797,A100-SXM4-80GB,8,16,64,448,43,62914
7d19369b-e658-4223-ac4c-77e3851bfe0e,geogpt-lxz-sft-magpie-llama3-pro-2ep-72b,1719629864,1719686159,finished,1719629926,1719686159,A100-SXM4-80GB,8,16,64,448,62,56233
68ea3f9c-21fb-4fd3-860f-a2d45f1e0535,geogpt-qwen2-72b-10-8bcpt2ep-sft,1719630000,1719682255,finished,1719634287,1719682255,A100-SXM4-80GB,8,40,64,448,4287,47968
7e5c80e5-efd9-4987-99e7-c27a9d9a8413,slimorca-geo-mtm1-geotable-nt-14b,1719630372,1719716475,finished,1719630392,1719716475,A100-SXM4-80GB,8,1,64,448,20,86083
f8ca5bc2-996d-4d3d-b258-800ed375ce57,test,1719630480,1719631106,finished,1719630499,1719631106,A100-SXM4-80GB,8,1,64,448,19,607
4d9086e5-2aab-4ae7-8986-b5114dd7b440,geo-72B-test,1719630600,1719631730,finished,1719630657,1719631730,A100-SXM4-80GB,8,2,64,896,57,1073
bbac80bf-120a-448b-beb9-3d5be0c8a39a,test,1719631389,1719632036,finished,1719631412,1719632036,A100-SXM4-80GB,8,1,64,448,23,624
c8716529-ceb8-47b8-b86f-b2b56c4fd5c9,easycontext-debug-14nodes,1719631414,1719632356,finished,1719631489,1719632356,A100-SXM4-80GB,8,14,64,448,75,867
cd69541b-22b9-4ba4-8a0f-6cfcb2f55809,llama3-70b-0628-80746-auto,1719631560,1719635564,finished,1719631580,1719635564,A100-SXM4-80GB,8,1,64,448,20,3984
a4e26642-a8fd-480b-8cf5-6358ae06074c,slimorca-geo-mtm1-mt-wild-14b,1719631597,1719804893,finished,1719631616,1719804893,A100-SXM4-80GB,8,1,64,448,19,173277
14a9a507-6890-45e0-be67-499b8420863c,llama3-70b-0628-3104a-auto,1719631657,1719634024,finished,1719631677,1719634024,A100-SXM4-80GB,8,1,64,448,20,2347
00c4f608-ee19-4735-9926-d1a4797d2dc1,llama3-70b-0628-9e35a-auto,1719631735,1719643899,finished,1719631753,1719643899,A100-SXM4-80GB,8,1,64,448,18,12146
965477fc-3ea1-4bad-b5a7-a5e123a481e9,llama3-70b-0628-c745b-auto,1719631812,1719632831,finished,1719631833,1719632831,A100-SXM4-80GB,8,1,64,448,21,998
f423e7fb-a806-4ef6-b22d-272e4c82e8b4,geo-72B-test,1719631828,1719632939,finished,1719631904,1719632939,A100-SXM4-80GB,8,2,64,896,76,1035
20bd1c83-c697-41b9-87c5-ca22ddfb6013,lzk-qwen15-7b-scihub-abstract-cpt-patch,1719631972,1719632088,finished,1719631992,1719632088,A100-SXM4-80GB,8,1,64,448,20,96
fc835e6d-e37f-4d02-a453-ead3a539760e,lzk-qwen15-7b-scihub-abstract-cpt-patch,1719632325,1719633069,finished,1719632349,1719633069,A100-SXM4-80GB,8,1,64,448,24,720
e31e7d8a-44ab-4362-93d0-d8f7a8639589,easycontext4debug,1719632356,1719633824,finished,1719632433,1719633824,A100-SXM4-80GB,8,12,64,448,77,1391
dd6460c8-d8f7-41b7-a0e0-95b1e562bfbc,qwen7b-total-cpt-lr-2e-5-e2-205d3-auto,1719632814,1719634346,finished,1719632835,1719634346,A100-SXM4-80GB,8,1,64,448,21,1511
3172850a-69cd-4f33-a97f-453983a6a367,txchen-train-task,1719633009,1719644343,finished,1719633029,1719644343,A100-SXM4-80GB,8,1,64,448,20,11314
9fe15d77-392d-4779-af5a-cf8a913846ab,geo-72B-test,1719633040,1719634152,finished,1719633100,1719634152,A100-SXM4-80GB,8,2,64,896,60,1052
60f38ed6-fb6f-42d9-a6dc-efe4ec740eb8,txchen-train-task2,1719633109,1719634306,finished,1719634181,1719634306,A100-SXM4-80GB,8,1,64,448,1072,125
fe3fce9e-6d77-42da-a20e-836c9e1b11ee,llama3-cpt-extra-infer,1719633195,1719724459,finished,1719633215,1719724459,A100-SXM4-80GB,8,1,64,448,20,91244
005b25d5-dd97-402d-a6b0-8b48ae3bb6c1,lzk-qwen15-7b-scihub-abstract-cpt-patch,1719633269,1719638710,finished,1719634161,1719638710,A100-SXM4-80GB,8,1,64,448,892,4549
12bc5cce-c9d6-4bc4-8fe5-b157480182a0,easy-context-llama3-copy,1719633358,1719634257,finished,1719633865,1719634257,A100-SXM4-80GB,8,32,64,448,507,392
c26c8331-2894-4ee2-95b4-d59f4e6ecf1e,geogpt-7b-llamapro-sft-s2-gateonly,1719633887,1719667044,finished,1719633908,1719667044,A100-SXM4-80GB,8,1,64,448,21,33136
880a3983-c2a2-432f-84d4-0dd8628c30d1,geo-72B-test,1719634261,1719635460,finished,1719634337,1719635460,A100-SXM4-80GB,8,2,64,896,76,1123
3538dd31-259d-41b9-8d1d-e52a28428516,easycontext4debug,1719635359,1719683379,finished,1719682267,1719683379,A100-SXM4-80GB,8,40,64,448,46908,1112
ff6aa072-5a16-4a1c-bd97-21434c9d2908,geo-72B-test,1719635558,1719636747,finished,1719635617,1719636747,A100-SXM4-80GB,8,2,64,896,59,1130
3e8c99f7-6244-4e6c-ac7b-e1e104852743,test,1719636132,1719637128,finished,1719636151,1719637128,A100-SXM4-80GB,8,1,64,448,19,977
a23c323d-2564-4d15-ac98-6a541796f112,lzk-qwen15-7b-scihub-abstract-scpt,1719636300,1719757901,finished,1719636320,1719757901,A100-SXM4-80GB,8,1,64,448,20,121581
ec8faf40-e05c-4329-b1ab-43082d1cba45,geo-72B-test,1719636845,1719637972,finished,1719636923,1719637972,A100-SXM4-80GB,8,2,64,896,78,1049
79a029dc-c8a2-47e6-b732-71f7131a4f62,test,1719637206,1719637869,finished,1719637224,1719637869,A100-SXM4-80GB,8,1,64,448,18,645
c2a6e593-5885-47c6-984e-b64292af24da,data-gen-magpie,1719637916,1719650063,finished,1719637935,1719650063,A100-SXM4-80GB,8,1,64,448,19,12128
e2c06db5-4b1f-4a31-a19c-ea09ab4d5734,geo-72B-test,1719638069,1719639257,finished,1719638147,1719639257,A100-SXM4-80GB,8,2,64,896,78,1110
78da1b03-72dd-49a5-a11d-9db72b73fe3e,test,1719638484,1719639601,finished,1719638503,1719639601,A100-SXM4-80GB,8,1,64,448,19,1098
7543595f-aa25-4577-9e32-a5939c5c448a,lzk-qwen15-7b-scihub-abstract-cpt-patch,1719638710,1719644017,finished,1719638729,1719644017,A100-SXM4-80GB,8,1,64,448,19,5288
121ac488-c307-4b3d-911a-fa5d11943149,geo-72B-test,1719639357,1719640514,finished,1719639417,1719640514,A100-SXM4-80GB,8,2,64,896,60,1097
38361f75-de94-431a-b791-0fa32f840c1e,qwen-72b-test,1719639435,1719639981,finished,1719639454,1719639981,A100-SXM4-80GB,8,1,64,448,19,527
d6adfaca-4366-4e26-9def-ccd8d704fa36,qwen-72b-test,1719639454,1719639961,finished,1719639473,1719639961,A100-SXM4-40GB,8,1,32,320,19,488
bf38a8f5-958b-4aa4-8ff8-0901110f4220,qwen-72b-test,1719640039,1719805103,finished,1719640061,1719805103,A100-SXM4-80GB,8,1,64,448,22,165042
681febdc-7b64-4f56-ad74-811dd98f6397,qwen-72b-test,1719640042,1719640512,finished,1719640061,1719640512,A100-SXM4-40GB,8,1,32,320,19,451
ea8fb3e1-e860-44ee-9e71-9d56bbfbde5c,test,1719640187,1719641392,finished,1719640206,1719641392,A100-SXM4-80GB,8,1,64,448,19,1186
23264d24-130d-4dde-bc73-76c7db0478f2,qwen-72b-test,1719640551,1719800605,finished,1719640573,1719800605,A100-SXM4-40GB,8,1,32,320,22,160032
ae2c37e8-d061-4ff5-9957-df933da40d83,geo-72B-test,1719640616,1719641736,finished,1719640674,1719641736,A100-SXM4-80GB,8,2,64,896,58,1062
3722b57f-e893-4fb4-95c1-c8adfe6f9a83,data-gen-magpie-3,1719640986,1719726400,finished,1719641006,1719726400,A100-SXM4-80GB,8,1,64,448,20,85394
2d8b196b-46e6-4b3f-a3a9-46ba14b11380,geo-72B-test,1719641831,1719642997,finished,1719641888,1719642997,A100-SXM4-80GB,8,2,64,896,57,1109
048a06e0-985b-40b0-978c-834d93a6893b,test,1719641941,1719643206,finished,1719641960,1719643206,A100-SXM4-80GB,8,1,64,448,19,1246
8b3b4a81-53d8-4806-9c1d-99cbfe683446,slimorca-geo-mtm1-funcfil2-14b,1719642902,1719816243,finished,1719642921,1719816243,A100-SXM4-80GB,8,1,64,448,19,173322
c785ff59-47bf-4a03-9076-76ca876f2151,geo-72B-test,1719643097,1719644179,finished,1719643136,1719644179,A100-SXM4-80GB,8,2,64,896,39,1043
2edfd905-f399-4d60-87b9-2d6a2530835d,test,1719643455,1719747117,finished,1719643473,1719747117,A100-SXM4-80GB,8,1,64,896,18,103644
17c907b8-9587-461e-b347-b28e9b5c97ba,lzk-qwen15-7b-scihub-abstract-cpt-patch,1719644017,1719651674,finished,1719644036,1719651674,A100-SXM4-80GB,8,1,64,448,19,7638
da1fc293-e0cf-429a-9546-bd21defb482d,geo-72B-test,1719644276,1719645464,finished,1719644354,1719645464,A100-SXM4-80GB,8,2,64,896,78,1110
965814af-efe8-456f-bbd5-e4f8ac865a4d,txchen-train-task,1719644344,1719645472,finished,1719644364,1719645472,A100-SXM4-80GB,8,1,64,448,20,1108
c8fa019c-5efe-469e-ad54-e3ea28500a38,txchen-train-task,1719645472,1719646692,finished,1719645531,1719646692,A100-SXM4-80GB,8,2,64,448,59,1161
e650e25b-3764-4842-a1e1-841e6d7ecd79,geo-72B-test,1719645562,1719647390,finished,1719646366,1719647390,A100-SXM4-80GB,8,2,64,896,804,1024
d5228bc2-ac57-4614-bbb2-b9af1c69322f,txchen-train-task,1719646692,1719681461,finished,1719646711,1719681461,A100-SXM4-80GB,8,1,64,448,19,34750
6b0f1094-8b80-467d-8f19-d6ee8e128169,txchen-eval,1719647194,1719647437,finished,1719647213,1719647437,A100-SXM4-80GB,8,1,64,448,19,224
3714b7eb-88d7-48f8-8171-f7e07d6b3bfb,geo-72B-test,1719647503,1719648670,finished,1719647560,1719648670,A100-SXM4-80GB,8,2,64,896,57,1110
81389f56-2613-44d3-bc08-8540f3ddae78,geo-72B-test,1719648767,1719649856,finished,1719648823,1719649856,A100-SXM4-80GB,8,2,64,896,56,1033
52681285-1ba4-4b8b-8850-ac8a0fae90f2,geo-72B-test,1719649969,1719651126,finished,1719650006,1719651126,A100-SXM4-80GB,8,2,64,896,37,1120
3aa19307-1b19-49cd-9402-c3a9cf9e4e96,geo-72B-test,1719651239,1719652380,finished,1719651296,1719652380,A100-SXM4-80GB,8,2,64,896,57,1084
2a1719b8-2ca4-48d9-8494-f51a59fce6da,lzk-qwen15-7b-scihub-abstract-cpt-patch,1719651674,1719805179,finished,1719651693,1719805179,A100-SXM4-80GB,8,1,64,448,19,153486
a44d04c1-9f07-43e4-88ca-22bf95cc2d36,geogpt-moe-sr12-ep1-mlp-5,1719651723,1719670799,finished,1719651743,1719670799,A100-SXM4-80GB,8,1,64,896,20,19056
9cf22d2c-4c0e-4058-9660-b80c953d1131,geo-72B-test,1719652475,1719653615,finished,1719652530,1719653615,A100-SXM4-80GB,8,2,64,896,55,1085
e1a5b86a-d37c-4f97-8565-2d92408a0cd2,geo-72B-test,1719653709,1719654803,finished,1719653746,1719654803,A100-SXM4-80GB,8,2,64,896,37,1057
4c1d89a8-0ca3-4246-8cbd-e4f2ad1f4706,geo-72B-test,1719654895,1719656029,finished,1719654970,1719656029,A100-SXM4-80GB,8,2,64,896,75,1059
7c50957d-54ff-4a10-8653-95410a9d1377,geogpt-dairui-model-merge-exp-1,1719655359,1719655650,finished,1719655377,1719655650,A100-SXM4-80GB,8,1,64,896,18,273
48b05672-c052-49ac-a1bb-61e6ec8e7c96,geo-72B-test,1719656141,1719657254,finished,1719656197,1719657254,A100-SXM4-80GB,8,2,64,896,56,1057
624bb7ce-8c00-495e-a7c9-45ccc01f40ae,geo-72B-test,1719657366,1719658458,finished,1719657422,1719658458,A100-SXM4-80GB,8,2,64,896,56,1036
42bf5f5d-37f5-4e7d-86d1-5206b6123fe4,geo-72B-test,1719658551,1719659746,finished,1719658607,1719659746,A100-SXM4-80GB,8,2,64,896,56,1139
a38a6119-816f-4ea6-85e3-e326e9858d7f,geogpt-lxz-cft-wildchat-t1t2-72b,1719658703,1719694939,finished,1719658739,1719694939,A100-SXM4-80GB,8,16,64,448,36,36200
6c1c9fee-1e55-41b2-be98-7a2c77ccafe7,geogpt-llm-moe-expand-0-5B-tag-0-1,1719659560,1719660193,finished,1719659581,1719660193,A100-SXM4-80GB,8,1,64,896,21,612
8d6efa3f-b3b2-4b0f-bb23-ae7988d483e6,geogpt-llm-moe-expand-0-5B-tag-1,1719659562,1719660212,finished,1719659581,1719660212,A100-SXM4-80GB,8,1,64,896,19,631
dbc4aef9-af92-4009-a6df-dfb85dcc655d,geo-72B-test,1719659842,1719661048,finished,1719659898,1719661048,A100-SXM4-80GB,8,2,64,896,56,1150
1d5655dd-4e77-4234-99d1-cd4ecef7b85c,geogpt-llm-moe-expand-0-5B-tag-0-1,1719660193,1719783977,finished,1719660212,1719783977,A100-SXM4-80GB,8,1,64,896,19,123765
6a5723ad-5bd5-445b-aacd-fb44d0aa8cba,geogpt-llm-moe-expand-0-5B-tag-1,1719660213,1719784265,finished,1719660231,1719784265,A100-SXM4-80GB,8,1,64,896,18,124034
801f0276-5872-4857-afeb-51d1a30bcedf,geogpt-llm-moe-expand-0-5B-tag-0-1-mlp-5,1719660380,1719791451,finished,1719660398,1719791451,A100-SXM4-80GB,8,1,64,896,18,131053
c7ebe13b-8c6f-4aee-a83e-d006c94b472c,geogpt-llm-moe-expand-0-5B-tag-0-1-mlp-6,1719660399,1719797789,finished,1719667117,1719797789,A100-SXM4-80GB,8,1,64,896,6718,130672
62dd59c6-89d0-4718-881e-3bc29d299265,geogpt-llm-moe-expand-0-5B-tag-1-mlp-5,1719660439,1719793130,finished,1719661066,1719793130,A100-SXM4-80GB,8,1,64,896,627,132064
62e5af70-3498-4902-945d-00cb4442b20a,geogpt-llm-moe-expand-0-5B-tag-1-mlp-6,1719660441,1719796966,finished,1719665755,1719796966,A100-SXM4-80GB,8,1,64,896,5314,131211
58322830-636b-47bb-a15e-a7c4415a992f,geogpt-dairui-model-merge-exp-1,1719660900,1719665736,finished,1719661066,1719665736,A100-SXM4-80GB,8,1,64,896,166,4670
1fadbf8e-3601-4ffd-a8c1-d6f6bb865d14,geo-72B-test,1719661161,1719668329,finished,1719667136,1719668329,A100-SXM4-80GB,8,2,64,896,5975,1193
8ed8b9ce-9b8d-4a42-b149-c0f9d1c2502c,data-gen-magpie,1719663088,1719709629,finished,1719663107,1719709629,A100-SXM4-80GB,8,1,64,448,19,46522
93edd046-750e-48f6-bc3c-6d56316edc58,geogpt-dairui-eval-code-2,1719665718,1719670322,finished,1719667117,1719670322,A100-SXM4-80GB,8,1,64,448,1399,3205
e71d81e2-e2c6-4536-80f9-caec6dffca9c,geogpt-dairui-model-merge-exp-1,1719665737,1719718851,finished,1719667710,1719718851,A100-SXM4-80GB,8,1,64,896,1973,51141
c50e01f2-13f9-4d82-842d-b9165791c438,geo-cpt-1-5B,1719667097,1719667691,finished,1719667485,1719667691,A100-SXM4-80GB,8,2,64,896,388,206
59fca6ae-8c04-4f63-b4ba-6f5dac3079e4,geo-cpt-1-5B-geo-common,1719667097,1719667429,finished,1719667173,1719667429,A100-SXM4-80GB,8,2,64,896,76,256
fe3d5f81-65d5-49f7-bc4c-9ea0410474e6,geo-cpt-1-8B,1719667193,1719668595,finished,1719668389,1719668595,A100-SXM4-80GB,8,4,64,896,1196,206
eaef0e5b-1171-4d9f-bcaf-7c9cc89e130f,gpt-megatron,1719668256,1719669113,finished,1719668361,1719669113,A100-SXM4-80GB,8,8,64,448,105,752
2b0e4539-5b66-48e4-8880-b181dca89af8,geo-72B-test,1719668447,1719668944,finished,1719668670,1719668944,A100-SXM4-80GB,8,2,64,896,223,274
e139e302-0e4a-45ee-b9dc-a2f518579a3f,geo-cpt-1-5B,1719668828,1719730476,finished,1719669000,1719730476,A100-SXM4-80GB,8,2,64,896,172,61476
71673ee5-3186-457e-a90d-d1b81d697158,geo-cpt-1-5B-geo-common,1719668829,1719781202,finished,1719668887,1719781202,A100-SXM4-80GB,8,2,64,896,58,112315
bb90f2d1-ab98-456f-ab0a-28aa8306e80e,geo-cpt-05B-geo-common,1719668848,1719720926,finished,1719668906,1719720926,A100-SXM4-80GB,8,2,64,896,58,52020
d8d11743-1ee3-4cb0-b3e9-9cac80b28305,geo-cpt-1-8B,1719668848,1719754194,finished,1719722725,1719754194,A100-SXM4-80GB,8,4,64,896,53877,31469
14c69e48-0e13-43ab-bad0-ce4f79a725fc,geo-72B-test,1719669040,1719671560,finished,1719670873,1719671560,A100-SXM4-80GB,8,2,64,896,1833,687
481f39d5-ac6a-43d4-b1be-30813c8c92cb,gpt-megatron,1719669296,1719669928,finished,1719669353,1719669928,A100-SXM4-80GB,8,4,64,448,57,575
8ffa1d81-d432-44b2-880f-292e6d5f71dd,gpt-megatron,1719670037,1719814570,finished,1719796563,1719814570,A100-SXM4-80GB,8,32,64,448,126526,18007
2b2b5a0d-fb57-4100-a09d-9d474a794260,geo-72B-test,1719671674,1719672340,finished,1719671712,1719672340,A100-SXM4-80GB,8,2,64,896,38,628
26d37913-cca4-4f79-ad75-a85e4de22884,geo-72B-test,1719672435,1719673160,finished,1719672492,1719673160,A100-SXM4-80GB,8,2,64,896,57,668
3ac30af6-7518-470f-9cce-055760cafcde,geo-72B-test,1719673256,1719673540,finished,1719673312,1719673540,A100-SXM4-80GB,8,2,64,896,56,228
b3101697-5efe-4225-9687-efcedf128c91,easycontext-zj-test,1719673649,1719674283,finished,1719673686,1719674283,A100-SXM4-80GB,8,3,64,896,37,597
acf8f7ab-e986-478d-9afa-2604f09f054a,easycontext-zj-test,1719674283,1719675506,finished,1719674320,1719675506,A100-SXM4-80GB,8,3,64,896,37,1186
7dd6749b-02b1-4244-a533-1127e70bd204,easycontext-zj-test,1719675507,1719676658,finished,1719675545,1719676658,A100-SXM4-80GB,8,12,64,896,38,1113
47a267b7-cbae-4978-8740-a7575ca9ca43,easycontext-zj-test,1719676775,1719687701,finished,1719676813,1719687701,A100-SXM4-80GB,8,12,64,896,38,10888
aa67d583-66d4-48de-afc4-bc2eb4596769,geogpt-72b-0412,1719677148,1719764510,finished,1719677168,1719764510,A100-SXM4-80GB,8,1,64,448,20,87342
cf424f42-de21-4b94-b23b-b3f31a172cff,geogpt-110b-0521,1719677820,1719764529,finished,1719677840,1719764529,A100-SXM4-80GB,8,1,64,448,20,86689
c1607804-08c2-4a78-948f-7f8e625cb798,geogpt-0612-merge-linear-w55,1719678179,1719722734,finished,1719678200,1719722734,A100-SXM4-80GB,8,1,64,448,21,44534
abc98b87-f317-41c0-8fc4-7cf7d82d99a9,geogpt-0612-merge-linear-w37,1719678180,1719722693,finished,1719678200,1719722693,A100-SXM4-80GB,8,1,64,448,20,44493
e03e4f2c-2cab-4976-abde-f38c6d9ef49a,geogpt-0612-merge-w37,1719678220,1719722734,finished,1719678238,1719722734,A100-SXM4-80GB,8,1,64,448,18,44496
2a2b527e-f06b-492e-8187-7be92b9062ac,geo-seesaw-sft-code-alpaca-ultra-eval-test,1719679460,1719889260,finished,1719679479,1719889260,A100-SXM4-80GB,8,1,64,896,19,209781
713898e3-c005-47a4-bb88-7f6b36c02a4a,txchen-train-task,1719681461,1719716462,finished,1719681480,1719716462,A100-SXM4-80GB,8,1,64,448,19,34982
74e1636c-95cc-4634-9844-602175517c24,geogpt-eval-deductive,1719708427,1719720210,finished,1719708447,1719720210,A100-SXM4-80GB,8,1,64,896,20,11763
d8d99845-13ba-46cd-8f2d-a3779eff0358,geogpt-eval-inductive,1719708622,1719713130,finished,1719708641,1719713130,A100-SXM4-80GB,8,1,64,896,19,4489
8385e498-685e-42f3-8cbd-deb58ab3603b,geogpt-14b-cpt-dynamic,1719711980,1719712231,finished,1719712000,1719712231,A100-SXM4-80GB,8,1,64,448,20,231
92400320-0fce-4d98-8336-71a6fc6aa06b,geogpt-14b-cpt-dynamic,1719712465,1719714930,finished,1719712483,1719714930,A100-SXM4-80GB,8,1,64,448,18,2447
a99e458c-da0a-43b4-b5c8-5a992332e464,geogpt-qwen2-72b-llamapro84-6bcpt,1719713090,1719726206,finished,1719713168,1719726206,A100-SXM4-80GB,8,20,64,448,78,13038
2d839151-2e66-4420-9d33-b87d93deff8e,geogpt-7b-50bcpt,1719714593,1719722836,finished,1719714686,1719722836,A100-SXM4-80GB,8,32,64,448,93,8150
950c0bd0-9a34-47b3-b3d8-11e07fba0111,geogpt-7b-llamapro40-38bcpt2ep,1719714613,1719719579,finished,1719714653,1719719579,A100-SXM4-80GB,8,32,64,448,40,4926
e6ba17b7-37e5-4a42-b1c0-d315add20e7f,qwen2-72b-10-8bcpt2ep-sft2ep-cfa36-auto,1719715106,1719717456,finished,1719715127,1719717456,A100-SXM4-80GB,8,1,64,448,21,2329
b982711f-361c-41b0-a760-86b9aca8caf7,qwen2-72b-10-8bcpt2ep-sft2ep-ae384-auto,1719715186,1719718992,finished,1719715206,1719718992,A100-SXM4-80GB,8,1,64,448,20,3786
a9125f24-b2b9-4c63-81cd-f6253ac9e006,qwen2-72b-10-8bcpt2ep-sft2ep-3c626-auto,1719715245,1719727550,finished,1719715266,1719727550,A100-SXM4-80GB,8,1,64,448,21,12284
66044856-4f39-488e-8781-e342f9b05d53,qwen2-72b-10-8bcpt2ep-sft2ep,1719715285,1719888349,finished,1719715304,1719888349,A100-SXM4-80GB,8,1,64,448,19,173045
441028de-9ac9-4859-a6ec-a3a6e4fd4f88,geogpt-gate-chat-eval,1719716209,1719814511,finished,1719716231,1719814511,A100-SXM4-80GB,8,1,64,448,22,98280
3edee0e6-51ce-4998-a7f0-354665e9d6ca,geogept-gate-chat-eval-geo,1719716252,1719717971,finished,1719716272,1719717971,A100-SXM4-80GB,8,1,64,448,20,1699
85eb4fbb-1beb-4fc4-8224-c172060989c1,geogpt-lxz-cft-wildchat-t1t2-72b,1719716268,1719716826,finished,1719716328,1719716826,A100-SXM4-80GB,8,16,64,448,60,498
0be00a83-62b7-42de-955f-94dba2ddc61c,txchen-train-task,1719716462,1719718293,finished,1719716483,1719718293,A100-SXM4-80GB,8,1,64,448,21,1810
9028c740-197c-4bd2-ad5c-82e8c801502e,geo-base-offline-eval,1719716571,1719728804,finished,1719716591,1719728804,A100-SXM4-80GB,8,1,64,448,20,12213
3a7b5d8e-d63b-4f86-b1d6-17db6c0bd08b,geogpt-lxz-sft-magpie-qwen2-pro-2ep-72b,1719716821,1719752276,finished,1719716868,1719752276,A100-SXM4-80GB,8,16,64,448,47,35408
ec588b68-d057-41ae-983f-ce2ff12d70fb,llama3-70b-0521-493f6-auto,1719716830,1719717889,finished,1719716851,1719717889,A100-SXM4-80GB,8,1,64,448,21,1038
0471575e-1ad4-4555-bcfd-fb12438551d2,geogpt-lxz-sft-magpie-llama3-pro-2ep-72b,1719716848,1719726802,finished,1719716914,1719726802,A100-SXM4-80GB,8,16,64,448,66,9888
52ea6952-ea0c-4499-a48d-2d85fe1572c9,geogpt-lxz-cft-wildchat-t1t2-72b,1719717710,1719723277,finished,1719719616,1719723277,A100-SXM4-80GB,8,16,64,448,1906,3661
f9f74963-0284-4330-bd49-cb28b78e98ac,data-gen-magpie,1719717967,1719726304,finished,1719717987,1719726304,A100-SXM4-80GB,8,1,64,448,20,8317
fac34a7e-1953-4c53-bdaa-69c11eb4e1e1,txchen-train-task,1719718293,1719994703,finished,1719718313,1719994703,A100-SXM4-80GB,8,1,64,448,20,276390
8d39d18c-3a54-40db-9aab-e3eff118ad66,easycontext4debug,1719720221,1719722967,finished,1719722865,1719722967,A100-SXM4-80GB,8,40,64,448,2644,102
164aaa3e-46e3-4f63-afbf-2a3a07911e74,geogpt-mixtral-test,1719720425,1719722686,finished,1719720948,1719722686,A100-SXM4-80GB,8,32,64,896,523,1738
3d656319-c99e-4508-b61b-2023033cc7ef,geogpt-mixtral-test,1719722686,1719777459,finished,1719723318,1719777459,A100-SXM4-80GB,8,64,64,896,632,54141
5405f1cb-499d-4e77-945b-54e249e7db3f,geogpt-72b-0206,1719722692,1719798816,finished,1719722714,1719798816,A100-SXM4-80GB,8,1,64,448,22,76102
a17b30e5-2413-4dfd-bf1e-4138a0b60b7a,easycontext4debug,1719723311,1719796648,finished,1719779454,1719796648,A100-SXM4-80GB,8,40,64,448,56143,17194
24346e2a-00a0-4b96-9e02-799a948b412f,geogpt-lxz-cft-1-8m-4-5-subset-72b,1719723365,1719739197,finished,1719726242,1719739197,A100-SXM4-80GB,8,16,64,448,2877,12955
f875ca34-7882-4818-bf19-d4468e4fd7cf,easycontext-zj-test,1719724174,1719724811,finished,1719724232,1719724811,A100-SXM4-80GB,8,3,64,896,58,579
e6756b3f-945a-4f66-a340-893d22cc0730,qwen1-5-7b-lp40-s2-regate-merge-9e958-auto,1719724507,1719732546,finished,1719724528,1719732546,A100-SXM4-80GB,8,1,64,448,21,8018
612bacfa-57a4-4955-92c7-4a50ef3d06d3,qwen1-5-7b-lp40-s2-regate-merge-5f6b4-auto,1719724607,1719733170,finished,1719724626,1719733170,A100-SXM4-80GB,8,1,64,448,19,8544
65a92233-1be9-4485-96cc-9439319b242c,easycontext-zj-test,1719724811,1719725363,finished,1719724888,1719725363,A100-SXM4-80GB,8,3,64,896,77,475
6c6a28c1-8691-492b-ab33-f8cad0fbb87f,easycontext-zj-test,1719725363,1719726011,finished,1719725420,1719726011,A100-SXM4-80GB,8,3,64,896,57,591
5409c1ca-13aa-48e0-bd93-33f5d204b8a3,geogpt-eval-latest,1719725899,1719799799,finished,1719725918,1719799799,A100-SXM4-80GB,8,1,64,896,19,73881
8ac3117c-d339-4d04-bf3b-47bbfaa7185b,easycontext-debug-2nodes,1719726697,1719727257,finished,1719726756,1719727257,A100-SXM4-80GB,8,2,64,448,59,501
d0458f7e-90ad-42df-b9f4-8a900cc4bbb1,qwen2-72b-lp84-s1-7b4fd-auto,1719726746,1719729282,finished,1719726765,1719729282,A100-SXM4-80GB,8,1,64,448,19,2517
b96ce75d-de59-4538-be4f-b496e943b2de,qwen2-72b-lp84-s1-82d18-auto,1719726845,1719759439,finished,1719726863,1719759439,A100-SXM4-80GB,8,1,64,448,18,32576
5c43178c-6c37-4b2e-b675-9f3af2c5fc02,easycontext-zj-test,1719727140,1719729218,finished,1719727180,1719729218,A100-SXM4-80GB,8,3,64,896,40,2038
113183d1-ce71-4bc8-9ff4-fb4417cca857,easycontext-debug-2nodes,1719727257,1719729407,finished,1719727316,1719729407,A100-SXM4-80GB,8,2,64,448,59,2091
3b956034-6e83-43d7-8c6b-1eec15ce82f3,geogpt-qwen2-72bb-lp84-s2-gate,1719728250,1719934607,finished,1719728290,1719934607,A100-SXM4-80GB,8,20,64,448,40,206317
2477d780-6102-4d4a-9e60-eae5b6c295a9,geogpt-0612-merge-vec-w55,1719728416,1719761593,finished,1719728436,1719761593,A100-SXM4-80GB,8,1,64,448,20,33157
0338c1b5-1497-457c-a425-bf28cfe6ba43,geogept-gate-eval,1719729070,1719782258,finished,1719729090,1719782258,A100-SXM4-80GB,8,1,64,448,20,53168
57b084a9-5a17-45d9-ac70-5652e5ffdbfb,qwen1-5-7b-lp40-s2-regate-merge-fc14f-auto,1719729092,1719730575,finished,1719729111,1719730575,A100-SXM4-80GB,8,1,64,448,19,1464
ff72f389-14d7-45fe-8ffe-2d962011bb92,easycontext-debug-2nodes,1719729580,1719731508,finished,1719729637,1719731508,A100-SXM4-80GB,8,2,64,448,57,1871
fd2b355f-1254-4276-ba19-23ef11fa94df,test-xiaodianq,1719730113,1719740206,finished,1719730133,1719740206,A100-SXM4-80GB,8,1,64,896,20,10073
641ec001-d171-460b-85e1-a1f319049fbe,easycontext-debug-2nodes,1719731508,1719732443,finished,1719731546,1719732443,A100-SXM4-80GB,8,2,64,448,38,897
057a8504-c6cd-4ddb-9f22-981528d57282,easycontext-debug-2nodes,1719732893,1719733104,finished,1719732949,1719733104,A100-SXM4-80GB,8,8,64,448,56,155
0b2d8bc3-e1ff-4031-970b-5755f81ec1c1,qwen1-5-7b-lp40-s2-regate-merge-d4c24-auto,1719733112,1719798102,finished,1719733132,1719798102,A100-SXM4-80GB,8,1,64,448,20,64970
9257e76c-5e8c-470a-be77-8849e86a9447,easycontext-debug-2nodes,1719733412,1719733638,finished,1719733486,1719733638,A100-SXM4-80GB,8,8,64,448,74,152
3e801282-dd60-44fb-b779-ec1ee01fcc83,easycontext-debug-2nodes,1719734086,1719734273,finished,1719734124,1719734273,A100-SXM4-80GB,8,8,64,448,38,149
eb19fdf0-73e1-42ac-9233-723bfd2c2d12,easycontext-debug-2nodes,1719734501,1719735556,finished,1719734557,1719735556,A100-SXM4-80GB,8,8,64,448,56,999
bf735c2c-755f-42a5-9805-7881802beb55,txchen-lm-eval2,1719735280,1719735626,finished,1719735300,1719735626,A100-SXM4-80GB,8,1,64,448,20,326
c29f9a0c-11c9-46dc-b642-a2ab92cd587c,txchen-lm-eval2,1719735626,1719742558,finished,1719735645,1719742558,A100-SXM4-80GB,8,1,64,448,19,6913
c7b0135e-35a9-4746-b3e9-0d5036f2db46,easycontext-debug-2nodes,1719735673,1719736237,finished,1719735748,1719736237,A100-SXM4-80GB,8,4,64,448,75,489
9624d7d4-a485-44a2-9617-f78aac388e72,qwen1-5-7b-lp40-s2-regate-merge-53048-auto,1719735681,1719798102,finished,1719735701,1719798102,A100-SXM4-80GB,8,1,64,448,20,62401
7e01e0d9-00f3-4467-bd74-ce8d837384f7,easycontext-debug-2nodes,1719736480,1719738673,finished,1719736518,1719738673,A100-SXM4-80GB,8,4,64,448,38,2155
201c3142-c6f5-47ff-b69e-32857ae7a95f,txchen-eval,1719737745,1719739472,finished,1719737764,1719739472,A100-SXM4-80GB,8,1,64,448,19,1708
b043a528-0696-4032-b2f7-a5008c53d38a,geo-seesaw-ssft-head-ablation-7b-code,1719737963,1719738432,finished,1719737981,1719738432,A100-SXM4-80GB,8,1,64,896,18,451
4e285170-9af6-4072-8d72-fd750e885fa7,geo-seesaw-ssft-head-ablation-13b-code-2,1719738412,1719747601,finished,1719738526,1719747601,A100-SXM4-80GB,8,1,64,896,114,9075
3d9202da-f416-415a-899f-0b3be50f73a4,geo-seesaw-ssft-head-ablation-7b-code,1719738432,1719822031,finished,1719738451,1719822031,A100-SXM4-80GB,8,1,64,896,19,83580
919ad3fa-0d91-4285-8edb-4740b899d8da,easycontext-debug-2nodes,1719738673,1719738978,finished,1719738732,1719738978,A100-SXM4-80GB,8,4,64,448,59,246
1f196100-b208-472a-b984-2bf3cf0c4d35,lzk-qwen15-7b-scihub-abstract-cpt,1719738933,1719947727,finished,1719739491,1719947727,A100-SXM4-80GB,8,1,64,448,558,208236
7ea3b8f9-f431-40fa-9e3f-2128dea7cc2e,qwen7b-total-cpt-lr-1e-4-e2-5bbc3-auto,1719739143,1719745616,finished,1719744150,1719745616,A100-SXM4-80GB,8,1,64,448,5007,1466
919cf54b-fc53-4578-be89-67d3e6edb19a,easycontext-debug-2nodes,1719739266,1719740098,finished,1719739305,1719740098,A100-SXM4-80GB,8,4,64,448,39,793
33a4f5f9-d2a5-4435-826f-48742279fcab,qwen7b-total-cpt-lr-1e-4-e1-e8511-auto,1719739415,1719744130,finished,1719742576,1719744130,A100-SXM4-80GB,8,1,64,448,3161,1554
a7c712b9-ffb1-40b4-a141-70b43a4707d7,easycontext-debug-2nodes,1719740560,1719741382,finished,1719740597,1719741382,A100-SXM4-80GB,8,4,64,448,37,785
dabc1340-eca9-4f98-a3a0-ba578cda7d34,easycontext-32k,1719741363,1719744455,finished,1719741402,1719744455,A100-SXM4-80GB,8,16,64,448,39,3053
bf000317-b7f2-4337-baa7-b395fefce0c0,easycontext-32k-theta-50w,1719742655,1720170211,finished,1719742712,1720170211,A100-SXM4-80GB,8,16,64,448,57,427499
a593ca1c-4a13-4dd6-8685-102ac9b3297f,test-xiaodianq,1719743253,1719781329,finished,1719743272,1719781329,A100-SXM4-80GB,8,1,64,896,19,38057
f2dd595c-2240-441e-bf36-de966f1bd279,easycontext-32k-ntk-21,1719744268,1720163453,finished,1719744474,1720163453,A100-SXM4-80GB,8,16,64,448,206,418979
a1876e66-eef9-4186-abb8-530fbc427911,test,1719747355,1719747997,finished,1719747375,1719747997,A100-SXM4-80GB,8,1,64,448,20,622
f1dbc9d6-d669-4e5e-a168-a50fff411149,test,1719748237,1719748959,finished,1719748256,1719748959,A100-SXM4-80GB,8,1,64,448,19,703
7aa0ca22-a8f7-47de-8269-4ffb83b6b3ee,test,1719749403,1719750273,finished,1719749422,1719750273,A100-SXM4-80GB,8,1,64,448,19,851
e8289c72-2a1a-4bd8-9159-437d558a4d69,test,1719750309,1719760901,finished,1719750329,1719760901,A100-SXM4-80GB,8,1,64,448,20,10572
5f353665-9d89-48d8-b1c1-2e26d0576353,geogpt-lxz-sft-magpie-llama3-pro-2ep-72b,1719752828,1719755688,finished,1719755287,1719755688,A100-SXM4-80GB,8,16,64,448,2459,401
424491f9-fb48-4434-ba88-504f0f3a2f23,geogpt-lxz-cft-wildchat-t1t2-72b,1719752830,1719755250,finished,1719752868,1719755250,A100-SXM4-80GB,8,16,64,448,38,2382
9205a3be-936f-40ff-9553-149ada2737f6,geogpt-lxz-sft-magpie-qwen2-pro-2ep-72b,1719752849,1719764049,finished,1719755724,1719764049,A100-SXM4-80GB,8,16,64,448,2875,8325
1a0692ff-cb1d-4977-a160-1acf7518f9b4,geogpt-lxz-sft-magpie-llama3-pro-2ep-72b,1719756257,1719779421,finished,1719764087,1719779421,A100-SXM4-80GB,8,16,64,448,7830,15334
dc65f036-5088-44e5-b5cb-8b07cdd877fb,geogpt-lxz-cft-wildchat-t1t2-72b,1719756258,1719782028,finished,1719777459,1719782028,A100-SXM4-80GB,8,16,64,448,21201,4569
4f474158-0f74-4e81-a5c1-9e371b537537,test-2,1719760901,1719761600,finished,1719760921,1719761600,A100-SXM4-80GB,8,1,64,448,20,679
0d3738ad-8676-4204-92c8-433f7f2c2461,test-2,1719761600,1719808994,finished,1719761618,1719808994,A100-SXM4-80GB,8,1,64,896,18,47376
9fdcedba-c65e-49b3-a2b6-9dcfec257e20,geogpt-72b-1215,1719761685,1719798834,finished,1719761706,1719798834,A100-SXM4-80GB,8,1,64,448,21,37128
ca41c603-3566-4d00-8bbd-64a93456509a,geogpt-lxz-sft-magpie-qwen2-pro-2ep-72b,1719764113,1719785025,finished,1719777484,1719785025,A100-SXM4-80GB,8,16,64,448,13371,7541
72d3029c-6357-4b57-9d74-e4529d57bbe1,geogpt-0521-llama3,1719764359,1719822276,finished,1719764379,1719822276,A100-SXM4-80GB,8,1,64,448,20,57897
cf444c35-41f0-4052-ac4e-8ad81572dbca,test-zz,1719769221,1719798857,finished,1719769239,1719798857,A100-SXM4-80GB,8,1,64,896,18,29618
dd306a69-fc0a-4383-9fe3-3f9452c037cc,geogpt-table-qwen2-72b-datav040-2,1719770015,1719820829,finished,1719770089,1719820829,A100-SXM4-80GB,8,4,64,896,74,50740
818dd4da-3f93-4280-80c8-696aac381323,geogpt-mixtral-test,1719777543,1719799918,finished,1719798729,1719799918,A100-SXM4-80GB,8,64,64,896,21186,1189
6c2fff61-f94d-4a75-a0b7-70050eb98dbe,geogpt-lxz-sft-magpie-llama3-pro-2ep-72b,1719779496,1719785581,finished,1719781203,1719785581,A100-SXM4-80GB,8,16,64,448,1707,4378
d2ca3264-c2ab-4ad3-80c7-f2b727fe8a84,geogpt-lxz-cft-wildchat-t1t2-72b,1719782087,1719782834,finished,1719782140,1719782834,A100-SXM4-80GB,8,16,64,448,53,694
e3c9dcff-c5a9-46c0-a791-ad98e473dade,geogpt-lxz-cft-wildchat-t1t2-72b,1719782889,1719783623,finished,1719782960,1719783623,A100-SXM4-80GB,8,16,64,448,71,663
73739750-b8e5-4f64-90df-d841aa6add0a,geogpt-lxz-cft-wildchat-t1t2-72b,1719783679,1719784414,finished,1719783753,1719784414,A100-SXM4-80GB,8,16,64,448,74,661
ba6e5e5e-6f15-435a-8ab7-67d499f284bd,geogpt-lxz-cft-wildchat-t1t2-72b,1719784468,1719785201,finished,1719784541,1719785201,A100-SXM4-80GB,8,16,64,448,73,660
cce16c35-170d-4efc-92c7-a33e690c6054,geogpt-lxz-sft-magpie-qwen2-pro-2ep-72b,1719785083,1719785923,finished,1719785138,1719785923,A100-SXM4-80GB,8,16,64,448,55,785
c6fb96c0-49d4-459d-9995-f826686bdd64,geogpt-lxz-cft-wildchat-t1t2-72b,1719785259,1719785944,finished,1719785297,1719785944,A100-SXM4-80GB,8,16,64,448,38,647
34eda747-47f7-4302-8f23-aad8f0450cca,geogpt-lxz-sft-magpie-llama3-pro-2ep-72b,1719785638,1719786352,finished,1719785712,1719786352,A100-SXM4-80GB,8,16,64,448,74,640
2fc416dd-e25e-40f1-80b1-1f311cf4f2ae,geogpt-lxz-sft-magpie-qwen2-pro-2ep-72b,1719785983,1719786809,finished,1719786024,1719786809,A100-SXM4-80GB,8,16,64,448,41,785
cf4583ba-954c-4ae1-abc0-d49d390bd026,geogpt-lxz-cft-wildchat-t1t2-72b,1719786005,1719786711,finished,1719786049,1719786711,A100-SXM4-80GB,8,16,64,448,44,662
3d5f7ddd-43a1-4f99-9baf-230e76357533,geogpt-lxz-sft-magpie-llama3-pro-2ep-72b,1719786408,1719787115,finished,1719786482,1719787115,A100-SXM4-80GB,8,16,64,448,74,633
19cd2457-b2a0-4e4e-b6a7-94e995d9eae6,geogpt-lxz-cft-wildchat-t1t2-72b,1719786769,1719787473,finished,1719786809,1719787473,A100-SXM4-80GB,8,16,64,448,40,664
1a3c2d8c-dddc-4e6d-a194-643586f97d77,geogpt-lxz-sft-magpie-qwen2-pro-2ep-72b,1719786872,1719787758,finished,1719786943,1719787758,A100-SXM4-80GB,8,16,64,448,71,815
39401ef1-051c-49ee-a3cc-090fb75b1742,geogpt-lxz-sft-magpie-llama3-pro-2ep-72b,1719787171,1719787835,finished,1719787228,1719787835,A100-SXM4-80GB,8,16,64,448,57,607
f7731773-6fac-43a5-952c-51a3adbe0e03,geogpt-lxz-cft-wildchat-t1t2-72b,1719787529,1719788181,finished,1719787565,1719788181,A100-SXM4-80GB,8,16,64,448,36,616
de45e2eb-2a4d-45f4-870e-3fcd8b1c0c82,geogpt-lxz-sft-magpie-qwen2-pro-2ep-72b,1719787814,1719788615,finished,1719787871,1719788615,A100-SXM4-80GB,8,16,64,448,57,744
1515264d-6fb9-46d3-9045-6f82c0310bfc,geogpt-lxz-sft-magpie-llama3-pro-2ep-72b,1719787898,1719788576,finished,1719787972,1719788576,A100-SXM4-80GB,8,16,64,448,74,604
792fd8fb-8283-4772-906b-e7844bc9aa66,geogpt-lxz-cft-wildchat-t1t2-72b,1719788237,1719788906,finished,1719788292,1719788906,A100-SXM4-80GB,8,16,64,448,55,614
ef22d4db-1eac-4b57-8eda-3c6e9f0c5219,geogpt-lxz-sft-magpie-llama3-pro-2ep-72b,1719788635,1719789324,finished,1719788710,1719789324,A100-SXM4-80GB,8,16,64,448,75,614
7587e322-e641-4cce-8099-12f3267ff387,geogpt-lxz-sft-magpie-qwen2-pro-2ep-72b,1719788674,1719789481,finished,1719788734,1719789481,A100-SXM4-80GB,8,16,64,448,60,747
649b2e56-7124-414c-b37a-2f98866f8294,geogpt-lxz-cft-wildchat-t1t2-72b,1719788964,1719789820,finished,1719789020,1719789820,A100-SXM4-80GB,8,16,64,448,56,800
a1f2c496-9769-4850-8823-f6839669e772,geogpt-lxz-sft-magpie-llama3-pro-2ep-72b,1719789380,1719790035,finished,1719789435,1719790035,A100-SXM4-80GB,8,16,64,448,55,600
48cc2663-13f2-41a8-b3bd-cf2520fed00d,geogpt-lxz-sft-magpie-qwen2-pro-2ep-72b,1719789538,1719790213,finished,1719789593,1719790213,A100-SXM4-80GB,8,16,64,448,55,620
c58d0d4e-830c-4ccd-bd6a-6e59a886db7f,geogpt-lxz-cft-wildchat-t1t2-72b,1719789877,1719790535,finished,1719789934,1719790535,A100-SXM4-80GB,8,16,64,448,57,601
6654eed5-2dc6-437a-a623-ec47634861c9,geogpt-lxz-sft-magpie-llama3-pro-2ep-72b,1719790092,1719790767,finished,1719790166,1719790767,A100-SXM4-80GB,8,16,64,448,74,601
e6bc5880-9f99-4307-8cd0-a440cd296ed4,geogpt-lxz-sft-magpie-qwen2-pro-2ep-72b,1719790268,1719790924,finished,1719790325,1719790924,A100-SXM4-80GB,8,16,64,448,57,599
4aaec8ce-dcc4-43f0-8c4c-2162d03112e1,geogpt-lxz-cft-wildchat-t1t2-72b,1719790591,1719791397,finished,1719790648,1719791397,A100-SXM4-80GB,8,16,64,448,57,749
f55a9fcf-8e57-43f7-83e5-d636ec05a0bb,geogpt-lxz-sft-magpie-llama3-pro-2ep-72b,1719790824,1719791491,finished,1719790879,1719791491,A100-SXM4-80GB,8,16,64,448,55,612
8c0ad279-4778-4107-afed-2b1856ccc4ba,geogpt-lxz-sft-magpie-qwen2-pro-2ep-72b,1719790984,1719791629,finished,1719791020,1719791629,A100-SXM4-80GB,8,16,64,448,36,609
d06f6d94-405e-4a16-babe-9714952c3892,geogpt-lxz-cft-wildchat-t1t2-72b,1719791452,1719792104,finished,1719791510,1719792104,A100-SXM4-80GB,8,16,64,448,58,594
0df35b64-4dee-4e04-ba26-c52979fa5aba,geogpt-lxz-sft-magpie-llama3-pro-2ep-72b,1719791554,1719792263,finished,1719791629,1719792263,A100-SXM4-80GB,8,16,64,448,75,634
9c3f1228-e136-490c-96bf-ca47ea6943f3,geogpt-lxz-sft-magpie-qwen2-pro-2ep-72b,1719791693,1719792362,finished,1719791747,1719792362,A100-SXM4-80GB,8,16,64,448,54,615
3ad6882d-4161-4801-beae-f31334cc97a3,geogpt-lxz-cft-wildchat-t1t2-72b,1719792162,1719792839,finished,1719792217,1719792839,A100-SXM4-80GB,8,16,64,448,55,622
297d67e0-97a7-4b17-9280-c98e78751aa6,geogpt-lxz-sft-magpie-llama3-pro-2ep-72b,1719792322,1719793015,finished,1719792400,1719793015,A100-SXM4-80GB,8,16,64,448,78,615
9ea532c1-319f-4dbf-9dd9-d436c670f72a,geogpt-lxz-sft-magpie-qwen2-pro-2ep-72b,1719792425,1719793074,finished,1719792482,1719793074,A100-SXM4-80GB,8,16,64,448,57,592
7196137a-c502-4ad2-9475-54fef49858cc,geogpt-lxz-cft-wildchat-t1t2-72b,1719792896,1719793548,finished,1719792932,1719793548,A100-SXM4-80GB,8,16,64,448,36,616
b8e83cda-ca9a-4070-8ecd-c40ae1338f72,geogpt-lxz-sft-magpie-llama3-pro-2ep-72b,1719793074,1719793765,finished,1719793150,1719793765,A100-SXM4-80GB,8,16,64,448,76,615
0c02eeb1-6283-44c6-a919-a2a562709ca8,geogpt-lxz-sft-magpie-qwen2-pro-2ep-72b,1719793131,1719793782,finished,1719793175,1719793782,A100-SXM4-80GB,8,16,64,448,44,607
b2ddb5dd-c47b-4eff-a6c2-ea4b4e08dfa6,geogpt-lxz-cft-wildchat-t1t2-72b,1719793604,1719794294,finished,1719793681,1719794294,A100-SXM4-80GB,8,16,64,448,77,613
eda49208-9240-4604-8e5b-674a4cf17cc2,geogpt-lxz-sft-magpie-llama3-pro-2ep-72b,1719793823,1719794490,finished,1719793877,1719794490,A100-SXM4-80GB,8,16,64,448,54,613
5ef919ac-da7b-4b93-8c2b-e53f1eed4ecb,geogpt-lxz-sft-magpie-qwen2-pro-2ep-72b,1719793841,1719794508,finished,1719793919,1719794508,A100-SXM4-80GB,8,16,64,448,78,589
a0368170-9e39-4dc0-bc68-7fa275b0e304,geogpt-lxz-cft-wildchat-t1t2-72b,1719794349,1719795023,finished,1719794405,1719795023,A100-SXM4-80GB,8,16,64,448,56,618
31f69d1c-86b1-4935-a150-f3d61f632f00,geogpt-lxz-sft-magpie-llama3-pro-2ep-72b,1719794549,1719795202,finished,1719794586,1719795202,A100-SXM4-80GB,8,16,64,448,37,616
85b4b786-41da-43f6-8a7e-598a92608c64,geogpt-lxz-sft-magpie-qwen2-pro-2ep-72b,1719794567,1719795241,finished,1719794630,1719795241,A100-SXM4-80GB,8,16,64,448,63,611
94efdb35-efac-4562-afb5-42d7e66b5216,geogpt-lxz-cft-wildchat-t1t2-72b,1719795079,1719795773,finished,1719795156,1719795773,A100-SXM4-80GB,8,16,64,448,77,617
43c8d03f-f6c8-4b50-b1dd-3da669e04183,geogpt-lxz-sft-magpie-llama3-pro-2ep-72b,1719795260,1719795953,finished,1719795337,1719795953,A100-SXM4-80GB,8,16,64,448,77,616
8444ec59-6554-41af-8a62-4ec2b3cf1a04,geogpt-lxz-sft-magpie-qwen2-pro-2ep-72b,1719795299,1719795972,finished,1719795362,1719795972,A100-SXM4-80GB,8,16,64,448,63,610
61d9f378-0287-46b7-b615-85d80ee0e319,geogpt-lxz-cft-wildchat-t1t2-72b,1719795829,1719796512,finished,1719795904,1719796512,A100-SXM4-80GB,8,16,64,448,75,608
e84df90d-860b-4d83-9c0f-9d7ad73af84a,geogpt-lxz-sft-magpie-llama3-pro-2ep-72b,1719796013,1719796873,finished,1719796072,1719796873,A100-SXM4-80GB,8,16,64,448,59,801
d72802a8-35d7-4a62-8f42-877f42eeefda,geogpt-lxz-sft-magpie-qwen2-pro-2ep-72b,1719796033,1719796717,finished,1719796114,1719796717,A100-SXM4-80GB,8,16,64,448,81,603
bf271416-e2da-45bd-9551-5748b7bba25a,geogpt-lxz-cft-wildchat-t1t2-72b,1719796583,1719797325,finished,1719796653,1719797325,A100-SXM4-80GB,8,16,64,448,70,672
c9bcf0f4-140e-4b70-8cef-15429fe76289,megatron-gpt-16nodes,1719796597,1719819090,finished,1719818507,1719819090,A100-SXM4-80GB,8,16,64,448,21910,583
62561a81-7e85-4408-ad9c-6a77f190e51d,geogpt-lxz-sft-magpie-qwen2-pro-2ep-72b,1719796771,1719797444,finished,1719796827,1719797444,A100-SXM4-80GB,8,16,64,448,56,617
beda57bf-c721-4d44-91be-01d95df22ae2,geogpt-lxz-sft-magpie-llama3-pro-2ep-72b,1719796929,1719797791,finished,1719797004,1719797791,A100-SXM4-80GB,8,16,64,448,75,787
94bd1bbb-7bdc-41dd-9a2c-5084a404f84a,sfr-synthetize-data,1719797082,1719797154,finished,1719797100,1719797154,A100-SXM4-80GB,8,1,64,448,18,54
3c36e640-891f-4d25-a029-51046340184b,sfr-eval-mteb,1719797208,1719798458,finished,1719797226,1719798458,A100-SXM4-80GB,8,1,64,448,18,1232
bc048b52-e969-4f5f-8221-bf43d144460b,reranker-inference11,1719797282,1719970042,finished,1719797300,1719970042,A100-SXM4-80GB,8,1,64,448,18,172742
582bbbaa-cc31-4747-8c87-808345f410fd,sfr-synthetize-data,1719797300,1719797439,finished,1719797320,1719797439,A100-SXM4-80GB,8,1,64,448,20,119
4a7a008e-790d-4f6d-9d87-45dd11881603,geogpt-lxz-cft-wildchat-t1t2-72b,1719797380,1719798062,finished,1719797420,1719798062,A100-SXM4-80GB,8,16,64,448,40,642
41c07e9c-458f-49b0-bf6d-cbcb79b2f755,sfr-embedding-test,1719797493,1719820689,finished,1719797512,1719820689,A100-SXM4-80GB,8,1,64,448,19,23177
bbb0fd33-6398-4de6-a3e0-f0c76fb0a2b6,geogpt-lxz-sft-magpie-qwen2-pro-2ep-72b,1719797499,1719798310,finished,1719797552,1719798310,A100-SXM4-80GB,8,16,64,448,53,758
b8de9744-ec8e-4abd-bbcb-5e65f2c772f2,geogpt-lxz-sft-magpie-llama3-pro-2ep-72b,1719797846,1719798563,finished,1719797902,1719798563,A100-SXM4-80GB,8,16,64,448,56,661
4e619381-5c96-444e-85e1-1e834561967e,sfr-synthetize-data,1719797860,1719797975,finished,1719797879,1719797975,A100-SXM4-80GB,8,1,64,448,19,96
46c32ca7-208b-4eb1-88a5-7777c8871873,test-xiaodianq,1719797973,1719798912,finished,1719797992,1719798912,A100-SXM4-80GB,8,1,64,896,19,920
cfdbb807-f79b-424c-ba40-679c240ffda8,qwen1-5-7b-lp40-s2-regatemerge-909c9-auto,1719798021,1719819544,finished,1719798044,1719819544,A100-SXM4-80GB,8,1,64,448,23,21500
6f99970e-d574-4690-9ddd-9f39808815b5,sfr-synthetize-data,1719798074,1719798151,finished,1719798092,1719798151,A100-SXM4-80GB,8,1,64,448,18,59
2c4186cc-91f0-4571-a35e-84420d6dd4fa,geogpt-lxz-cft-wildchat-t1t2-72b,1719798117,1719798503,finished,1719798158,1719798503,A100-SXM4-80GB,8,16,64,448,41,345
7d66ac8d-e4ab-4f7a-8b9d-9b803c97fc03,geogpt-lxz-sft-magpie-qwen2-pro-2ep-72b,1719798364,1719798756,finished,1719798420,1719798756,A100-SXM4-80GB,8,16,64,448,56,336
1b71f2ce-c7ad-475d-a2d7-8517914a9d0d,qwen2-cpt8k-extra,1719798517,1719805167,finished,1719798540,1719805167,A100-SXM4-80GB,8,1,64,448,23,6627
c30b150a-e546-49b0-902c-d56ff59078a6,geogpt-lxz-cft-wildchat-t1t2-72b,1719798901,1719799714,finished,1719798977,1719799714,A100-SXM4-80GB,8,16,64,448,76,737
80fad259-b442-45b5-a1a7-a141da9d5507,geogpt-lxz-sft-magpie-qwen2-pro-2ep-72b,1719798921,1719800511,finished,1719799749,1719800511,A100-SXM4-80GB,8,16,64,448,828,762
c7b0b811-f105-462d-9968-702efb495410,geogpt-lxz-sft-magpie-llama3-pro-2ep-72b,1719798923,1719800785,finished,1719799975,1719800785,A100-SXM4-80GB,8,16,64,448,1052,810
9c9a2ec0-e77e-4c14-8669-0119d1bec38a,easycontext-80k,1719799196,1719805482,finished,1719800002,1719805482,A100-SXM4-80GB,8,16,64,448,806,5480
3ef5ecf3-a14f-485b-8002-3a618a197afe,profiler,1719799249,1719799687,finished,1719799268,1719799687,A100-SXM4-80GB,8,1,64,896,19,419
36f658a8-cb12-4989-9d19-dd994f5d7b48,reranker-inference,1719799669,1719972757,finished,1719799688,1719972757,A100-SXM4-80GB,8,1,64,448,19,173069
fd488571-180a-4498-9283-bec186723ec9,geogpt-lxz-cft-wildchat-t1t2-72b,1719799776,1719800785,finished,1719799982,1719800785,A100-SXM4-80GB,8,16,64,448,206,803
dda81a76-126c-4328-a046-837576fec284,geo-table-datav05-lora-5e-5,1719799796,1719814071,finished,1719799814,1719814071,A100-SXM4-80GB,8,1,64,448,18,14257
65bab8e2-f81c-45ca-9e17-092e13e4af59,geogpt-mixtral-test,1719799975,1719829072,finished,1719805487,1719829072,A100-SXM4-80GB,8,64,64,896,5512,23585
3b173b8c-aa06-4e48-8870-2ae27884ca8e,geogpt-prompt-eval-all,1719799995,1719804167,finished,1719800020,1719804167,A100-SXM4-80GB,8,1,64,896,25,4147
ce11325d-4d42-4e34-933f-1bb78c5c55e2,qwen72Binstruct-dpo,1719800136,1719800544,finished,1719800155,1719800544,A100-SXM4-80GB,8,1,64,896,19,389
dd92262f-1461-4f52-88c7-7c15364abbfe,Qwen2-72B-Instruct-9db91-auto,1719800184,1719819506,finished,1719800204,1719819506,A100-SXM4-80GB,8,1,64,448,20,19302
ffaa22fb-068f-47b3-82a9-b9bfca6db5ec,profiler,1719800249,1719800323,finished,1719800268,1719800323,A100-SXM4-80GB,8,1,64,896,19,55
03f5904a-0a83-4878-8e74-e11bf384d733,txchen-lm-eval2,1719800336,1719808083,finished,1719800355,1719808083,A100-SXM4-80GB,8,1,64,448,19,7728
4083f0ac-b514-4393-875e-fb4c65163cb8,geogpt-lxz-sft-magpie-qwen2-pro-2ep-72b,1719800572,1719801226,finished,1719800628,1719801226,A100-SXM4-80GB,8,16,64,448,56,598
2dd1c40b-4356-426b-a7ea-a3738fc3b025,profiler,1719800601,1719801294,finished,1719800621,1719801294,A100-SXM4-80GB,8,1,64,896,20,673
6b703d3a-9d13-474a-b241-c5d0e8f35672,geogpt-lxz-sft-magpie-llama3-pro-2ep-72b,1719800842,1719801503,finished,1719800900,1719801503,A100-SXM4-80GB,8,16,64,448,58,603
d7f1237f-230e-41d2-b292-77322eae8ce2,geogpt-lxz-cft-wildchat-t1t2-72b,1719800842,1719801543,finished,1719800906,1719801543,A100-SXM4-80GB,8,16,64,448,64,637
3f40f902-4919-4312-a8be-04acd1c4cafe,txchen-eval,1719800919,1719801826,finished,1719800938,1719801826,A100-SXM4-80GB,8,1,64,448,19,888
3945855e-fc86-4b25-8008-c3b84476ee46,geogpt-lxz-sft-magpie-qwen2-pro-2ep-72b,1719801282,1719801936,finished,1719801337,1719801936,A100-SXM4-80GB,8,16,64,448,55,599
63241ad3-cec1-44ef-b1ec-986f2d6361ab,qwen-72b-test,1719801378,1719803540,finished,1719801398,1719803540,A100-SXM4-40GB,8,1,32,320,20,2142
48f3de2e-1c65-4bfd-8547-9c39f431f65f,profiler,1719801413,1719802166,finished,1719801432,1719802166,A100-SXM4-80GB,8,1,64,896,19,734
537bdf96-1995-427a-acbe-29edb5095038,geo-72B-test,1719801477,1719802053,finished,1719801560,1719802053,A100-SXM4-80GB,8,2,64,896,83,493
6d4b08d7-5e9a-4d07-bd70-55bb53bcf80a,rag-rank,1719801495,1719803123,finished,1719801515,1719803123,A100-SXM4-80GB,8,1,64,448,20,1608
e9ed88c8-add3-4b86-9e74-b60fe790559a,geogpt-lxz-sft-magpie-llama3-pro-2ep-72b,1719801562,1719802231,finished,1719801637,1719802231,A100-SXM4-80GB,8,16,64,448,75,594
b7cc40b7-ce21-4f66-9836-2b12bf36253f,geogpt-lxz-cft-wildchat-t1t2-72b,1719801601,1719802271,finished,1719801662,1719802271,A100-SXM4-80GB,8,16,64,448,61,609
8f69b9d5-d14a-438a-be3f-c69133f7a530,sfr-eval-mteb,1719801736,1719803717,finished,1719801756,1719803717,A100-SXM4-80GB,8,1,64,448,20,1961
c1496f97-a0f6-46fd-8959-a3563c159b49,sfr-synthetize-data,1719801757,1719801869,finished,1719801777,1719801869,A100-SXM4-80GB,8,1,64,448,20,92
bca70176-de89-4ac6-bd22-9b8ce543dc53,geo-router-tag-1,1719801874,1719818028,finished,1719801933,1719818028,A100-SXM4-80GB,8,4,64,448,59,16095
d920ed47-b5ae-4838-b251-408ab6fea4a2,llama-multi,1719801950,1719804743,finished,1719802009,1719804743,A100-SXM4-80GB,8,2,64,448,59,2734
45fb4fab-12cd-44df-b4c8-d7ee64a4a1d5,geogpt-lxz-sft-magpie-qwen2-pro-2ep-72b,1719801995,1719802731,finished,1719802055,1719802731,A100-SXM4-80GB,8,16,64,448,60,676
dad1d271-7aaf-4b0c-9437-e7956148bf7f,geo-72B-test,1719802053,1719802491,finished,1719802079,1719802491,A100-SXM4-80GB,8,1,64,896,26,412
712ca633-0aa5-4594-a914-f8433bfa62c8,easycontext-zj-8b,1719802129,1719802547,finished,1719802149,1719802547,A100-SXM4-80GB,8,1,64,896,20,398
f967ec63-7ebf-4811-bab8-ff22a57caaa8,geogpt-lxz-sft-magpie-llama3-pro-2ep-72b,1719802290,1719802946,finished,1719802330,1719802946,A100-SXM4-80GB,8,16,64,448,40,616
272c2cc5-3c08-4fdd-b23e-583b5bdad97d,geogpt-lxz-cft-wildchat-t1t2-72b,1719802336,1719803009,finished,1719802412,1719803009,A100-SXM4-80GB,8,16,64,448,76,597
c4202efc-f67e-4ab1-9e6b-7c51707e827d,easycontext-zj-8b,1719802547,1719802725,finished,1719802566,1719802725,A100-SXM4-80GB,8,1,64,896,19,159
9de8163b-f7a1-4247-8e67-91e11ffb2f66,sfr-synthetize-data,1719802547,1719802702,finished,1719802566,1719802702,A100-SXM4-80GB,8,1,64,448,19,136
72c5f0b4-38cc-4e77-b646-4122b8bc2dfe,geo-72B-test,1719802592,1719802842,finished,1719802610,1719802842,A100-SXM4-80GB,8,1,64,896,18,232
4aa03512-f15e-4447-97fc-d4280d95dad6,easycontext-zj-8b,1719802725,1719803557,finished,1719802744,1719803557,A100-SXM4-80GB,8,1,64,896,19,813
e54c0727-e633-4324-b376-7b79fd02466e,geogpt-lxz-sft-magpie-qwen2-pro-2ep-72b,1719802788,1719803462,finished,1719802844,1719803462,A100-SXM4-80GB,8,16,64,448,56,618
250bd904-93fd-43de-a9ef-4c40c025a0dc,geo-72B-test,1719802963,1719803380,finished,1719802983,1719803380,A100-SXM4-80GB,8,1,64,896,20,397
55a1139c-a0fb-4e04-ae60-fc7bbc848339,geogpt-lxz-sft-magpie-llama3-pro-2ep-72b,1719803009,1719803666,finished,1719803047,1719803666,A100-SXM4-80GB,8,16,64,448,38,619
ae00f206-39cf-42ae-8452-39dd28c05a83,geogpt-lxz-cft-wildchat-t1t2-72b,1719803073,1719803747,finished,1719803147,1719803747,A100-SXM4-80GB,8,16,64,448,74,600
53541827-298a-4a16-9e10-4e3441f17d15,profiler,1719803201,1719807357,finished,1719803221,1719807357,A100-SXM4-80GB,8,1,64,896,20,4136
ab4383a0-801f-4381-bfde-c600e0c976e5,easycontext-zj-8b-cg,1719803261,1719804081,finished,1719803280,1719804081,A100-SXM4-80GB,8,1,64,896,19,801
5980e360-4bbd-49b8-99c3-5426ec31155c,online-doc-extract,1719803371,1722394388,finished,1719803393,1722394388,A100-SXM4-80GB,8,1,64,448,22,2590995
68b3b11f-5ec4-4bcb-a813-a652888f335b,geogpt-72b-0326-qa-pre,1719803372,1721821920,finished,1719803393,1721821920,A100-SXM4-80GB,8,1,64,448,21,2018527
2b547245-5b22-47f9-aaca-33d4247d0c4a,sfr-synthetize-data,1719803394,1719805369,finished,1719803413,1719805369,A100-SXM4-80GB,8,1,64,448,19,1956
2ede84d9-b6e3-48b7-8162-add19e34d026,geo-72B-test,1719803479,1719803935,finished,1719803498,1719803935,A100-SXM4-80GB,8,1,64,896,19,437
768576ff-14e2-4b7b-ba53-6250d03c1ca0,qwen72Binstruct-dpo,1719803516,1719803661,finished,1719803537,1719803661,A100-SXM4-80GB,8,1,64,896,21,124
69086352-f70d-42a0-94d8-261658bcdd95,geogpt-lxz-sft-magpie-qwen2-pro-2ep-72b,1719803522,1719804377,finished,1719803599,1719804377,A100-SXM4-80GB,8,16,64,448,77,778
23903cce-dbd5-458e-b28e-2be823908eef,easycontext-zj-8b,1719803557,1719803660,finished,1719803576,1719803660,A100-SXM4-80GB,8,1,64,896,19,84
a62512b0-79ed-4545-ac40-eadbe299fc09,geogpt-lxz-sft-magpie-llama3-pro-2ep-72b,1719803723,1719804398,finished,1719803804,1719804398,A100-SXM4-80GB,8,16,64,448,81,594
972e6c58-a909-446c-b75c-8fd9a2991671,easycontext-zj-8b,1719803740,1719804778,finished,1719803760,1719804778,A100-SXM4-80GB,8,1,64,896,20,1018
fece72e8-80e8-4d3a-9a34-d98d93ea6612,qwen2-72b-instruct-judge,1719803792,1719824764,finished,1719803818,1719824764,A100-SXM4-40GB,8,1,32,320,26,20946
f4636f55-1766-4b53-babc-1c05ab90842f,geogpt-lxz-cft-wildchat-t1t2-72b,1719803811,1719805136,finished,1719803892,1719805136,A100-SXM4-80GB,8,16,64,448,81,1244
6b0ea8d5-35b2-4e7a-be18-2e6d9dd07b4a,qwen72Binstruct-dpo,1719803886,1719804688,finished,1719803912,1719804688,A100-SXM4-80GB,8,1,64,896,26,776
c233e197-7c24-47c7-93c0-88344cfa5629,sfr-eval-mteb,1719803911,1719811560,finished,1719803931,1719811560,A100-SXM4-80GB,8,1,64,448,20,7629
4a673cb2-3f9c-4680-805b-9d46b55b6da1,geo-72B-test,1719803935,1719807650,finished,1719803955,1719807650,A100-SXM4-80GB,8,1,64,896,20,3695
7c103757-f7ed-4f82-a39c-444311f76b70,geogpt-prompt-eval-all,1719804167,1720509112,finished,1719804307,1720509112,A100-SXM4-80GB,8,1,64,896,140,704805
a82da686-a4d4-4e3a-80b3-f2e87c089da1,qwen-72b-test,1719804297,1719804927,finished,1719804316,1719804927,A100-SXM4-40GB,8,1,32,320,19,611
09140b56-676a-445d-b436-fb6ee7691259,geogpt-lxz-sft-magpie-qwen2-pro-2ep-72b,1719804436,1719805154,finished,1719804475,1719805154,A100-SXM4-80GB,8,16,64,448,39,679
634801d9-a927-4c99-a2d0-205a6fed31da,geogpt-lxz-sft-magpie-llama3-pro-2ep-72b,1719804457,1719805154,finished,1719804519,1719805154,A100-SXM4-80GB,8,16,64,448,62,635
286a4480-0291-4b98-b982-0abb4a76ebb2,commonbench-chat-vllm-bs1,1719804623,1719813400,finished,1719804642,1719813400,A100-SXM4-80GB,8,1,64,448,19,8758
ab187d06-2daf-41bf-a314-fad8cf64bfc4,qwen72Binstruct-dpo,1719804926,1719806252,finished,1719804946,1719806252,A100-SXM4-80GB,8,1,64,896,20,1306
daad2517-d564-4f24-b305-8b9f1130e434,llama-factory-long,1719804965,1719805527,finished,1719805002,1719805527,A100-SXM4-80GB,8,2,64,896,37,525
143d0b6c-e398-4dc1-abfe-2c37c0199f4c,lzk-qwen15-7b-scihub-abstract-cpt-patch,1719805179,1720026033,finished,1719805196,1720026033,A100-SXM4-80GB,8,1,64,448,17,220837
f8adc7ab-f3c7-4599-9123-92af605dd122,qwen-72b-test,1719805206,1719835027,finished,1719805225,1719835027,A100-SXM4-80GB,8,1,64,448,19,29802
24be0997-6605-4945-8843-cf199f341390,qwen2-cpt8k-extra,1719805314,1719815488,finished,1719805334,1719815488,A100-SXM4-80GB,8,1,64,448,20,10154
ca0549a7-3f5c-440b-8ae5-e5e9acc83f12,lzk-qwen15-7b-scihub-abstract-scpt,1719805628,1720032826,finished,1719805647,1720032826,A100-SXM4-80GB,8,1,64,448,19,227179
596fbbcc-4fd0-45a6-bfd1-81c8983b69d1,geogpt-smoe-eval,1719805660,1719866973,finished,1719805679,1719866973,A100-SXM4-80GB,8,1,64,448,19,61294
d3ef8b75-76c9-46c1-bec3-b81223087555,geo-table-datav041,1719806690,1719806728,finished,1719806710,1719806728,A100-SXM4-40GB,8,1,32,320,20,18
5699f9dd-7095-4d40-b6d1-c1e62f7064a2,geogept-gate-eval,1719807276,1719830825,finished,1719807294,1719830825,A100-SXM4-80GB,8,1,64,448,18,23531
8895c510-974c-493f-9b12-4671903b05d1,geogpt-llama3-eval,1719807709,1719807804,finished,1719807729,1719807804,A100-SXM4-80GB,8,1,64,448,20,75
b4dfd80b-86d0-41cf-896d-9679fddf3491,geo-72B-test,1719807744,1719808963,finished,1719807763,1719808963,A100-SXM4-80GB,8,1,64,896,19,1200
013c47e4-f4aa-494f-a683-9458301697ec,test-zz,1719807756,1719880818,finished,1719807776,1719880818,A100-SXM4-80GB,8,1,64,896,20,73042
b00d7312-88a5-4163-99fa-8f168f7d223a,test-xiaodianq,1719807849,1719870210,finished,1719807868,1719870210,A100-SXM4-80GB,8,1,64,896,19,62342
5a0fbbe1-c36c-440a-833a-c371ed7cb2b1,geogpt-llama3-eval,1719807915,1719808006,finished,1719807933,1719808006,A100-SXM4-80GB,8,1,64,448,18,73
a315769f-2f0b-404b-b760-692dcdcc717d,geogpt-llama3-eval,1719808097,1719808222,finished,1719808115,1719808222,A100-SXM4-80GB,8,1,64,448,18,107
4fa83116-5162-45a1-a52e-ebdc206d6525,geogpt-llama3-eval,1719808331,1719808602,finished,1719808349,1719808602,A100-SXM4-80GB,8,1,64,448,18,253
b261947a-220e-434b-a80d-33841b1769fd,test-2,1719808995,1719809611,finished,1719809012,1719809611,A100-SXM4-80GB,8,1,64,896,17,599
08ca067f-64d1-4bd3-b359-c40487aaa254,profiler,1719809123,1719818625,finished,1719809142,1719818625,A100-SXM4-80GB,8,1,64,896,19,9483
338c6eca-330e-4a55-8ea9-4bb34ba9a46d,geo-base-offline-eval,1719809128,1719821514,finished,1719809146,1719821514,A100-SXM4-80GB,8,1,64,448,18,12368
98e67a2d-0c3e-4e96-9b4e-c195b1bcb312,txchen-lm-eval2,1719809769,1719810136,finished,1719809788,1719810136,A100-SXM4-80GB,8,1,64,448,19,348
590229c9-5905-4d01-9493-d0ec21c4d349,geo-table-datav041,1719809799,1719823944,finished,1719809818,1719823944,A100-SXM4-80GB,8,1,64,448,19,14126
c1f60cb6-99ef-4735-b83d-ef0e115003b5,geo-router-block-weight,1719810038,1719810314,finished,1719810165,1719810314,A100-SXM4-80GB,8,2,64,448,127,149
3d0e181d-9edd-4b4d-b111-7ba1f367a683,test-2,1719810197,1719836615,finished,1719810291,1719836615,A100-SXM4-80GB,8,1,64,896,94,26324
9ceef109-0347-4cd0-9763-af52f8507beb,geo-72B-test,1719810240,1719810434,finished,1719810277,1719810434,A100-SXM4-80GB,8,1,64,896,37,157
266c8d8f-8da4-49de-9468-dcbbb79b408e,geo-72B-test,1719810411,1719813858,finished,1719810434,1719813858,A100-SXM4-80GB,8,1,64,896,23,3424
3351f3bb-49be-436c-87d6-d9fd84bfd42a,txchen-lm-eval2,1719810591,1719818288,finished,1719811553,1719818288,A100-SXM4-80GB,8,1,64,448,962,6735
a5ccc2ff-5293-4ff8-aca8-2cc42dcf183a,qwen-72b-test,1719813280,1719814267,finished,1719813299,1719814267,A100-SXM4-40GB,8,1,32,320,19,968
99116bef-0d92-4a65-81c0-1229ead1ed13,geogpt-lxz-sft-magpie-qwen2-pro-2ep-72b,1719813507,1719829372,finished,1719814621,1719829372,A100-SXM4-80GB,8,16,64,448,1114,14751
dcd87731-5be5-46e0-a273-ec367086a6cf,geogpt-lxz-sft-magpie-llama3-pro-2ep-72b,1719813546,1719818912,finished,1719818866,1719818912,A100-SXM4-80GB,8,16,64,448,5320,46
9f0754ec-24b0-48fa-b7cc-40a6ba74b0dd,sfr-eval-mteb,1719813710,1719817070,finished,1719813732,1719817070,A100-SXM4-80GB,8,1,64,448,22,3338
45c2c2ee-462f-40bb-bfdb-bcb8e46c249f,llama-factory-long,1719813733,1719815450,finished,1719814615,1719815450,A100-SXM4-80GB,8,2,64,896,882,835
af7e0e3d-9b13-4223-af21-accf390846e7,geo-router-block-weight-init,1719813897,1719814821,finished,1719814643,1719814821,A100-SXM4-80GB,8,2,64,448,746,178
fa8b6ca7-0def-430a-9de5-d9e6f6a80856,geogpt-llama3-eval,1719813998,1719814292,finished,1719814019,1719814292,A100-SXM4-80GB,8,1,64,448,21,273
e2b76563-9b9a-4b32-bc6f-85c46eac5aec,geo-MoD-1-8B,1719814130,1719816145,finished,1719814150,1719816145,A100-SXM4-80GB,8,1,64,448,20,1995
3c01d298-132f-49f1-ada7-5e5318e03ac4,geo-table-datav05-lora-5e-5,1719814170,1719816336,finished,1719814267,1719816336,A100-SXM4-80GB,8,1,64,448,97,2069
11c5d15b-6e90-4d47-8600-3947d6d03cb6,qwen-72b-test,1719814306,1719816080,finished,1719814326,1719816080,A100-SXM4-40GB,8,1,32,320,20,1754
ca83995d-e2ae-4b10-bfec-db46a7d4e017,geogpt-llama3-eval,1719814476,1719814768,finished,1719814493,1719814768,A100-SXM4-80GB,8,1,64,448,17,275
89585b61-7864-4bee-8dd1-3fc80a82fa92,syh-subspace-moe-mathmed,1719814563,1719814711,finished,1719814587,1719814711,A100-SXM4-80GB,8,1,64,448,24,124
54b7dff0-9d0e-4523-a01b-9a26283aa1a4,syh-subspace-moe-math,1719814563,1719814693,finished,1719814587,1719814693,A100-SXM4-80GB,8,1,64,448,24,106
4bfd31df-8b3a-47f9-9bae-a7128e8a6875,geogpt-72b-0206,1719814651,1719838638,finished,1719814672,1719838638,A100-SXM4-80GB,8,1,64,448,21,23966
ef244e9c-6506-4626-aacd-8d6a314828f3,geo-llamapro-1-5B,1719814761,1719818473,finished,1719814783,1719818473,A100-SXM4-80GB,8,1,64,448,22,3690
289d9f31-7e6b-46f0-9a5a-50527cfd260d,geo-72B-test,1719814763,1719814975,finished,1719814802,1719814975,A100-SXM4-80GB,8,2,64,896,39,173
050307b3-9db2-48d0-a115-c9e322e7630d,geogpt-dairui-model-merge-exp-1,1719814898,1719854088,finished,1719814919,1719854088,A100-SXM4-80GB,8,1,64,896,21,39169
670c9323-1251-4067-8edd-0e539f9f2f23,geogpt-dairui-eval-code-2,1719814919,1719815806,finished,1719814938,1719815806,A100-SXM4-80GB,8,1,64,448,19,868
e18ffb67-d864-4fba-a967-3d503d98ded7,geogpt-llama3-eval,1719814943,1719815225,finished,1719814961,1719815225,A100-SXM4-80GB,8,1,64,448,18,264
6a3b1e75-f458-43c7-871e-585ece33ead7,geogpt-eval-latest,1719815054,1720099238,finished,1719815075,1720099238,A100-SXM4-80GB,8,1,64,896,21,284163
789b033a-7b89-4cdf-9a26-4f3f18f4abbf,geo-72B-test,1719815072,1719815277,finished,1719815128,1719815277,A100-SXM4-80GB,8,2,64,896,56,149
3a0b6ff5-1cd8-4f76-b322-5b4bc1ea688d,geo-72B-test,1719815376,1719815592,finished,1719815435,1719815592,A100-SXM4-80GB,8,2,64,896,59,157
e9566679-3b69-4604-98de-7ceade2efabe,llama-factory-long,1719815450,1719816178,finished,1719815510,1719816178,A100-SXM4-80GB,8,2,64,896,60,668
44c721a7-05bb-4eed-ac9f-0f8068598e90,qwen2-72b-instruct-extra-128k-fa83c-auto,1719815507,1719816235,finished,1719815530,1719816235,A100-SXM4-80GB,8,4,64,896,23,705
1de34b3b-73df-4b2b-bc68-3835dea2fd43,geo-72B-test,1719815686,1719815903,finished,1719815742,1719815903,A100-SXM4-80GB,8,2,64,896,56,161
82e1943e-c1f5-4159-b617-ffaea9414534,geogpt-dairui-model-merge-exp-2,1719815784,1719864424,finished,1719815806,1719864424,A100-SXM4-80GB,8,1,64,896,22,48618
b7c811b2-16f2-4dbc-8c93-e97da34dfec4,geo-router-block-weight-init,1719815941,1719881590,finished,1719816002,1719881590,A100-SXM4-80GB,8,2,64,448,61,65588
e269db1f-f538-4fce-83f6-d0316058fefb,geogpt-dairui-eval-code,1719816001,1719816338,finished,1719816023,1719816338,A100-SXM4-80GB,8,1,64,896,22,315
c5527475-bac5-4c4f-8e42-b059ee2dec95,geo-72B-test,1719816105,1719816338,finished,1719816162,1719816338,A100-SXM4-80GB,8,2,64,896,57,176
f19a5462-ea27-4b60-9ed9-45502c7d4e90,llama-factory-long,1719816178,1719816705,finished,1719816236,1719816705,A100-SXM4-80GB,8,2,64,896,58,469
ec88ddcf-f483-4c1d-95df-4bf964f78161,geogpt-dairui-eval-code,1719816338,1719817267,finished,1719816357,1719817267,A100-SXM4-80GB,8,1,64,896,19,910
803072a9-88f3-4ae7-97e0-7290a503e19a,geo-table-datav05-lora-5e-5,1719816415,1719817802,finished,1719816435,1719817802,A100-SXM4-80GB,8,1,64,448,20,1367
96f1eb66-6863-4101-984f-965ec6679f07,geo-72B-test,1719816436,1719816592,finished,1719816474,1719816592,A100-SXM4-80GB,8,2,64,896,38,118
55946d24-6eb0-46e2-bc8a-361c505f0eec,geogpt-72b-1215,1719816537,1719888352,finished,1719816559,1719888352,A100-SXM4-80GB,8,1,64,448,22,71793
e26cc321-47fd-492d-9cb5-53e6686c3ee3,syh-subspace-moe-math,1719816559,1719817524,finished,1719816620,1719817524,A100-SXM4-80GB,8,1,64,448,61,904
504cfea5-2861-4f61-94cc-7dae65de7f0b,syh-subspace-moe-mathmed,1719816559,1719819451,finished,1719816580,1719819451,A100-SXM4-80GB,8,1,64,448,21,2871
9b269b57-6825-4020-b7f2-0dc59ab0f70c,txchen-cpu-task,1719816601,1719817295,finished,1719816620,1719817295,A100-SXM4-80GB,8,1,64,448,19,675
53dbd957-4b17-4bfd-bd9b-354694661fa5,geo-72B-test,1719816651,1719818259,finished,1719818084,1719818259,A100-SXM4-80GB,8,2,64,896,1433,175
ac66f297-6088-4f39-8c91-984fd88d68fc,geogpt-qwen2-chat-0612dpo-linear-w55,1719816788,1719979398,finished,1719816809,1719979398,A100-SXM4-80GB,8,1,64,448,21,162589
f4f66c65-77e9-4760-b72a-680167120924,llama-factory-long,1719816802,1719817339,finished,1719816841,1719817339,A100-SXM4-80GB,8,2,64,448,39,498
259ac9a6-122d-4f18-b834-34340c23f0dd,qwen2-72b-instruct-extra-128k-07950-auto,1719817008,1719819554,finished,1719817032,1719819554,A100-SXM4-80GB,8,1,64,896,24,2522
4e6383c6-c0ba-4beb-a1c0-77e8a206e145,sfr-eval-mteb,1719817129,1719822863,finished,1719817149,1719822863,A100-SXM4-80GB,8,1,64,448,20,5714
51423511-d1bf-459f-b7bb-897ac707f644,geogpt-dairui-eval-code,1719817267,1719818144,finished,1719817286,1719818144,A100-SXM4-80GB,8,1,64,896,19,858
e6e95a1c-637f-4b92-85a6-6ef33f0c2546,txchen-cpu-task,1719817467,1719818114,finished,1719817487,1719818114,A100-SXM4-80GB,8,1,64,448,20,627
86c52de1-8e6e-4053-8145-29fc06e684ea,llama-factory-long,1719817667,1719818275,finished,1719817744,1719818275,A100-SXM4-80GB,8,2,64,448,77,531
369df8d1-864b-4046-9423-9361279e7347,easycontext-zj-8b,1719817895,1719818944,finished,1719817914,1719818944,A100-SXM4-80GB,8,1,64,896,19,1030
41d97327-243c-4e4f-a596-3ab4f56bc7f5,llama-factory-long,1719818276,1719818837,finished,1719818335,1719818837,A100-SXM4-80GB,8,2,64,448,59,502
152ce186-994a-424d-9a52-0a50aff1f197,txchen-cpu-task,1719818288,1719818423,finished,1719818309,1719818423,A100-SXM4-80GB,8,1,64,448,21,114
b0be7811-bcb7-4ddb-b6a2-479f96168d9e,geo-72B-test,1719818358,1719818573,finished,1719818415,1719818573,A100-SXM4-80GB,8,2,64,896,57,158
c07a8a92-f900-49b8-820d-49cb9acb43cc,syh-subspace-eval,1719818461,1719824572,finished,1719818482,1719824572,A100-SXM4-80GB,8,1,64,448,21,6090
1fbc7629-7977-451d-9534-b025613e10f7,txchen-cpu-task,1719818542,1719818696,finished,1719818562,1719818696,A100-SXM4-80GB,8,1,64,448,20,134
15f2343e-9911-4a13-99f4-ff4eac81e0f1,geo-72B-test,1719818688,1719818948,finished,1719818765,1719818948,A100-SXM4-80GB,8,2,64,896,77,183
36ee0b41-5f01-4d23-a25b-db961b2b9847,txchen-cpu-task,1719818812,1719819507,finished,1719818831,1719819507,A100-SXM4-80GB,8,1,64,448,19,676
c8a16f87-ae06-41b9-821e-2d4342cfa804,geogpt-dairui-eval-code,1719818863,1719819113,finished,1719818888,1719819113,A100-SXM4-80GB,8,1,64,896,25,225
9e92cea6-e246-4b8d-ae3e-d49bf3907a8b,geogpt-lxz-sft-magpie-llama3-pro-2ep-72b,1719818971,1719819118,finished,1719818990,1719819118,A100-SXM4-80GB,8,16,64,448,19,128
1a22ef6a-d5d5-4703-abef-6d376c95d349,megatron-gpt-16nodes,1719819090,1719819535,finished,1719819487,1719819535,A100-SXM4-80GB,8,16,64,448,397,48
7b3e7985-f425-400b-a8bc-ad2f84d7ae4b,geogpt-dairui-eval-code,1719819113,1719820273,finished,1719819433,1719820273,A100-SXM4-80GB,8,1,64,896,320,840
644cadf9-2a2d-4fe2-8c70-51d6961c3f2d,geo-72B-test,1719819114,1719819597,finished,1719819466,1719819597,A100-SXM4-80GB,8,2,64,896,352,131
21bb19ca-2488-491d-9547-1ffa114bb531,geogpt-lxz-sft-magpie-llama3-pro-2ep-72b,1719819118,1719820711,finished,1719819542,1719820711,A100-SXM4-80GB,8,16,64,448,424,1169
a32addc1-599a-4d36-b692-de36c3744615,geogpt-llama3-eval,1719819502,1719819780,finished,1719819526,1719819780,A100-SXM4-80GB,8,1,64,448,24,254
fbf57f0b-b214-4058-b58d-6a8948f55db3,geo-router-tag-1,1719819636,1719819855,finished,1719819676,1719819855,A100-SXM4-80GB,8,4,64,448,40,179
2f12797d-2fba-499f-b487-b9bba9fb0655,geo-72B-test,1719819755,1719819856,finished,1719819816,1719819856,A100-SXM4-80GB,8,4,64,896,61,40
7fe91081-2e74-4446-9ec4-b8a4041506a3,txchen-lm-eval2,1719819804,1719842051,finished,1719819881,1719842051,A100-SXM4-80GB,8,1,64,448,77,22170
df8e43bc-d391-4b43-8b69-096248fdebb0,easycontext-zj-8b,1719819812,1719820007,finished,1719819832,1719820007,A100-SXM4-80GB,8,1,64,896,20,175
bc1211ca-595c-4747-820c-5d66bca2fe1f,geo-72B-test,1719819915,1719822972,finished,1719819992,1719822972,A100-SXM4-80GB,8,4,64,896,77,2980
505e92b7-757c-48e4-a3f5-1d0cc0ca982f,geo-router-tag-1,1719819954,1719820546,finished,1719820352,1719820546,A100-SXM4-80GB,8,4,64,448,398,194
30a83eb8-bbd9-4ac8-bdd5-b4303db28ac9,llama-factory-long,1719820250,1719820464,finished,1719820307,1719820464,A100-SXM4-80GB,8,2,64,448,57,157
258d5210-5615-4f2b-9709-a6917b23512e,easycontext-zj-8b,1719820250,1719820561,finished,1719820268,1719820561,A100-SXM4-80GB,8,1,64,896,18,293
5ce93690-620f-4e1d-9ae2-8f8cbc45e940,geogpt-72b-0412,1719820337,1719820860,finished,1719820360,1719820860,A100-SXM4-80GB,8,1,64,448,23,500
617d40bb-ec4c-4dad-9113-b503800df9cc,geogpt-0612,1719820339,1719820810,finished,1719820360,1719820810,A100-SXM4-80GB,8,1,64,448,21,450
7aba820f-6792-437e-91a7-547a71433bdc,geogpt-0612-merge-linear-w55,1719820360,1719820812,finished,1719820381,1719820812,A100-SXM4-80GB,8,1,64,448,21,431
f2ca8ff9-2666-4ae9-8d3e-a0a434d2941f,easycontext-zj-8b-cg,1719820502,1719821327,finished,1719820522,1719821327,A100-SXM4-80GB,8,1,64,896,20,805
65265694-9e58-44a7-be9d-6c9405f6da4a,easycontext-zj-8b,1719820561,1719820692,finished,1719820580,1719820692,A100-SXM4-80GB,8,1,64,896,19,112
eae8c0ce-0244-4129-98e0-5258286d8b9d,sfr-embedding-test,1719820776,1719907431,finished,1719820826,1719907431,A100-SXM4-80GB,8,1,64,448,50,86605
0078ab87-e8f8-47ec-b87f-c81c44d9b8d6,easycontext-zj-8b,1719820778,1719821830,finished,1719820826,1719821830,A100-SXM4-80GB,8,1,64,896,48,1004
ed4a6883-f6b2-41dd-9b3c-2aea52b0de1d,geo-table-datav05-lora-5e-5,1719820787,1719823925,finished,1719820851,1719823925,A100-SXM4-80GB,8,1,64,448,64,3074
4e1e1e84-070e-41ba-a3cb-22e04cc772fa,geogpt-lxz-sft-magpie-llama3-pro-2ep-72b,1719820799,1719820922,finished,1719820875,1719820922,A100-SXM4-80GB,8,16,64,448,76,47
8468b864-9700-4cc5-821b-7b00870dfb4e,geogpt-0612,1719820811,1719821340,finished,1719820861,1719821340,A100-SXM4-80GB,8,1,64,448,50,479
2def08f9-3d77-47c5-a516-5d75a92fa71f,geogpt-0612-merge-linear-w55,1719820813,1719821340,finished,1719820839,1719821340,A100-SXM4-80GB,8,1,64,448,26,501
85ab21e4-57b6-494b-81d1-ab4289d15fd9,geogpt-72b-0412,1719820860,1719821364,finished,1719820887,1719821364,A100-SXM4-80GB,8,1,64,448,27,477
eeea0239-5149-429a-939a-9905bab7cfc9,geogpt-lxz-sft-magpie-llama3-pro-2ep-72b,1719820979,1719821082,finished,1719821037,1719821082,A100-SXM4-80GB,8,16,64,448,58,45
945fd20c-3dbd-4f35-b0cd-2be478bd9d1c,geogpt-lxz-sft-magpie-llama3-pro-2ep-72b,1719821177,1719821312,finished,1719821199,1719821312,A100-SXM4-80GB,8,16,64,448,22,113
f6d6df93-d884-483b-ae30-ce98943e59d5,q72b-chat-0612dpo-ties-w55-d5050-81522-auto,1719821201,1719821309,finished,1719821223,1719821309,A100-SXM4-80GB,8,1,64,448,22,86
738b48eb-806a-48e4-9ccf-65b6429532ba,q72b-chat-0612dpo-ties-w55-d5050-ab102-auto,1719821202,1719821309,finished,1719821223,1719821309,A100-SXM4-80GB,8,1,64,448,21,86
f84d0588-c213-4b20-b3e1-2dde68a80733,q72b-chat-0612dpo-ties-w55-d5075-a5f76-auto,1719821271,1719821381,finished,1719821310,1719821381,A100-SXM4-80GB,8,1,64,448,39,71
aae0a29f-2f58-45b3-9b57-94e072ed9499,q72b-chat-0612dpo-ties-w55-d50100-17b15-auto,1719821272,1719821381,finished,1719821310,1719821381,A100-SXM4-80GB,8,1,64,448,38,71
c29ef64d-22ec-4d39-8010-2ca1aa8cd902,geogpt-lxz-sft-magpie-llama3-pro-2ep-72b,1719821312,1719821434,finished,1719821381,1719821434,A100-SXM4-80GB,8,16,64,448,69,53
eef24c49-1a90-42b9-ac4d-3dc45e45920f,geogpt-0612,1719821340,1719908610,finished,1719821364,1719908610,A100-SXM4-80GB,8,1,64,448,24,87246
91970771-a0aa-4887-af0b-eea50c4e956c,geogpt-0612-merge-linear-w55,1719821341,1719907743,finished,1719821364,1719907743,A100-SXM4-80GB,8,1,64,448,23,86379
445aeb88-db9d-4411-b313-64ade8259694,geo-router-tag-1,1719821356,1719821451,finished,1719821409,1719821451,A100-SXM4-80GB,8,4,64,448,53,42
f1f22ad9-1ad3-45c8-83c4-74806be2fe5c,geogpt-72b-0412,1719821364,1719839364,finished,1719821420,1719839364,A100-SXM4-80GB,8,1,64,448,56,17944
65e3c27a-5ef5-40ae-aac3-81cf196ad898,geogpt-7b-chat-lp40-25bgeo,1719821478,1719821565,finished,1719821520,1719821565,A100-SXM4-80GB,8,16,64,448,42,45
b8cc234c-01c8-409d-b139-3e042643f730,geogpt-lxz-sft-magpie-llama3-pro-2ep-72b,1719821498,1719821666,finished,1719821619,1719821666,A100-SXM4-80GB,8,16,64,448,121,47
b99d7280-2877-4325-94eb-b30a32efddaa,geo-router-tag-1,1719821514,1719823526,finished,1719821539,1719823526,A100-SXM4-80GB,8,4,64,448,25,1987
13e4e7ee-da3d-4303-a9d0-b7cbfd78dc4c,q72b-chat-0612dpo-ties-w55-d5075-e134a-auto,1719821686,1719827655,finished,1719821707,1719827655,A100-SXM4-80GB,8,1,64,448,21,5948
01f2e7cb-a144-4180-a345-2a6303e34c82,q72b-chat-0612dpo-ties-w55-d50100-0887a-auto,1719821689,1719827655,finished,1719821707,1719827655,A100-SXM4-80GB,8,1,64,448,18,5948
94a09982-2fec-4ead-b1e2-a05371d2c669,geogpt-lxz-sft-magpie-llama3-pro-2ep-72b,1719821730,1719821837,finished,1719821789,1719821837,A100-SXM4-80GB,8,16,64,448,59,48
cbe832f2-8c79-4684-a33c-ad017601faad,q72b-chat-0612dpo-ties-w55-d5050-a7c80-auto,1719821730,1719827656,finished,1719821750,1719827656,A100-SXM4-80GB,8,1,64,448,20,5906
d2c89f55-f034-4bb3-b08e-76946f18d2ae,geogpt-mixtral-eval,1719822035,1720223976,finished,1719822057,1720223976,A100-SXM4-80GB,8,1,64,896,22,401919
761fc228-c297-4341-8b38-a1ee827706f9,geogpt-lxz-sft-magpie-llama3-pro-2ep-72b,1719822036,1719830329,finished,1719822079,1719830329,A100-SXM4-80GB,8,16,64,448,43,8250
465dff32-811a-4edd-99f8-b88fc8b5c8d0,citysora-cele-ppm-cosmic,1719822166,1719905100,finished,1719822267,1719905100,A100-SXM4-80GB,8,4,64,896,101,82833
2e882cbb-f1b6-4994-9ebc-9ead880920e9,intent-train-llm-gpt,1719822188,1719823365,finished,1719822210,1719823365,A100-SXM4-80GB,8,1,64,448,22,1155
f082837f-0277-457c-bfed-317f9fb82037,geogpt-7b-chat-lp40-25bgeo,1719822198,1719833591,finished,1719829428,1719833591,A100-SXM4-80GB,8,16,64,448,7230,4163
5386bc67-8886-483a-9052-32a497b1935e,q72b-chat-0612dpo-ties-w55-d50100-20cbc-auto,1719822218,1719827657,finished,1719822974,1719827657,A100-SXM4-80GB,8,1,64,448,756,4683
3340a18a-6e55-4789-990e-ee8b0cea03d1,q72b-chat-0612dpo-ties-w55-d5050-0db64-auto,1719822242,1719827633,finished,1719822270,1719827633,A100-SXM4-80GB,8,1,64,448,28,5363
d6e3fe68-5740-49d2-9902-7418d10eccdb,q72b-chat-0612dpo-ties-w55-d5075-904af-auto,1719822244,1719827657,finished,1719824584,1719827657,A100-SXM4-80GB,8,1,64,448,2340,3073
882f5acb-182c-4a63-b5bd-4b53eb2cf5d0,llama3-70b-instruct,1719822250,1719996760,finished,1719822979,1719996760,A100-SXM4-80GB,8,1,64,448,729,173781
534aa3fd-c358-423a-afee-90496c54e949,geo-seesaw-sft-translate,1719822575,1719829408,finished,1719822846,1719829408,A100-SXM4-80GB,8,1,64,896,271,6562
037ca48d-4f3c-4666-a2b4-e180c6a97161,qwen-72b-test,1719822653,1719822843,finished,1719822674,1719822843,A100-SXM4-40GB,8,1,32,320,21,169
e58e0655-f631-4441-aa99-7f2c53294d16,geogpt-0521-llama3,1719822723,1719900840,finished,1719825649,1719900840,A100-SXM4-80GB,8,1,64,448,2926,75191
b4b42aec-3d10-4a84-86da-78086a328d40,easycontext-zj-8b,1719822816,1719823826,finished,1719822987,1719823826,A100-SXM4-80GB,8,1,64,896,171,839
8abe9cfc-71e4-493e-9832-a63b1f089800,qwen-72b-test,1719822929,1719823167,finished,1719822950,1719823167,A100-SXM4-40GB,8,1,32,320,21,217
8f51faf9-b92d-4cb0-bf5f-2deeb3268efa,sfr-eval-mteb,1719822947,1719827587,finished,1719822987,1719827587,A100-SXM4-80GB,8,1,64,448,40,4600
2466a43f-a077-469b-9797-be15143a920b,geo-72B-test,1719822972,1719824564,finished,1719823347,1719824564,A100-SXM4-80GB,8,1,64,896,375,1217
5669f516-774f-4e85-8766-d9728d4a287b,geogpt-lxz-cft-wildchat-t1t2-72b,1719823113,1719833863,finished,1719829411,1719833863,A100-SXM4-80GB,8,16,64,448,6298,4452
4feda727-8c56-4f8c-b7bd-a11fbd4e47e8,intent-test-llm-all,1719823523,1719824655,finished,1719823942,1719824655,A100-SXM4-80GB,8,1,64,448,419,713
9bbc19d8-5d53-43cb-b6e7-e7864ea47f97,geogpt-dairui-eval-code,1719823624,1719825407,finished,1719823945,1719825407,A100-SXM4-80GB,8,1,64,896,321,1462
a26cf6f6-1930-4c85-9107-8f2a42c1b487,geo-router-tag-1,1719823771,1719829662,finished,1719829496,1719829662,A100-SXM4-80GB,8,4,64,448,5725,166
0145bd15-50e1-4f64-81e1-296571e254bb,easycontext-zj-8b-cg,1719823788,1719824152,finished,1719823826,1719824152,A100-SXM4-80GB,8,1,64,896,38,326
e4d78b60-3c3d-433c-b5e8-e7eeb9926136,easycontext-zj-8b,1719823826,1719824945,finished,1719824653,1719824945,A100-SXM4-80GB,8,1,64,896,827,292
7ed34918-7995-4737-a92b-e31b4f1865f2,syh-subspace-moe-mathmed,1719824084,1719827190,finished,1719824487,1719827190,A100-SXM4-80GB,8,1,64,448,403,2703
39ee4670-72be-4cf4-b573-e8b11a1b5255,syh-fullsft-mathmed,1719824085,1719828800,finished,1719824144,1719828800,A100-SXM4-80GB,8,1,64,448,59,4656
a8a0457c-b743-4c27-89ea-1ca61c40d926,citysora-modelv4-cele-ppm-65-512,1719824119,1719829369,finished,1719827855,1719829369,A100-SXM4-80GB,8,5,64,896,3736,1514
fdd8e222-fd19-41ae-ae77-6b01f6586826,easycontext-zj-8b-cg,1719824152,1719827606,finished,1719826835,1719827606,A100-SXM4-80GB,8,1,64,896,2683,771
46b5085d-0814-4f35-b5b7-4b162d8f4bb7,geo-72B-test,1719824564,1719826839,finished,1719826671,1719826839,A100-SXM4-80GB,8,4,64,896,2107,168
6c0718f6-5ab3-4141-9aa0-65255322893a,qwen2-72b-instruct-judge,1719824821,1720018932,finished,1719824842,1720018932,A100-SXM4-40GB,8,1,32,320,21,194090
75b109b4-5b43-40a7-83ca-5596dfcef911,intent-test-llm-all,1719824871,1719825658,finished,1719824965,1719825658,A100-SXM4-80GB,8,1,64,448,94,693
903a4282-dc8a-43a4-a12c-1a105f193da8,easycontext-zj-8b,1719824945,1719826035,finished,1719825403,1719826035,A100-SXM4-80GB,8,1,64,896,458,632
f13aa21f-6210-4e95-ac56-276a6f7d28f3,GeoGPT-0630,1719825891,1719829353,finished,1719825914,1719829353,A100-SXM4-40GB,8,1,32,320,23,3439
0313cfbf-e38f-42ca-853d-7ceb4a3ef25d,geogpt-dairui-eval-code,1719825925,1719826167,finished,1719826019,1719826167,A100-SXM4-80GB,8,1,64,896,94,148
022946e7-d165-4e6f-8b22-fd6aaaf2440b,easycontext-zj-8b,1719826035,1719826901,finished,1719826163,1719826901,A100-SXM4-80GB,8,1,64,896,128,738
1bcd1e75-0ab4-4818-8d12-da245f9f54e3,citysora-modelv4-cele-ppm-121-512,1719826670,1719905077,finished,1719826820,1719905077,A100-SXM4-80GB,8,4,64,896,150,78257
7802eb3b-9a5b-4551-afe8-63e8429b11c7,geogpt-dairui-eval-code,1719826883,1719829408,finished,1719827572,1719829408,A100-SXM4-80GB,8,1,64,896,689,1836
1ffc6396-d2ff-43e1-8e54-856c844c2576,easycontext-zj-8b,1719826901,1719828927,finished,1719827198,1719828927,A100-SXM4-80GB,8,1,64,896,297,1729
7e0a4904-c3e7-4cac-9573-2b3a6354d922,geo-72B-test,1719826963,1719827919,finished,1719827717,1719827919,A100-SXM4-80GB,8,4,64,896,754,202
f20b6daa-2dd1-44c7-856d-ed513e04c383,sfr-eval-mteb,1719827672,1719895665,finished,1719827692,1719895665,A100-SXM4-80GB,8,1,64,448,20,67973
ef7b736f-0a40-4a4d-9d27-37acb2e4bc2f,syh-subspace-eval,1719828375,1719915257,finished,1719828800,1719915257,A100-SXM4-80GB,8,1,64,448,425,86457
5dfa09a0-713b-4b66-9699-426d4ae9829f,geo-72B-test,1719828520,1719829580,finished,1719829408,1719829580,A100-SXM4-80GB,8,4,64,896,888,172
0143d410-ff87-4a4c-9c4b-7382c2806c1a,citysora-modelv4-cele-ppm-65-512,1719829369,1719905101,finished,1719829475,1719905101,A100-SXM4-80GB,8,5,64,896,106,75626
320a7f89-4610-4760-b356-17bd02a87714,geogpt-mixtral-eval-common,1719829373,1720496542,finished,1719829411,1720496542,A100-SXM4-80GB,8,1,64,896,38,667131
ff298ab4-8dae-40d2-b4e1-1f565044e757,q72b-ties-w55-d5050-4221c-auto,1719829420,1719840236,finished,1719829454,1719840236,A100-SXM4-80GB,8,1,64,448,34,10782
c48977d2-2976-499b-9b78-a9bd11c4e9db,q72b-ties-w55-d5075-b5a99-auto,1719829422,1719839379,finished,1719829454,1719839379,A100-SXM4-80GB,8,1,64,448,32,9925
ad353c42-9127-4775-bbee-65d5fe5ac748,q72b-ties-w55-d5025-2923f-auto,1719829424,1719844757,finished,1719829454,1719844757,A100-SXM4-80GB,8,1,64,448,30,15303
6bd7582f-d4a2-4adc-84a4-d4de10641b1c,q72b-ties-w55-d50100-5afe3-auto,1719829426,1719840771,finished,1719829454,1719840771,A100-SXM4-80GB,8,1,64,448,28,11317
8ab0b66a-fabc-4b58-8013-11524f42560e,geogpt-mixtral-test,1719829454,1719837770,finished,1719834291,1719837770,A100-SXM4-80GB,8,64,64,896,4837,3479
15b3cd12-2e98-424b-b0db-c835481ada3e,geogpt-lxz-sft-magpie-qwen2-pro-2ep-72b,1719829478,1719833023,finished,1719829518,1719833023,A100-SXM4-80GB,8,16,64,448,40,3505
a98e8e79-2e81-401c-bcb3-22bb01b20477,geo-72B-test,1719829705,1719829965,finished,1719829767,1719829965,A100-SXM4-80GB,8,4,64,896,62,198
84e6c63f-ee20-4294-a6b2-ee707d336f48,geo-router-tag-1,1719829787,1719830025,finished,1719829846,1719830025,A100-SXM4-80GB,8,4,64,448,59,179
a8f38d12-1567-480d-8ce2-1353c4d887cd,geo-MoD-1-8B,1719829924,1719830084,finished,1719829944,1719830084,A100-SXM4-80GB,8,1,64,448,20,140
4ac7a987-af5e-4207-8970-0489a627e68e,geo-72B-test,1719830084,1719830327,finished,1719830146,1719830327,A100-SXM4-80GB,8,4,64,896,62,181
eb2360ba-b634-4c7a-87e5-6d7c76675792,geo-router-tag-1,1719830126,1719830347,finished,1719830167,1719830347,A100-SXM4-80GB,8,4,64,448,41,180
1d52a332-8db7-44af-a5f0-08609ea12f2e,geo-MoD-1-8B,1719830188,1719830366,finished,1719830207,1719830366,A100-SXM4-80GB,8,1,64,448,19,159
cdb1e19f-6696-46cb-acdd-1b16477f56be,geogpt-lxz-sft-magpie-llama3-pro-2ep-72b,1719830392,1719833863,finished,1719830455,1719833863,A100-SXM4-80GB,8,16,64,448,63,3408
efdbc20f-3ffe-4e45-8834-2a57194d76f0,geo-72B-test,1719830452,1719830677,finished,1719830500,1719830677,A100-SXM4-80GB,8,4,64,896,48,177
fc94f556-923b-4795-a25a-9d5f220cca54,geo-router-tag-1,1719830479,1719830716,finished,1719830521,1719830716,A100-SXM4-80GB,8,4,64,448,42,195
b31181b2-0eaf-423d-a9e0-9f404d9399ac,geo-MoD-1-8B,1719830499,1719830677,finished,1719830521,1719830677,A100-SXM4-80GB,8,1,64,448,22,156
47bfa692-9c8a-446e-95f4-ef084601cc3e,geo-72B-test,1719830778,1719831018,finished,1719830840,1719831018,A100-SXM4-80GB,8,4,64,896,62,178
cd7867f2-7f7a-44d3-8cd8-53875862c3b8,geo-MoD-1-8B,1719830797,1719830979,finished,1719830819,1719830979,A100-SXM4-80GB,8,1,64,448,22,160
0e83fec2-0154-4f85-8939-c6a8d7503a40,geo-router-tag-1,1719830819,1719831057,finished,1719830880,1719831057,A100-SXM4-80GB,8,4,64,448,61,177
98fb05d3-201f-4113-bcd8-7a41ed5b1b52,geo-MoD-1-8B,1719831097,1719831244,finished,1719831119,1719831244,A100-SXM4-80GB,8,1,64,448,22,125
be3133de-a622-4333-84e3-cb67d819fbc7,geo-72B-test,1719831119,1719831342,finished,1719831182,1719831342,A100-SXM4-80GB,8,4,64,896,63,160
7177b9bf-6fc6-42e1-9721-d91eb742d803,geo-router-tag-1,1719831162,1719831402,finished,1719831223,1719831402,A100-SXM4-80GB,8,4,64,448,61,179
a737ba14-595e-44e7-b0b8-f338277a6f74,geo-MoD-1-8B,1719831342,1719831503,finished,1719831362,1719831503,A100-SXM4-80GB,8,1,64,448,20,141
ad18c123-4c2f-4e26-9e42-a4ac624260a2,geo-72B-test,1719831464,1719831706,finished,1719831523,1719831706,A100-SXM4-80GB,8,4,64,896,59,183
d672264d-9fb6-445f-bc74-05b923bbc819,geo-router-tag-1,1719831503,1719831706,finished,1719831545,1719831706,A100-SXM4-80GB,8,4,64,448,42,161
ee6e14ea-c621-4e07-ad99-f58353820572,geo-MoD-1-8B,1719831606,1719831745,finished,1719831626,1719831745,A100-SXM4-80GB,8,1,64,448,20,119
43d53cca-9c03-47aa-bcf5-4e1004357249,txchen-train-task2,1719831799,1719831920,finished,1719831820,1719831920,A100-SXM4-80GB,8,1,64,448,21,100
53c5a625-9799-4415-ba73-500e1c3821d6,geo-router-tag-1,1719831811,1719832050,finished,1719831872,1719832050,A100-SXM4-80GB,8,4,64,448,61,178
b691004a-26c7-4223-89d9-b3f30ae192ae,geo-72B-test,1719831811,1719832011,finished,1719831852,1719832011,A100-SXM4-80GB,8,4,64,896,41,159
69920471-8a3f-401f-a00b-f82336987231,geo-MoD-1-8B,1719831872,1719832011,finished,1719831931,1719832011,A100-SXM4-80GB,8,1,64,448,59,80
2f2da248-1d65-41a7-92c1-25a6e08001e7,geo-MoD-1-8B,1719832071,1719832217,finished,1719832091,1719832217,A100-SXM4-80GB,8,1,64,448,20,126
3dd48659-ca60-4929-a1d0-405a43e1660d,geo-72B-test,1719832114,1719832362,finished,1719832176,1719832362,A100-SXM4-80GB,8,4,64,896,62,186
2b3c4116-9610-4dd2-b78f-9cfd20c00198,geo-router-tag-1,1719832155,1719832381,finished,1719832217,1719832381,A100-SXM4-80GB,8,4,64,448,62,164
dd96bab3-5695-4497-84a8-5e2859774db4,txchen-train-task2,1719832206,1719836974,finished,1719832246,1719836974,A100-SXM4-80GB,8,1,64,448,40,4728
d94f4692-4c3c-43e2-a0af-a4f5214a5073,GeoGPT-0630,1719832308,1719832490,finished,1719832329,1719832490,A100-SXM4-40GB,8,1,32,320,21,161
25341184-0a4a-4695-b24c-0d4ecd4ee6bf,geo-MoD-1-8B,1719832320,1719832522,finished,1719832381,1719832522,A100-SXM4-80GB,8,1,64,448,61,141
86258033-6bbb-4320-b217-7075fc5fff1d,geo-72B-test,1719832483,1719832704,finished,1719832522,1719832704,A100-SXM4-80GB,8,4,64,896,39,182
11ce8439-5097-4bc1-9f9b-e9ccacca7205,geo-router-tag-1,1719832502,1719832765,finished,1719832583,1719832765,A100-SXM4-80GB,8,4,64,448,81,182
2d7ac46b-ec51-4a23-8175-9c7d3f0bd6b1,GeoGPT-0630,1719832614,1720765448,finished,1719832635,1720765448,A100-SXM4-40GB,8,1,32,320,21,932813
03e16c6f-a015-48ae-b58f-8c69823dc91e,geo-MoD-1-8B,1719832647,1719832865,finished,1719832724,1719832865,A100-SXM4-80GB,8,1,64,448,77,141
f1c5ca55-ebe9-473c-9e45-11a3effad62f,geo-72B-test,1719832806,1719833091,finished,1719832866,1719833091,A100-SXM4-80GB,8,4,64,896,60,225
9191acb6-78f4-4259-882a-c07538cfdd67,q72b-ties-w55-d5075-8dd95-auto,1719832880,1719835115,finished,1719832900,1719835115,A100-SXM4-80GB,8,1,64,448,20,2215
12fd7a88-1033-495e-a52e-3da9f3521dcf,geo-router-tag-1,1719832897,1719833315,finished,1719833014,1719833315,A100-SXM4-80GB,8,4,64,448,117,301
53ddb3ae-ba2e-4aae-9bc4-5ed71f1dc2d6,q72b-ties-w55-d10075-411f1-auto,1719832902,1719845010,finished,1719832936,1719845010,A100-SXM4-80GB,8,1,64,448,34,12074
ee6c8420-8d9c-4f72-a0fe-cd43f9db7ca0,q72b-ties-w55-d7525-189d5-auto,1719832904,1719836012,finished,1719832936,1719836012,A100-SXM4-80GB,8,1,64,448,32,3076
2766dd06-2bfd-4dea-971a-b05a157b5262,q72b-ties-w55-d5025-191d5-auto,1719832906,1719835961,finished,1719832936,1719835961,A100-SXM4-80GB,8,1,64,448,30,3025
fdc07fd4-3192-4356-8b6c-e40dec2a6d2b,q72b-ties-w55-d10075-a9186-auto,1719832908,1719834286,finished,1719832936,1719834286,A100-SXM4-80GB,8,1,64,448,28,1350
d9b24d40-0c34-474f-be37-efa83e334184,q72b-ties-w55-d7550-a1d95-auto,1719832909,1719845778,finished,1719832936,1719845778,A100-SXM4-80GB,8,1,64,448,27,12842
27971eee-8bf5-4dc1-ad0d-2a1c1560eddf,q72b-ties-w55-d7575-132e9-auto,1719832912,1719835522,finished,1719832936,1719835522,A100-SXM4-80GB,8,1,64,448,24,2586
64bd7719-8686-47a7-8d6d-2cd4d840fa7c,q72b-ties-w55-d10050-69faf-auto,1719832913,1719845601,finished,1719832936,1719845601,A100-SXM4-80GB,8,1,64,448,23,12665
b92fa2a9-ef0a-4c07-8c3e-8b2524fed831,q72b-ties-w55-d7525-92f2f-auto,1719832915,1719847207,finished,1719832937,1719847207,A100-SXM4-80GB,8,1,64,448,22,14270
afe1ba69-38b2-411d-bab6-5f90502b3654,q72b-ties-w55-d50100-43103-auto,1719832963,1719834656,finished,1719833018,1719834656,A100-SXM4-80GB,8,1,64,448,55,1638
8788aac1-4774-4ef6-8495-b87fa394eff0,q72b-ties-w55-d10025-810bd-auto,1719832964,1719835914,finished,1719833018,1719835914,A100-SXM4-80GB,8,1,64,448,54,2896
581f44d9-ea9e-4090-a231-8958ad767fdc,q72b-ties-w55-d5050-4f1d9-auto,1719832967,1719835464,finished,1719833018,1719835464,A100-SXM4-80GB,8,1,64,448,51,2446
36f034fd-7b8a-4b90-9570-007453564d06,q72b-ties-w55-d5075-2d918-auto,1719832968,1719834904,finished,1719833018,1719834904,A100-SXM4-80GB,8,1,64,448,50,1886
917fb1c6-4756-41a0-be1c-1868eaf0ef1c,q72b-ties-w55-d7575-8c87f-auto,1719832970,1719834904,finished,1719833018,1719834904,A100-SXM4-80GB,8,1,64,448,48,1886
61e54732-6657-4a6b-af88-8a6417efd667,q72b-ties-w55-d7550-ce1a4-auto,1719832973,1719835937,finished,1719833018,1719835937,A100-SXM4-80GB,8,1,64,448,45,2919
af35266c-92ec-41b8-900b-aba585fc1856,q72b-ties-w55-d5050-e8708-auto,1719832975,1719836046,finished,1719833018,1719836046,A100-SXM4-80GB,8,1,64,448,43,3028
d82ac99b-dee1-4a49-94ec-cfeb419f958c,q72b-ties-w55-d5025-130db-auto,1719832977,1719835465,finished,1719833019,1719835465,A100-SXM4-80GB,8,1,64,448,42,2446
0e3e44d2-3f88-420d-a6bb-c7a6f88a1ebb,q72b-ties-w55-d10050-28b22-auto,1719832979,1719835842,finished,1719833019,1719835842,A100-SXM4-80GB,8,1,64,448,40,2823
d86d0b9d-2b19-4691-96e2-4d7f89cea784,q72b-ties-w55-d75100-89f00-auto,1719832980,1719844904,finished,1719833019,1719844904,A100-SXM4-80GB,8,1,64,448,39,11885
20c6eedc-44dd-4ddd-aa6f-36e6edf01389,q72b-ties-w55-d75100-b5c4b-auto,1719832982,1719835004,finished,1719833020,1719835004,A100-SXM4-80GB,8,1,64,448,38,1984
22201088-f2ff-48a3-8afb-bdce82b48c68,q72b-ties-w55-d50100-40763-auto,1719832985,1719835843,finished,1719833020,1719835843,A100-SXM4-80GB,8,1,64,448,35,2823
275acc32-7b6b-4052-9f3e-9e1d0ac43709,q72b-ties-w55-d7550-561aa-auto,1719832987,1719835524,finished,1719833021,1719835524,A100-SXM4-80GB,8,1,64,448,34,2503
74d38cb7-b5fb-4e9a-aeff-2ce5da964bbe,q72b-ties-w55-d100100-826bb-auto,1719832988,1719836015,finished,1719833021,1719836015,A100-SXM4-80GB,8,1,64,448,33,2994
91d89657-d0c8-4c73-a687-e1dc5ecfedeb,q72b-ties-w55-d7525-6bc07-auto,1719832991,1719835525,finished,1719833021,1719835525,A100-SXM4-80GB,8,1,64,448,30,2504
b1c7a9f9-4f7c-4c74-89f8-7c965c1d84cb,q72b-ties-w55-d10025-36c99-auto,1719832993,1719835575,finished,1719833022,1719835575,A100-SXM4-80GB,8,1,64,448,29,2553
3d52a600-ccff-4191-bb81-badbecbd6fb3,q72b-ties-w55-d7575-38dcd-auto,1719832995,1719845311,finished,1719833022,1719845311,A100-SXM4-80GB,8,1,64,448,27,12289
ef5ba003-04f0-41d9-9654-3b8c22dd19b3,geo-MoD-1-8B,1719833066,1719833271,finished,1719833112,1719833271,A100-SXM4-80GB,8,1,64,448,46,159
69506cb5-847b-42a8-b3f1-b9a4d817c7aa,geogpt-lxz-sft-magpie-qwen2-pro-2ep-72b,1719833093,1719834319,finished,1719833154,1719834319,A100-SXM4-80GB,8,16,64,448,61,1165
da8eb88e-beee-44bc-8aca-b2229214fcbc,geo-72B-test,1719833203,1719833523,finished,1719833341,1719833523,A100-SXM4-80GB,8,4,64,896,138,182
7d044142-25e6-48a9-9520-8e73c01f1f02,geo-MoD-1-8B,1719833393,1719833633,finished,1719833419,1719833633,A100-SXM4-80GB,8,1,64,448,26,214
ca034c20-51f9-4e48-9669-9548a54695e3,geo-router-tag-1,1719833444,1719833809,finished,1719833578,1719833809,A100-SXM4-80GB,8,4,64,448,134,231
81f5c7cc-8267-424d-99ef-95fc4395c9ac,geo-72B-test,1719833660,1719834647,finished,1719833749,1719834647,A100-SXM4-80GB,8,4,64,896,89,898
a1d27de3-3329-421d-b780-188786b07f6e,llama-factory-long,1719833775,1719886893,finished,1719833881,1719886893,A100-SXM4-80GB,8,2,64,448,106,53012
e59dc769-405d-475c-aba0-df3134b77c1a,geo-MoD-1-8B,1719833809,1719834472,finished,1719833849,1719834472,A100-SXM4-80GB,8,1,64,448,40,623
be3d6c12-e0cf-4b02-bcae-4cdd84d516c2,qwen-72b-test,1719834643,1719835083,finished,1719834693,1719835083,A100-SXM4-40GB,8,1,32,320,50,390
6523333e-1a32-4b2b-8256-3a27de0e2ad6,geo-router-tag-1,1719834647,1719835112,finished,1719834895,1719835112,A100-SXM4-80GB,8,4,64,448,248,217
927d5422-4e2d-406e-b90c-c5748caf723e,geo-MoD-1-8B,1719834895,1719835085,finished,1719834932,1719835085,A100-SXM4-80GB,8,1,64,448,37,153
513d59e1-24b4-47b1-994c-33e0d78c4071,geo-72B-test,1719834998,1719835493,finished,1719835174,1719835493,A100-SXM4-80GB,8,4,64,896,176,319
acb4425b-81e6-4220-b69d-59d7ca069b74,q72b-ties-w55-d10050-e8e92-auto,1719835038,1719836438,finished,1719835065,1719836438,A100-SXM4-80GB,8,1,64,448,27,1373
d5ec318c-54bd-484a-af1a-a1fc63b9228c,qwen-72b-test,1719835111,1719835545,finished,1719835142,1719835545,A100-SXM4-80GB,8,1,64,448,31,403
cbff511a-2ccf-43fb-8718-b2cf7cc3fea5,geogpt-lxz-sft-magpie-qwen2-pro-2ep-72b,1719835458,1719850482,finished,1719837790,1719850482,A100-SXM4-80GB,8,16,64,448,2332,12692
993f211e-df29-4a69-8d66-58c6c146da52,geogpt-lxz-sft-magpie-llama3-pro-2ep-72b,1719835460,1719837823,finished,1719836016,1719837823,A100-SXM4-80GB,8,16,64,448,556,1807
409a997a-3e4f-47df-a65e-44b45cd9323e,q72b-ties-w55-d100100-f1fc3-auto,1719835471,1719836439,finished,1719835499,1719836439,A100-SXM4-80GB,8,1,64,448,28,940
2f511a02-2c17-40dd-8925-52f0a3b41bb4,geo-MoD-1-8B,1719835518,1719835689,finished,1719835546,1719835689,A100-SXM4-80GB,8,1,64,448,28,143
005f4047-906d-46ec-9cc8-941f8397b2dc,geo-router-tag-1,1719835713,1719835984,finished,1719835762,1719835984,A100-SXM4-80GB,8,4,64,448,49,222
fd1db2f5-6ba4-4d14-ab53-cf632fc892e1,geo-MoD-1-8B,1719835813,1719836010,finished,1719835838,1719836010,A100-SXM4-80GB,8,1,64,448,25,172
430565b9-5489-4249-a45a-a80f08e164a0,geo-router-tag-1,1719836118,1719836435,finished,1719836193,1719836435,A100-SXM4-80GB,8,4,64,448,75,242
7f0296de-2565-4868-b15f-86b2ef3a1f93,geo-MoD-1-8B,1719836143,1719836251,finished,1719836170,1719836251,A100-SXM4-80GB,8,1,64,448,27,81
8a7cd9c6-0149-4861-a251-f14552149ea3,easycontext-zj-8b-cg,1719836189,1719836934,finished,1719836214,1719836934,A100-SXM4-80GB,8,1,64,896,25,720
f1f408ca-ee5c-449c-b635-035ff920587b,easycontext-zj-8b,1719836214,1719836958,finished,1719836431,1719836958,A100-SXM4-80GB,8,1,64,896,217,527
785609fa-e0a9-4732-982a-20332b05bb61,q72b-ties-w55-d10075-92f94-auto,1719836227,1719838004,finished,1719836259,1719838004,A100-SXM4-80GB,8,1,64,448,32,1745
ae8d98c8-434d-45dd-bfa5-ee9eda008197,geo-MoD-1-8B,1719836345,1719836548,finished,1719836414,1719836548,A100-SXM4-80GB,8,1,64,448,69,134
78e92611-6cd8-4adb-92e4-4b0dfc961de0,geo-72B-test,1719836504,1719836753,finished,1719836572,1719836753,A100-SXM4-80GB,8,4,64,896,68,181
e565a9ff-c8ef-4648-93a4-2e4cccd82371,geo-router-tag-1,1719836572,1719837008,finished,1719836797,1719837008,A100-SXM4-80GB,8,4,64,448,225,211
056ee8a9-3786-44e7-9cde-c36b92b3d811,geo-MoD-1-8B,1719836663,1719836822,finished,1719836688,1719836822,A100-SXM4-80GB,8,1,64,448,25,134
ac6f6d85-17fd-4e5b-a370-94e769c2bc22,train-0701,1719836861,1719837883,finished,1719836886,1719837883,A100-SXM4-80GB,8,1,64,448,25,997
ba9b2700-3bd9-4f13-abf2-a2df46496dbe,geo-72B-test,1719836891,1719837188,finished,1719837008,1719837188,A100-SXM4-80GB,8,4,64,896,117,180
f680a1d5-37d1-4324-abf1-6e628ac6aa2f,easycontext-zj-8b-cg,1719836934,1719837741,finished,1719836958,1719837741,A100-SXM4-80GB,8,1,64,896,24,783
6e06d3dd-9aa0-4c52-92cd-68e7fcdfce1e,geo-MoD-1-8B,1719836939,1719837118,finished,1719836963,1719837118,A100-SXM4-80GB,8,1,64,448,24,155
cea692c0-8abd-4bbd-94d1-298384376b4d,easycontext-zj-8b,1719836958,1719837976,finished,1719836982,1719837976,A100-SXM4-80GB,8,1,64,896,24,994
19e81926-2d57-4759-b55c-d881ebd9a646,geo-router-tag-1,1719837143,1719837388,finished,1719837209,1719837388,A100-SXM4-80GB,8,4,64,448,66,179
06266047-92a5-4dcb-88c6-8e32ded27207,geo-MoD-1-8B,1719837256,1719837431,finished,1719837278,1719837431,A100-SXM4-80GB,8,1,64,448,22,153
34c21f44-fb79-461a-93d2-c1c25c060541,geo-72B-test,1719837301,1719837656,finished,1719837388,1719837656,A100-SXM4-80GB,8,4,64,896,87,268
d0bc1fd7-defc-4718-97ed-84212f25db67,geo-router-tag-1,1719837521,1719837788,finished,1719837564,1719837788,A100-SXM4-80GB,8,4,64,448,43,224
cc6152f0-873c-4941-90bb-5d8225760e59,geo-MoD-1-8B,1719837564,1719837744,finished,1719837587,1719837744,A100-SXM4-80GB,8,1,64,448,23,157
b49a5e00-d9e6-47d0-bfd4-defaaa3fd9b7,train-0701,1719837883,1719884070,finished,1719837906,1719884070,A100-SXM4-80GB,8,1,64,896,23,46164
778a705e-7f9a-4f22-ab92-4ad9b2031605,geo-MoD-1-8B,1719837911,1719838088,finished,1719837935,1719838088,A100-SXM4-80GB,8,1,64,448,24,153
738e775d-494c-434d-a079-7fa528629456,geo-router-tag-1,1719837911,1719838194,finished,1719837957,1719838194,A100-SXM4-80GB,8,4,64,448,46,237
c24276f8-369a-47df-a7ea-862e1e0ae26b,geo-MoD-1-8B,1719838215,1719838392,finished,1719838237,1719838392,A100-SXM4-80GB,8,1,64,448,22,155
205a83b3-6cb7-45aa-a282-ee06d11498b6,geo-router-tag-1,1719838304,1719838586,finished,1719838370,1719838586,A100-SXM4-80GB,8,4,64,448,66,216
75f8e496-695a-4f9e-bdcb-ec9d04062524,geo-MoD-1-8B,1719838519,1719838693,finished,1719838542,1719838693,A100-SXM4-80GB,8,1,64,448,23,151
977b183e-b36d-40ab-bade-840ed31c6252,geo-router-tag-1,1719838715,1719839003,finished,1719838760,1719839003,A100-SXM4-80GB,8,4,64,448,45,243
8e6e833e-2713-4e5c-9aec-587e05729c06,geo-MoD-1-8B,1719838845,1719839023,finished,1719838872,1719839023,A100-SXM4-80GB,8,1,64,448,27,151
7e0e53ec-dd7b-415c-9391-2a1d7c2ea68f,geo-72B-test,1719838873,1719839136,finished,1719838937,1719839136,A100-SXM4-80GB,8,4,64,896,64,199
c334aa22-0ec9-45a9-9161-a53bdc596b50,qwen-72b-test,1719839112,1719901597,finished,1719839135,1719901597,A100-SXM4-80GB,8,1,64,448,23,62462
cf0639b7-490a-4995-bcdd-cb239cbbd6c2,geo-router-tag-1,1719839114,1719839421,finished,1719839179,1719839421,A100-SXM4-80GB,8,4,64,448,65,242
42937ea5-2697-4029-8a6e-98a9cde76d68,geo-MoD-1-8B,1719839179,1719839356,finished,1719839203,1719839356,A100-SXM4-80GB,8,1,64,448,24,153
2f708ce2-7bcc-473b-9f67-17a2a5943462,geo-72B-test,1719839268,1719839531,finished,1719839331,1719839531,A100-SXM4-80GB,8,4,64,896,63,200
260ecfa4-eaca-4f42-bfef-623f1915b5f3,geogpt-sft-1-8m-wo-geo-llama3-8b,1719839337,1719839935,finished,1719839377,1719839935,A100-SXM4-80GB,8,4,64,448,40,558
2a08e786-ec0e-40c8-b012-2ad3050eccc6,geo-MoD-1-8B,1719839486,1719839640,finished,1719839508,1719839640,A100-SXM4-80GB,8,1,64,448,22,132
9e179c68-acca-412b-bd4a-1606ccfd58b1,geo-router-tag-1,1719839531,1719839818,finished,1719839596,1719839818,A100-SXM4-80GB,8,4,64,448,65,222
6a5f899f-e84f-4d01-90dd-7269e76e008b,geo-72B-test,1719839663,1719839952,finished,1719839708,1719839952,A100-SXM4-80GB,8,4,64,896,45,244
bb7983ea-3e75-41b4-9ca3-bd60052db22e,geo-MoD-1-8B,1719839774,1719839929,finished,1719839796,1719839929,A100-SXM4-80GB,8,1,64,448,22,133
22975641-3eb4-42fa-bc5b-9ec626eb65cf,geo-router-tag-1,1719839929,1719926672,finished,1719839974,1719926672,A100-SXM4-80GB,8,4,64,448,45,86698
dc35f8d1-7dcf-4a7e-936d-8928e0cd55f2,geogpt-sft-1-8m-wo-geo-llama3-8b,1719839999,1719912223,finished,1719840045,1719912223,A100-SXM4-80GB,8,8,64,448,46,72178
d475f08f-94ff-44fb-bfd0-85132d0733bc,geo-MoD-1-8B,1719840066,1719841891,finished,1719840088,1719841891,A100-SXM4-80GB,8,1,64,448,22,1803
a89800da-5b57-48ca-883a-96835cea4edb,geo-72B-test,1719840358,1719840907,finished,1719840401,1719840907,A100-SXM4-80GB,8,4,64,896,43,506
f9f3f343-ce72-4e73-a5bd-9618345785f9,q72b-ties-w55-d100100-b7f51-auto,1719840673,1719852416,finished,1719840693,1719852416,A100-SXM4-80GB,8,1,64,448,20,11723
1a8f5235-6e9a-44f7-b350-6d460e069ffd,geo-72B-test,1719841031,1719841372,finished,1719841093,1719841372,A100-SXM4-80GB,8,4,64,896,62,279
b6181054-e85a-4421-9f95-0bdebc95ab9a,geogpt-lxz-sft-magpie-llama3-pro-2ep-72b,1719841264,1719851282,finished,1719841325,1719851282,A100-SXM4-80GB,8,16,64,448,61,9957
4cc67fab-29f9-4243-b47b-f7a8f67c7eba,geo-72B-test,1719841372,1719841997,finished,1719841436,1719841997,A100-SXM4-80GB,8,4,64,896,64,561
eaaaa230-2e72-4f88-8369-95148cb45ec3,q72b-ties-w55-d10025-ed140-auto,1719841418,1719855175,finished,1719841440,1719855175,A100-SXM4-80GB,8,1,64,448,22,13735
3158bd3f-eade-4b99-99a5-54704bbf462f,q72b-ties-w55-d75100-f5941-auto,1719841749,1719843549,finished,1719841770,1719843549,A100-SXM4-80GB,8,1,64,448,21,1779
899a8983-4f22-4637-98d8-9a7aae5888a0,geo-72B-test,1719841997,1719842525,finished,1719842062,1719842525,A100-SXM4-80GB,8,8,64,896,65,463
76c73ceb-0168-4719-ae2e-7c11f9ddcdce,geo-MoD-1-8B,1719842019,1719850420,finished,1719842041,1719850420,A100-SXM4-80GB,8,1,64,448,22,8379
b137f387-6302-43c0-8e6c-19646c1200b7,geo-72B-test,1719842635,1719843161,finished,1719842697,1719843161,A100-SXM4-80GB,8,8,64,896,62,464
2f8c5936-6e44-4f96-b021-9e4683c0af4b,geo-72B-test,1719843290,1719843811,finished,1719843352,1719843811,A100-SXM4-80GB,8,8,64,896,62,459
cbee6c4e-5898-445c-9798-8d4f499d4d01,geo-72B-test,1719843938,1719844295,finished,1719843981,1719844295,A100-SXM4-80GB,8,8,64,896,43,314
6c2ef34f-6364-4ef2-aeb2-906148467f8e,geogpt-eval-mixtral-dde,1719844215,1719845919,finished,1719844234,1719845919,A100-SXM4-80GB,8,1,64,896,19,1685
d4c09592-c7f3-43c0-9ec6-9360d0d8061b,geo-72B-test,1719844422,1719844797,finished,1719844484,1719844797,A100-SXM4-80GB,8,8,64,896,62,313
4d878ea3-3f67-45b8-88cf-87f5b323613f,geo-72B-test,1719844924,1719845309,finished,1719844986,1719845309,A100-SXM4-80GB,8,8,64,896,62,323
7ffd100f-652d-43f4-9e73-d1000d7bf327,profiler,1719845302,1719845385,finished,1719845324,1719845385,A100-SXM4-80GB,8,1,64,896,22,61
5c27486f-b402-4780-a531-7ab4a449dad5,profiler,1719845427,1719919493,finished,1719845450,1719919493,A100-SXM4-80GB,8,1,64,896,23,74043
eb2f8ed1-c3ec-48b7-be26-f697099a8a82,geo-72B-test,1719845433,1719845994,finished,1719845497,1719845994,A100-SXM4-80GB,8,8,64,896,64,497
6f88756d-6e75-49cb-8f0b-5905650364df,geogpt-mixtral-test,1719845834,1719901580,finished,1719845872,1719901580,A100-SXM4-80GB,8,16,64,896,38,55708
13fdfa11-8a91-4d0e-a955-66e1a8b892bc,geogpt-eval-mixtral-dde,1719845919,1720611781,finished,1719845939,1720611781,A100-SXM4-80GB,8,1,64,896,20,765842
29d6eb42-c6c1-4d06-be77-5a8f24a37739,geo-72B-test,1719846092,1719846464,finished,1719846150,1719846464,A100-SXM4-80GB,8,8,64,896,58,314
e46b8b6b-e670-4db0-9071-8273b6bea101,geo-72B-test,1719846464,1719846872,finished,1719846523,1719846872,A100-SXM4-80GB,8,8,64,896,59,349
8a0572c9-3d34-441b-ac33-a8a8ffcb9a90,geo-72B-test,1719846969,1719847436,finished,1719847027,1719847436,A100-SXM4-80GB,8,8,64,896,58,409
8bb9e4e1-c474-4236-b498-d43eeb9fa6f6,geo-72B-test,1719847436,1719847496,finished,1719847456,1719847496,A100-SXM4-80GB,8,16,64,896,20,40
9736ec57-2b91-4a17-907b-b5d34d21ee96,geo-72B-test,1719847535,1719847809,finished,1719847593,1719847809,A100-SXM4-80GB,8,16,64,896,58,216
0f194b33-a857-4de3-a21f-4b28a58fc36e,geo-72B-test,1719847910,1719848163,finished,1719847950,1719848163,A100-SXM4-80GB,8,16,64,896,40,213
1a7cefc7-7572-4a60-afe2-7523ec7482ef,geogpt-72b-0206,1719848001,1719888352,finished,1719848020,1719888352,A100-SXM4-80GB,8,1,64,448,19,40332
be4dfcdf-79eb-46fd-aba3-8be6e5754063,geo-72B-test,1719848282,1719848758,finished,1719848338,1719848758,A100-SXM4-80GB,8,16,64,896,56,420
1471a205-3657-4b9e-b338-0a5de0dbd423,geogpt-llm-moe-expand-0-5B-tag-1-freeze-attn,1719848612,1719908190,finished,1719848632,1719908190,A100-SXM4-80GB,8,1,64,896,20,59558
24505862-9161-4aef-93ee-589b07ff6e90,geogpt-llm-moe-expand-0-5B-tag-0-freeze-attn,1719848652,1719908078,finished,1719848672,1719908078,A100-SXM4-80GB,8,1,64,896,20,59406
9aae711c-fbbf-4fae-89de-f3613e2462fc,geogpt-moe-0-5B-tag-0-1-freeze-attn,1719848715,1719908579,finished,1719848738,1719908579,A100-SXM4-80GB,8,1,64,896,23,59841
da857af8-79e9-4e1c-915c-0fe922f4b36b,geo-72B-test,1719848758,1719849485,finished,1719848817,1719849485,A100-SXM4-80GB,8,16,64,896,59,668
1c6b9d89-8710-4b28-9bd8-b033cb6d7804,qwen2-72b-sft-ep1-v1-4-0701-dpo,1719849239,1719849674,finished,1719849508,1719849674,A100-SXM4-80GB,8,16,64,448,269,166
573b8123-fc39-4898-bd43-63cc53049bc3,qwen2-72b-sft-ep2-v1-41-0701-dpo,1719849296,1719849770,finished,1719849551,1719849770,A100-SXM4-80GB,8,16,64,448,255,219
20019a38-6ada-4cf1-bc76-5f6b21c30516,qwen-72b-test,1719849667,1719850784,finished,1719849689,1719850784,A100-SXM4-40GB,4,1,32,320,22,1095
03a6a2af-a570-46f0-ae55-5e17e367c431,geo-MoD-1-8B,1719850539,1719862051,finished,1719850560,1719862051,A100-SXM4-80GB,8,1,64,448,21,11491
765f3b5d-bf2b-459e-b4ae-31e267ae1ffe,geogpt-lxz-sft-magpie-qwen2-pro-2ep-72b,1719850542,1719852455,finished,1719850600,1719852455,A100-SXM4-80GB,8,16,64,448,58,1855
1801d305-268a-4425-b2eb-18fd2eef2c55,qwen-72b-test,1719850841,1719851518,finished,1719850859,1719851518,A100-SXM4-40GB,1,1,8,32,18,659
e49535cc-089f-425c-a53f-599d10012349,geogpt-lxz-sft-magpie-llama3-pro-2ep-72b,1719851339,1719851676,finished,1719851397,1719851676,A100-SXM4-80GB,8,16,64,448,58,279
4cbabbe1-9a9f-43fb-b169-6e97bc5dc980,qwen-72b-test,1719851595,1719851794,finished,1719851616,1719851794,A100-SXM4-40GB,1,1,8,32,21,178
3054ccce-9c8b-487e-98df-f93ffc47ec8e,geogpt-lxz-sft-magpie-llama3-pro-2ep-72b,1719851740,1719852093,finished,1719851797,1719852093,A100-SXM4-80GB,8,16,64,448,57,296
6219cf34-ee45-4362-993e-906d677e9870,geogpt-lxz-sft-magpie-llama3-pro-2ep-72b,1719852156,1719852474,finished,1719852197,1719852474,A100-SXM4-80GB,8,16,64,448,41,277
706c9f36-ee16-4a0e-8ba8-123eea4ce6aa,qwen-72b-test,1719852193,1719900929,finished,1719852221,1719900929,A100-SXM4-40GB,1,1,8,32,28,48708
d7c2b3c4-c2b3-4ad1-b9a1-a2d7488a80d4,Qwen2-72B-Instruct-2ab7a-auto,1719852289,1719870203,finished,1719852308,1719870203,A100-SXM4-80GB,8,1,64,448,19,17895
94cab05b-5996-4299-b97f-954edc5f2c0a,Llama-3-70B-Instruct-48562-auto,1719852385,1719869123,finished,1719852403,1719869123,A100-SXM4-80GB,8,1,64,448,18,16720
8e5e32d3-893e-4a91-9657-43622c01cb6e,GeoGPT-0521-Llama3-e169f-auto,1719852525,1719869246,finished,1719852546,1719869246,A100-SXM4-80GB,8,1,64,448,21,16700
0317591f-50e4-475b-a9c8-b9e8cefda2d5,geogpt-lxz-sft-magpie-llama3-pro-2ep-72b,1719852539,1719852864,finished,1719852578,1719852864,A100-SXM4-80GB,8,16,64,448,39,286
f1865f31-19f3-4491-bc34-7a774a38fd60,geogpt-lxz-sft-magpie-llama3-pro-2ep-72b,1719852926,1719853248,finished,1719852984,1719853248,A100-SXM4-80GB,8,16,64,448,58,264
d3bf97d7-7105-4662-9096-d99b810df892,geogpt-lxz-sft-magpie-llama3-pro-2ep-72b,1719853310,1719853709,finished,1719853372,1719853709,A100-SXM4-80GB,8,16,64,448,62,337
34dd9cf8-b20c-40de-9985-ea3cc30276a6,geogpt-lxz-sft-magpie-llama3-pro-2ep-72b,1719853771,1719854109,finished,1719853829,1719854109,A100-SXM4-80GB,8,16,64,448,58,280
aa3e5e4c-fb0e-42a9-8ab4-4b8f344c4b21,geogpt-lxz-sft-magpie-llama3-pro-2ep-72b,1719854173,1719854490,finished,1719854231,1719854490,A100-SXM4-80GB,8,16,64,448,58,259
9de814e8-8a78-4e9b-b090-efc8bd9f659e,geogpt-lxz-sft-magpie-llama3-pro-2ep-72b,1719854552,1719854870,finished,1719854610,1719854870,A100-SXM4-80GB,8,16,64,448,58,260
2bca3fd5-3c13-4188-b8fb-ef55d8a3dd94,geogpt-lxz-sft-magpie-llama3-pro-2ep-72b,1719854932,1719855251,finished,1719854991,1719855251,A100-SXM4-80GB,8,16,64,448,59,260
e489a955-6c9c-47bb-8975-dde5278c5c6a,geogpt-lxz-sft-magpie-llama3-pro-2ep-72b,1719855314,1719855632,finished,1719855352,1719855632,A100-SXM4-80GB,8,16,64,448,38,280
eca66c2c-ce6c-417a-8489-362d1724eba8,geogpt-lxz-sft-magpie-llama3-pro-2ep-72b,1719855695,1719856030,finished,1719855753,1719856030,A100-SXM4-80GB,8,16,64,448,58,277
5d15a0da-0f4f-44bb-a6b6-bf30206a69fe,geogpt-lxz-sft-magpie-llama3-pro-2ep-72b,1719856095,1719856410,finished,1719856152,1719856410,A100-SXM4-80GB,8,16,64,448,57,258
0393412e-2a7d-476d-b98f-145c776288db,geogpt-lxz-sft-magpie-llama3-pro-2ep-72b,1719856470,1719856804,finished,1719856528,1719856804,A100-SXM4-80GB,8,16,64,448,58,276
85753e77-d5e7-420f-ad51-007367d73ed4,geogpt-lxz-sft-magpie-llama3-pro-2ep-72b,1719856868,1719857186,finished,1719856927,1719857186,A100-SXM4-80GB,8,16,64,448,59,259
1c4f1c36-2f0c-48a4-b507-4ee2926013a3,geogpt-lxz-sft-magpie-llama3-pro-2ep-72b,1719857246,1719857560,finished,1719857303,1719857560,A100-SXM4-80GB,8,16,64,448,57,257
e89be9aa-a69a-46bd-8037-37758e354e62,geogpt-lxz-sft-magpie-llama3-pro-2ep-72b,1719857624,1719857958,finished,1719857682,1719857958,A100-SXM4-80GB,8,16,64,448,58,276
1c93b6ed-039c-44f3-9f1e-cadb097ab4a4,geogpt-lxz-sft-magpie-llama3-pro-2ep-72b,1719858021,1719858355,finished,1719858079,1719858355,A100-SXM4-80GB,8,16,64,448,58,276
b2396d1e-1a43-4bd8-9d6b-b03770f94317,geogpt-lxz-sft-magpie-llama3-pro-2ep-72b,1719858419,1719858734,finished,1719858457,1719858734,A100-SXM4-80GB,8,16,64,448,38,277
e938d1ca-c627-4784-b518-43e097d6a0c2,geogpt-lxz-sft-magpie-llama3-pro-2ep-72b,1719858797,1719859287,finished,1719858854,1719859287,A100-SXM4-80GB,8,16,64,448,57,433
f49d8de1-0de7-49f4-9f37-81bad35558f0,geogpt-lxz-sft-magpie-llama3-pro-2ep-72b,1719859350,1719859669,finished,1719859410,1719859669,A100-SXM4-80GB,8,16,64,448,60,259
bc781394-35d5-41cd-859f-a07482db056c,geogpt-lxz-sft-magpie-llama3-pro-2ep-72b,1719859730,1719860046,finished,1719859769,1719860046,A100-SXM4-80GB,8,16,64,448,39,277
d0de76aa-c25d-4912-a9d2-ca89806942d0,geogpt-lxz-sft-magpie-llama3-pro-2ep-72b,1719860109,1719860443,finished,1719860166,1719860443,A100-SXM4-80GB,8,16,64,448,57,277
5174df82-b304-4d80-862d-a1c29654dd90,geogpt-lxz-sft-magpie-llama3-pro-2ep-72b,1719860506,1719860811,finished,1719860545,1719860811,A100-SXM4-80GB,8,16,64,448,39,266
80151582-018d-4bcc-8c27-e58862eb1d8d,geogpt-lxz-sft-magpie-llama3-pro-2ep-72b,1719860875,1719861192,finished,1719860915,1719861192,A100-SXM4-80GB,8,16,64,448,40,277
bd750a83-7f9b-4b22-af3f-2adbf6ca9f75,geogpt-lxz-sft-magpie-llama3-pro-2ep-72b,1719861256,1719861592,finished,1719861314,1719861592,A100-SXM4-80GB,8,16,64,448,58,278
047166ec-b5af-463f-af80-f981cc882012,geogpt-lxz-sft-magpie-llama3-pro-2ep-72b,1719861655,1719861989,finished,1719861713,1719861989,A100-SXM4-80GB,8,16,64,448,58,276
6b997016-1148-4a04-9401-119cf86100a1,geogpt-lxz-sft-magpie-llama3-pro-2ep-72b,1719862053,1719862380,finished,1719862112,1719862380,A100-SXM4-80GB,8,16,64,448,59,268
a62099e1-4507-4dc2-a695-ba1c52c8018e,geo-MoD-1-8B,1719862157,1719873700,finished,1719862177,1719873700,A100-SXM4-80GB,8,1,64,448,20,11523
b11b75ca-83d3-4520-93a0-33e535fae696,geogpt-lxz-sft-magpie-llama3-pro-2ep-72b,1719862444,1719862741,finished,1719862483,1719862741,A100-SXM4-80GB,8,16,64,448,39,258
81b905e8-92e6-4b90-849e-607a9208b208,geogpt-lxz-sft-magpie-llama3-pro-2ep-72b,1719862803,1719863118,finished,1719862861,1719863118,A100-SXM4-80GB,8,16,64,448,58,257
a77f3f2d-a443-4899-b2c9-d984bfa54988,geogpt-lxz-sft-magpie-llama3-pro-2ep-72b,1719863183,1719863498,finished,1719863240,1719863498,A100-SXM4-80GB,8,16,64,448,57,258
31b54d70-86f8-411a-89e7-0c7aa2e5b7c1,geogpt-lxz-sft-magpie-llama3-pro-2ep-72b,1719863561,1719863860,finished,1719863600,1719863860,A100-SXM4-80GB,8,16,64,448,39,260
cdc02da7-c698-4951-8850-b215372f1ec3,geogpt-lxz-sft-magpie-llama3-pro-2ep-72b,1719863923,1719864258,finished,1719863981,1719864258,A100-SXM4-80GB,8,16,64,448,58,277
51f3e03b-8cbe-4ef4-9131-677a712101a4,geogpt-lxz-sft-magpie-llama3-pro-2ep-72b,1719864322,1719864641,finished,1719864380,1719864641,A100-SXM4-80GB,8,16,64,448,58,261
e3a76c9c-6df6-4cd1-bddd-94b8aa369192,geogpt-lxz-sft-magpie-llama3-pro-2ep-72b,1719864709,1719865243,finished,1719864769,1719865243,A100-SXM4-80GB,8,16,64,448,60,474
be40b72e-aee5-4bed-a830-827ce01df4a4,geogpt-lxz-sft-magpie-llama3-pro-2ep-72b,1719865305,1719865603,finished,1719865343,1719865603,A100-SXM4-80GB,8,16,64,448,38,260
02771d92-8e34-4efa-b728-3cda05472a77,geogpt-lxz-sft-magpie-llama3-pro-2ep-72b,1719865666,1719865972,finished,1719865704,1719865972,A100-SXM4-80GB,8,16,64,448,38,268
c876459c-f917-4dbe-99d3-b564616fd426,geogpt-lxz-sft-magpie-llama3-pro-2ep-72b,1719866035,1719866352,finished,1719866075,1719866352,A100-SXM4-80GB,8,16,64,448,40,277
10f938a9-aab8-47be-b83b-f5ed3ab012f7,geogpt-lxz-sft-magpie-llama3-pro-2ep-72b,1719866415,1719866730,finished,1719866473,1719866730,A100-SXM4-80GB,8,16,64,448,58,257
8f6d947f-01bc-42b8-8406-2a3b197870bf,geogpt-lxz-sft-magpie-llama3-pro-2ep-72b,1719866793,1719867129,finished,1719866851,1719867129,A100-SXM4-80GB,8,16,64,448,58,278
b843fe3c-fd38-42af-82e5-f270ff20e160,geogpt-lxz-sft-magpie-llama3-pro-2ep-72b,1719867192,1719867527,finished,1719867249,1719867527,A100-SXM4-80GB,8,16,64,448,57,278
b296d71a-d9ee-4b57-9e9f-0dd37a3b5ffe,geogpt-lxz-sft-magpie-llama3-pro-2ep-72b,1719867592,1719867910,finished,1719867649,1719867910,A100-SXM4-80GB,8,16,64,448,57,261
babf4c56-9825-4c56-a90f-3264c76500d7,geogpt-lxz-sft-magpie-llama3-pro-2ep-72b,1719867973,1719868293,finished,1719868031,1719868293,A100-SXM4-80GB,8,16,64,448,58,262
0c350a35-6ba0-48e8-af99-000bc3c93c78,geogpt-lxz-sft-magpie-llama3-pro-2ep-72b,1719868356,1719868692,finished,1719868413,1719868692,A100-SXM4-80GB,8,16,64,448,57,279
9aa5c9cb-8561-4407-aeb6-054e5ce28979,geogpt-lxz-sft-magpie-llama3-pro-2ep-72b,1719868756,1719869076,finished,1719868816,1719869076,A100-SXM4-80GB,8,16,64,448,60,260
314c482b-78a3-468f-bc0f-3661a835ccb7,geogpt-lxz-sft-magpie-llama3-pro-2ep-72b,1719869137,1719869451,finished,1719869175,1719869451,A100-SXM4-80GB,8,16,64,448,38,276
82e14140-0066-4560-8c07-15599aa5d4da,geogpt-lxz-sft-magpie-llama3-pro-2ep-72b,1719869514,1719869825,finished,1719869551,1719869825,A100-SXM4-80GB,8,16,64,448,37,274
36c89da7-47ec-4f3d-a5ae-cad1ea5e7345,geogpt-lxz-sft-magpie-llama3-pro-2ep-72b,1719869885,1719870219,finished,1719869942,1719870219,A100-SXM4-80GB,8,16,64,448,57,277
4332d90b-880d-4090-acc9-07bfc0096ff5,geogpt-lxz-sft-magpie-llama3-pro-2ep-72b,1719870281,1719870593,finished,1719870320,1719870593,A100-SXM4-80GB,8,16,64,448,39,273
fe1e7cb4-705e-4eac-be70-1f9eb27706ce,geogpt-lxz-sft-magpie-llama3-pro-2ep-72b,1719870654,1719870982,finished,1719870710,1719870982,A100-SXM4-80GB,8,16,64,448,56,272
3c12be45-0833-4db1-93de-bd12c79cf8b2,geogpt-lxz-sft-magpie-llama3-pro-2ep-72b,1719871043,1719871504,finished,1719871080,1719871504,A100-SXM4-80GB,8,16,64,448,37,424
160d67c8-a695-48b4-a761-847a0258bff4,geogpt-lxz-sft-magpie-llama3-pro-2ep-72b,1719871567,1719871895,finished,1719871625,1719871895,A100-SXM4-80GB,8,16,64,448,58,270
0cd518ea-3527-4b57-bf46-00888a45af53,geogpt-lxz-sft-magpie-llama3-pro-2ep-72b,1719871957,1719872287,finished,1719872014,1719872287,A100-SXM4-80GB,8,16,64,448,57,273
c84ccdbc-8ad2-4970-86eb-036070c0ea6b,geogpt-lxz-sft-magpie-llama3-pro-2ep-72b,1719872347,1719872671,finished,1719872403,1719872671,A100-SXM4-80GB,8,16,64,448,56,268
6540b532-63d4-4e0a-935d-85b41b4471ed,geogpt-lxz-sft-magpie-llama3-pro-2ep-72b,1719872732,1719873056,finished,1719872788,1719873056,A100-SXM4-80GB,8,16,64,448,56,268
8cd3ae04-77d2-4a83-8b8b-c256d32a6364,geogpt-lxz-sft-magpie-llama3-pro-2ep-72b,1719873118,1719873446,finished,1719873175,1719873446,A100-SXM4-80GB,8,16,64,448,57,271
152898f2-a055-477b-ab76-fb5281a60bc8,geogpt-lxz-sft-magpie-llama3-pro-2ep-72b,1719873508,1719873819,finished,1719873563,1719873819,A100-SXM4-80GB,8,16,64,448,55,256
5ad67221-6f3c-406b-a581-e0e6423d7561,geo-MoD-1-8B,1719873797,1719885285,finished,1719873817,1719885285,A100-SXM4-80GB,8,1,64,448,20,11468
399876a8-65f6-45aa-bd75-89bd0235ce60,geogpt-lxz-sft-magpie-llama3-pro-2ep-72b,1719873880,1719874205,finished,1719873917,1719874205,A100-SXM4-80GB,8,16,64,448,37,288
26b1e03d-f39b-4aba-b8ce-0e82713bfbe9,geogpt-lxz-sft-magpie-llama3-pro-2ep-72b,1719874266,1719874590,finished,1719874321,1719874590,A100-SXM4-80GB,8,16,64,448,55,269
e97c90e6-5640-44c2-8394-2f9b78ca0726,geogpt-lxz-sft-magpie-llama3-pro-2ep-72b,1719874651,1719874977,finished,1719874708,1719874977,A100-SXM4-80GB,8,16,64,448,57,269
ee0cd02a-0a75-48c6-a58d-62df299fbee9,geogpt-lxz-sft-magpie-llama3-pro-2ep-72b,1719875038,1719875385,finished,1719875096,1719875385,A100-SXM4-80GB,8,16,64,448,58,289
a9ad025b-25dd-44c6-9a91-f37cbf75dabc,geogpt-lxz-sft-magpie-llama3-pro-2ep-72b,1719875447,1719875773,finished,1719875503,1719875773,A100-SXM4-80GB,8,16,64,448,56,270
43f7b5d8-c6bd-4932-b839-7eff820d8b26,geogpt-lxz-sft-magpie-llama3-pro-2ep-72b,1719875835,1719876144,finished,1719875891,1719876144,A100-SXM4-80GB,8,16,64,448,56,253
5404e1dd-505a-4e06-8411-6755c5d7cc27,geogpt-lxz-sft-magpie-llama3-pro-2ep-72b,1719876205,1719876531,finished,1719876260,1719876531,A100-SXM4-80GB,8,16,64,448,55,271
246ca0ed-71b0-4c17-9a16-296be998d787,geogpt-lxz-sft-magpie-llama3-pro-2ep-72b,1719876592,1719876994,finished,1719876649,1719876994,A100-SXM4-80GB,8,16,64,448,57,345
d33a72ba-e97b-4112-9e3b-53d266ec863a,geogpt-lxz-sft-magpie-llama3-pro-2ep-72b,1719877057,1719877384,finished,1719877115,1719877384,A100-SXM4-80GB,8,16,64,448,58,269
458a2007-e037-4c97-abdb-4872ef8a041a,geogpt-lxz-sft-magpie-llama3-pro-2ep-72b,1719877446,1719877755,finished,1719877485,1719877755,A100-SXM4-80GB,8,16,64,448,39,270
e93789cc-445e-4022-b6ce-4400f7580481,geogpt-lxz-sft-magpie-llama3-pro-2ep-72b,1719877817,1719878143,finished,1719877875,1719878143,A100-SXM4-80GB,8,16,64,448,58,268
ecc6e949-12f5-4910-ba7e-5083f3ce4159,geogpt-lxz-sft-magpie-llama3-pro-2ep-72b,1719878206,1719878532,finished,1719878263,1719878532,A100-SXM4-80GB,8,16,64,448,57,269
58251acb-be21-4f59-a3d8-5c1617f81797,geogpt-lxz-sft-magpie-llama3-pro-2ep-72b,1719878594,1719878900,finished,1719878632,1719878900,A100-SXM4-80GB,8,16,64,448,38,268
940ee56a-1024-44ae-9059-d7c996df6fa2,geogpt-lxz-sft-magpie-llama3-pro-2ep-72b,1719878962,1719879269,finished,1719879000,1719879269,A100-SXM4-80GB,8,16,64,448,38,269
9c543516-7e4b-4779-bf1e-07a0f4617758,geogpt-lxz-sft-magpie-llama3-pro-2ep-72b,1719879331,1719879658,finished,1719879388,1719879658,A100-SXM4-80GB,8,16,64,448,57,270
4c9ff402-898e-433b-8eb9-db3e25a90871,geogpt-lxz-sft-magpie-llama3-pro-2ep-72b,1719879720,1719880046,finished,1719879777,1719880046,A100-SXM4-80GB,8,16,64,448,57,269
d8b7f2b1-de76-4c15-8899-f1d217927544,geogpt-lxz-sft-magpie-llama3-pro-2ep-72b,1719880108,1719880435,finished,1719880165,1719880435,A100-SXM4-80GB,8,16,64,448,57,270
05061900-21b3-437b-831c-97f9aa179b20,geogpt-lxz-sft-magpie-llama3-pro-2ep-72b,1719880497,1719880826,finished,1719880555,1719880826,A100-SXM4-80GB,8,16,64,448,58,271
5e56fa2a-7413-47b5-8bed-70467b40e1ff,geogpt-lxz-sft-magpie-llama3-pro-2ep-72b,1719880888,1719881215,finished,1719880946,1719881215,A100-SXM4-80GB,8,16,64,448,58,269
65f609bc-992b-4c50-bd02-99d999d53e15,geogpt-lxz-sft-magpie-llama3-pro-2ep-72b,1719881278,1719881611,finished,1719881335,1719881611,A100-SXM4-80GB,8,16,64,448,57,276
1d3dbdac-be07-4111-b775-19fed329adbb,qwen2-72b-sft-ep2-v1-41-0701-dpo,1719881369,1719887863,finished,1719881434,1719887863,A100-SXM4-80GB,8,16,64,448,65,6429
5053b3da-874c-4a0b-9b6c-6c02bf8f1b14,qwen2-72b-sft-ep1-v1-4-0701-dpo,1719881390,1719887767,finished,1719881429,1719887767,A100-SXM4-80GB,8,16,64,448,39,6338
93653ce6-7b75-4b22-bbb2-0fa5c35033ae,geogpt-lxz-sft-magpie-llama3-pro-2ep-72b,1719881672,1719881998,finished,1719881728,1719881998,A100-SXM4-80GB,8,16,64,448,56,270
07c178ad-7996-4363-b46f-abd0af76d17a,geogpt-lxz-sft-magpie-llama3-pro-2ep-72b,1719882060,1719882519,finished,1719882098,1719882519,A100-SXM4-80GB,8,16,64,448,38,421
9f92e698-4ce7-49c6-8590-159b0418aa41,geogpt-lxz-sft-magpie-llama3-pro-2ep-72b,1719882581,1719882908,finished,1719882638,1719882908,A100-SXM4-80GB,8,16,64,448,57,270
71853d72-53f2-41c2-878c-2be4f37afca1,geogpt-lxz-sft-magpie-llama3-pro-2ep-72b,1719882969,1719883297,finished,1719883026,1719883297,A100-SXM4-80GB,8,16,64,448,57,271
47f3380e-af47-4380-b98b-37cd4aa1a911,geogpt-lxz-sft-magpie-llama3-pro-2ep-72b,1719883359,1719883819,finished,1719883397,1719883819,A100-SXM4-80GB,8,16,64,448,38,422
80d7c29a-a6dd-4bac-901e-11e016405a6d,geogpt-lxz-sft-magpie-llama3-pro-2ep-72b,1719883881,1719884209,finished,1719883937,1719884209,A100-SXM4-80GB,8,16,64,448,56,272
cb525312-143d-4254-9e63-0648c8cf08c6,train-0701,1719884070,1719884670,finished,1719884089,1719884670,A100-SXM4-80GB,8,1,64,896,19,581
8dc89648-2a42-4c83-be1f-2070d654779b,geogpt-lxz-sft-magpie-llama3-pro-2ep-72b,1719884271,1719884577,finished,1719884308,1719884577,A100-SXM4-80GB,8,16,64,448,37,269
9f41af73-c2fd-4cfd-a042-5567aeb0ab31,geogpt-lxz-sft-magpie-llama3-pro-2ep-72b,1719884638,1719884969,finished,1719884695,1719884969,A100-SXM4-80GB,8,16,64,448,57,274
1fe3df32-b1f1-4fdc-b202-e2503357d8f3,train-0701,1719884809,1719909788,finished,1719884829,1719909788,A100-SXM4-80GB,8,1,64,896,20,24959
03995c58-fc06-4349-a7ae-a67bf1a0cf6a,cft-mt-lr5e-6-14b,1719885007,1720006552,finished,1719885032,1720006552,A100-SXM4-80GB,8,1,64,448,25,121520
852127ae-8c61-4ec8-b872-2a1e0342dce1,geogpt-lxz-sft-magpie-llama3-pro-2ep-72b,1719885031,1719885564,finished,1719885069,1719885564,A100-SXM4-80GB,8,16,64,448,38,495
631bbe9b-ee4e-4a64-b9cb-88cd41bf203b,easycontext-zj-8b,1719885222,1719886253,finished,1719885242,1719886253,A100-SXM4-80GB,8,1,64,896,20,1011
89854d48-7d6a-42ce-b6ec-5138734c7001,test-zz,1719885318,1719922402,finished,1719885340,1719922402,A100-SXM4-80GB,8,1,64,896,22,37062
0d66271b-6550-40a6-88f1-24c45e57a3f6,test-xiaodianq,1719885340,1719888731,finished,1719885360,1719888731,A100-SXM4-80GB,8,1,64,896,20,3371
a09704e4-77b6-4ab9-b368-3a8c48023a79,geo-MoD-1-8B,1719885387,1719888176,finished,1719885407,1719888176,A100-SXM4-80GB,8,1,64,448,20,2769
d56e67a0-46a7-45ec-9488-d073f907b276,geogpt-lxz-sft-magpie-llama3-pro-2ep-72b,1719885629,1719885959,finished,1719885687,1719885959,A100-SXM4-80GB,8,16,64,448,58,272
eb8671c9-73fe-4f68-9564-4c77983dd11d,geogpt-lxz-sft-magpie-llama3-pro-2ep-72b,1719886021,1719886334,finished,1719886060,1719886334,A100-SXM4-80GB,8,16,64,448,39,274
3304cf90-6f81-467b-a4a3-bc965057a876,geogpt-lxz-sft-magpie-llama3-pro-2ep-72b,1719886396,1719886732,finished,1719886456,1719886732,A100-SXM4-80GB,8,16,64,448,60,276
8eba89c3-a7c2-4592-8e6a-6f2cecd19df1,geogpt-sft-magpie-qwen2-pro-llama3-8b,1719886674,1719906454,finished,1719886712,1719906454,A100-SXM4-80GB,8,4,64,448,38,19742
72683a9f-9ada-4d41-b479-36877e7fb2f5,geogpt-lxz-sft-magpie-llama3-pro-2ep-72b,1719886794,1719887099,finished,1719886832,1719887099,A100-SXM4-80GB,8,16,64,448,38,267
505f3583-327a-4154-9744-c9eb496cfa8b,mixtral-8x7b-v01-commonbench,1719886860,1719976247,finished,1719886880,1719976247,A100-SXM4-80GB,8,1,64,896,20,89367
ddad92b9-5102-4128-bb66-a38178ed2d6c,llama-factory-long,1719886893,1719887660,finished,1719886933,1719887660,A100-SXM4-80GB,8,2,64,448,40,727
7435aa5d-eb41-477b-a3ee-b48d6de582a7,geogpt-sft-magpie-llama3-pro-llama3-8b,1719886899,1719906431,finished,1719886958,1719906431,A100-SXM4-80GB,8,4,64,448,59,19473
b04a483d-0a28-42c3-be28-4fbe6a6d6b78,geo-72B-test,1719887097,1719887321,finished,1719887160,1719887321,A100-SXM4-80GB,8,4,64,896,63,161
6845a323-0ed7-4abb-8565-d4f488cc9a06,geogpt-lxz-sft-magpie-llama3-pro-2ep-72b,1719887163,1719887475,finished,1719887202,1719887475,A100-SXM4-80GB,8,16,64,448,39,273
5080a32b-5488-4119-9011-8da84fd24203,geogpt-lxz-sft-magpie-llama3-pro-2ep-72b,1719887538,1719887842,finished,1719887578,1719887842,A100-SXM4-80GB,8,16,64,448,40,264
66777c2b-3817-4cfc-a169-ebb6a6de0046,easycontext-2nodes,1719887738,1719888495,finished,1719887798,1719888495,A100-SXM4-80GB,8,2,64,448,60,697
61422d40-67c4-4968-808a-b01bb2c58d99,geogpt-lxz-sft-magpie-llama3-pro-2ep-72b,1719887904,1719888236,finished,1719887961,1719888236,A100-SXM4-80GB,8,16,64,448,57,275
862a2874-c9ba-4dc9-9618-e1afc32ee321,geo-MoD-1-8B,1719888176,1719888338,finished,1719888196,1719888338,A100-SXM4-80GB,8,1,64,448,20,142
7512267b-ea6d-4fc0-a396-40416a2c3b9a,geogpt-lxz-sft-magpie-llama3-pro-2ep-72b,1719888301,1719888599,finished,1719888340,1719888599,A100-SXM4-80GB,8,16,64,448,39,259
9ad2dc7a-bbd9-4a7e-8fc4-2fa9ea41b650,qwen2-cpt8k-extra,1719888399,1719900544,finished,1719888419,1719900544,A100-SXM4-80GB,8,1,64,448,20,12125
36d2fbd2-080c-4eff-b097-a4d1d1748804,geo-MoD-1-8B,1719888443,1719888616,finished,1719888461,1719888616,A100-SXM4-80GB,8,1,64,448,18,155
f86e8496-8789-486b-b0de-a4276349bb96,GeoGPT-0701-v1-c7b95-auto,1719888523,1719900711,finished,1719888543,1719900711,A100-SXM4-80GB,8,1,64,448,20,12168
6375c184-63f2-4eef-9837-b61839b03fa1,GeoGPT-0701-v2-fbdf9-auto,1719888561,1719900636,finished,1719888584,1719900636,A100-SXM4-80GB,8,1,64,448,23,12052
e5f73ed7-10c9-4f95-ac1e-ac1c80999832,geogpt-lxz-sft-magpie-llama3-pro-2ep-72b,1719888657,1719888964,finished,1719888694,1719888964,A100-SXM4-80GB,8,16,64,448,37,270
f2dadd3b-5127-45d6-8f9e-af62134352ca,geo-MoD-1-8B,1719888718,1719888888,finished,1719888737,1719888888,A100-SXM4-80GB,8,1,64,448,19,151
f71cc808-f39e-455e-b833-8340b0e7f95b,geo-MoD-1-8B,1719888980,1719889145,finished,1719888999,1719889145,A100-SXM4-80GB,8,1,64,448,19,146
6802a1bc-2432-4082-b5df-5cfbd1f50bce,geogpt-lxz-sft-magpie-llama3-pro-2ep-72b,1719889024,1719889356,finished,1719889084,1719889356,A100-SXM4-80GB,8,16,64,448,60,272
c281ad4b-1ce8-43b0-892f-d3b8e266fe58,GeoGPT-0701-v2,1719889064,1719931932,finished,1719889092,1719931932,A100-SXM4-80GB,8,1,64,448,28,42840
e3247436-22dd-4d38-9ff8-006281106526,GeoGPT-0701-v1,1719889066,1719931932,finished,1719889092,1719931932,A100-SXM4-80GB,8,1,64,448,26,42840
49a1f48d-cebb-4465-ac79-429cbc4dcacc,geo-MoD-1-8B,1719889241,1719889415,finished,1719889260,1719889415,A100-SXM4-80GB,8,1,64,448,19,155
04ae132c-d47e-4909-a662-7431eb3656e6,geo-seesaw-sft-code-alpaca-ultra-eval-test,1719889260,1720081250,finished,1719889279,1720081250,A100-SXM4-80GB,8,1,64,896,19,191971
6a228f5c-321d-4fbd-9d9f-fcb2fa16ea39,geogpt-lxz-sft-magpie-llama3-pro-2ep-72b,1719889417,1719889743,finished,1719889473,1719889743,A100-SXM4-80GB,8,16,64,448,56,270
a838a3b6-8ead-464c-bda5-722435c5f065,test-xiaodianq,1719889427,1719913757,finished,1719889445,1719913757,A100-SXM4-80GB,8,1,64,896,18,24312
928098e6-2361-43ce-9b89-8723f93ef699,geo-MoD-1-8B,1719889517,1719889701,finished,1719889536,1719889701,A100-SXM4-80GB,8,1,64,448,19,165
f3c54f76-c729-4e4c-8eaf-f32ed4eb5758,geogpt-7b-50bcpt,1719889724,1719996851,finished,1719889787,1719996851,A100-SXM4-80GB,8,32,64,448,63,107064
e96671d2-76a2-4632-b664-a80dc9e4a986,geo-MoD-1-8B,1719889815,1719889990,finished,1719889835,1719889990,A100-SXM4-80GB,8,1,64,448,20,155
5609c9cd-8421-44d7-ae82-6bac165db047,geogpt-lxz-sft-magpie-llama3-pro-2ep-72b,1719889818,1719890122,finished,1719889855,1719890122,A100-SXM4-80GB,8,16,64,448,37,267
cde6fb4f-f383-468d-9ad4-befdec6ac8e4,geo-MoD-1-8B,1719890083,1719890278,finished,1719890102,1719890278,A100-SXM4-80GB,8,1,64,448,19,176
d19c28a3-6126-47e5-a403-6e4bc631e727,geogpt-lxz-sft-magpie-llama3-pro-2ep-72b,1719890183,1719890487,finished,1719890219,1719890487,A100-SXM4-80GB,8,16,64,448,36,268
67d118be-b411-4f38-b9f9-e788ddb6c390,easycontext-2nodes,1719890293,1719891504,finished,1719890349,1719891504,A100-SXM4-80GB,8,2,64,448,56,1155
b49b902d-e570-4376-885b-6b8ab3265da0,geo-MoD-1-8B,1719890372,1719890546,finished,1719890391,1719890546,A100-SXM4-80GB,8,1,64,448,19,155
374915e1-e721-41a9-89b4-f9e5e8fe574d,geogpt-lxz-sft-magpie-llama3-pro-2ep-72b,1719890548,1719890859,finished,1719890587,1719890859,A100-SXM4-80GB,8,16,64,448,39,272
da845518-8ad5-4a99-8248-18345b171f85,geo-MoD-1-8B,1719890647,1719890820,finished,1719890665,1719890820,A100-SXM4-80GB,8,1,64,448,18,155
27da40c6-5309-4bc9-9e2a-c999b77a5c60,GeoGPT-1215-13307-auto,1719890806,1719900640,finished,1719890826,1719900640,A100-SXM4-80GB,8,1,64,448,20,9814
c9d8cf75-1867-467a-ba1c-78db09ef5383,GeoGPT-0206-0838a-auto,1719890807,1719900640,finished,1719890826,1719900640,A100-SXM4-80GB,8,1,64,448,19,9814
3b342c53-708e-45fb-8cfc-52e89da7f795,GeoGPT-0412-f232d-auto,1719890865,1719900640,finished,1719890886,1719900640,A100-SXM4-80GB,8,1,64,448,21,9754
b4cc2663-625c-49aa-ada9-c98a5beadc57,easycontext-zj-8b,1719890893,1719891112,finished,1719890917,1719891112,A100-SXM4-80GB,8,1,64,896,24,195
62121c9b-063d-434e-b318-a898d6edda55,geo-MoD-1-8B,1719890922,1719891097,finished,1719890941,1719891097,A100-SXM4-80GB,8,1,64,448,19,156
d9e184fa-4472-494d-b61e-4b6fdfdc1ce6,geogpt-lxz-sft-magpie-llama3-pro-2ep-72b,1719890924,1719891216,finished,1719890962,1719891216,A100-SXM4-80GB,8,16,64,448,38,254
35587761-2e90-4183-a3f1-8be0c9704e07,geo-MoD-1-8B,1719891213,1719891411,finished,1719891232,1719891411,A100-SXM4-80GB,8,1,64,448,19,179
8b6f0470-2d8d-4af9-ac56-b569c34bcfc6,geogpt-lxz-sft-magpie-llama3-pro-2ep-72b,1719891273,1719891605,finished,1719891330,1719891605,A100-SXM4-80GB,8,16,64,448,57,275
69154866-0dcd-4184-9a28-96f7b7bb6fde,easycontext-zj-8b,1719891350,1719891543,finished,1719891369,1719891543,A100-SXM4-80GB,8,1,64,896,19,174
c261f542-433b-4194-8f66-05ffd7636be2,easycontext-2nodes,1719891504,1719896906,finished,1719891562,1719896906,A100-SXM4-80GB,8,2,64,448,58,5344
d3bc549c-6e13-4a1c-85fa-b05bf4f39527,geo-MoD-1-8B,1719891509,1719891720,finished,1719891528,1719891720,A100-SXM4-80GB,8,1,64,448,19,192
ea3333b4-c619-4d21-8a3d-bc7e22e1eafb,geogpt-lxz-sft-magpie-llama3-pro-2ep-72b,1719891681,1719892019,finished,1719891748,1719892019,A100-SXM4-80GB,8,16,64,448,67,271
12dac101-f9f4-4360-ab8f-70360e482477,easycontext-zj-8b,1719891716,1719892768,finished,1719891741,1719892768,A100-SXM4-80GB,8,1,64,896,25,1027
8dba8c50-162b-4aac-900c-05cfbbe00878,geo-MoD-1-8B,1719891849,1719892403,finished,1719891868,1719892403,A100-SXM4-80GB,8,1,64,448,19,535
3d41d9ea-9ff9-47d8-9e3f-55ac108c4c48,geo-base-offline-eval,1719891906,1719902431,finished,1719891925,1719902431,A100-SXM4-80GB,8,1,64,448,19,10506
05f0ef93-80a6-4c44-8601-ce852c02a333,geogpt-lxz-sft-magpie-llama3-pro-2ep-72b,1719892080,1719892404,finished,1719892137,1719892404,A100-SXM4-80GB,8,16,64,448,57,267
1e18b742-b500-486e-8f67-44ee51513ffd,geogpt-lxz-sft-magpie-llama3-pro-2ep-72b,1719892467,1719892812,finished,1719892529,1719892812,A100-SXM4-80GB,8,16,64,448,62,283
652d52ed-f9c1-4bab-8b27-0d976a64c1bc,geogpt-lxz-sft-magpie-llama3-pro-2ep-72b,1719892872,1719893184,finished,1719892909,1719893184,A100-SXM4-80GB,8,16,64,448,37,275
bca09dbe-eba8-47ce-bf8a-43c6779e0703,geogpt-7b-lp40-s2-sft-40w,1719893072,1719893243,finished,1719893145,1719893243,A100-SXM4-80GB,8,2,64,448,73,98
8668ab64-555b-424d-889d-8e105fae9df8,geogpt-lxz-sft-magpie-llama3-pro-2ep-72b,1719893261,1719893590,finished,1719893325,1719893590,A100-SXM4-80GB,8,16,64,448,64,265
9ee5ba23-a8b9-4b1c-bd4f-5e9605766005,geogpt-7b-lp40-s2-sft-40w,1719893309,1719922598,finished,1719893354,1719922598,A100-SXM4-80GB,8,2,64,448,45,29244
5d334717-0d80-4858-b589-0e2798ee0646,LLAMA2-7B-ALPACAMOSAIClongtext-a338e-auto,1719893360,1719893401,finished,1719893382,1719893401,A100-SXM4-40GB,1,1,8,32,22,19
4ab4d031-b501-451e-9086-4f2e9f659cb7,geogpt-dairui-model-merge-exp-1,1719893393,1719893609,finished,1719893413,1719893609,A100-SXM4-80GB,8,1,64,896,20,196
10e93a84-7717-4bcd-94e5-73665d1ecc0b,Mistral7B-ALPACAMOSAIClongtext-607f2-auto,1719893461,1719893499,finished,1719893480,1719893499,A100-SXM4-40GB,1,1,8,96,19,19
b95467a6-278c-4f10-9a92-cb4f1b2dc1cc,geogpt-smoe-eval,1719893631,1719954578,finished,1719893657,1719954578,A100-SXM4-80GB,8,1,64,448,26,60921
d2af3221-a7ce-464c-af9e-c08aac4ac5c3,geogpt-lxz-sft-magpie-llama3-pro-2ep-72b,1719893657,1719893977,finished,1719893695,1719893977,A100-SXM4-80GB,8,16,64,448,38,282
e986b8e9-3971-430f-b4a7-bb2f72be54fa,geo-qwen0-5-cpt-freezeEmbed,1719893800,1719893975,finished,1719893821,1719893975,A100-SXM4-80GB,8,1,64,896,21,154
fb9ce05a-ced9-42e8-97c4-249399dc3f40,geogpt-lxz-sft-magpie-llama3-pro-2ep-72b,1719894041,1719894374,finished,1719894103,1719894374,A100-SXM4-80GB,8,16,64,448,62,271
124ffb27-9e71-478b-8839-4a92c058bc00,geogpt-dairui-model-merge-exp-1,1719894060,1719902250,finished,1719894081,1719902250,A100-SXM4-80GB,8,1,64,896,21,8169
079eac32-5358-440d-8d74-28a7e9181d20,geo-qwen0-5-cpt-freezeEmbed,1719894147,1719894312,finished,1719894167,1719894312,A100-SXM4-80GB,8,1,64,896,20,145
1bf8617e-9744-4fa0-9a7e-f280f2f041f3,geogpt-lxz-sft-magpie-llama3-pro-2ep-72b,1719894437,1719894778,finished,1719894496,1719894778,A100-SXM4-80GB,8,16,64,448,59,282
eceaeef0-aacc-44b9-aab2-97ba1b26f4df,geogpt-7b-lp40-s2-gate-2b,1719894478,1719894682,finished,1719894544,1719894682,A100-SXM4-80GB,8,2,64,448,66,138
056b9f45-74db-4634-bf32-ecc8cc467653,geo-qwen0-5-cpt-freezeEmbed,1719894697,1720020169,finished,1719894716,1720020169,A100-SXM4-80GB,8,1,64,896,19,125453
fde2bdca-446f-4a1d-b55e-6d8bdcc77239,geogpt-7b-lp40-s2-gate-2b,1719894800,1719979901,finished,1719894867,1719979901,A100-SXM4-80GB,8,2,64,448,67,85034
80dd5c99-7f0b-46fe-832c-7a7cb6cd2e2e,geogpt-lxz-sft-magpie-llama3-pro-2ep-72b,1719894843,1719895167,finished,1719894903,1719895167,A100-SXM4-80GB,8,16,64,448,60,264
99602ef3-1721-445a-970a-616a923dec68,geo-qwen0-5-cpt-freezeEmbed,1719894950,1719952399,finished,1719894970,1719952399,A100-SXM4-80GB,8,1,64,896,20,57429
cb811bf5-2057-4785-a222-b429ca1f8791,geogpt-lxz-sft-magpie-llama3-pro-2ep-72b,1719895231,1719895566,finished,1719895289,1719895566,A100-SXM4-80GB,8,16,64,448,58,277
ba528c63-5fb3-48db-88b0-671022614de7,geogpt-lxz-sft-magpie-llama3-pro-2ep-72b,1719895629,1719895954,finished,1719895691,1719895954,A100-SXM4-80GB,8,16,64,448,62,263
64ebcb9a-44e5-46fa-a45b-6e0cdbf75ab4,sfr-eval-mteb,1719895665,1719896031,finished,1719895685,1719896031,A100-SXM4-80GB,8,1,64,448,20,346
bafdd3ab-91a8-4d42-ad7a-4dceb7a4dea6,geogpt-lxz-sft-magpie-llama3-pro-2ep-72b,1719896017,1719896356,finished,1719896077,1719896356,A100-SXM4-80GB,8,16,64,448,60,279
6dd847d7-a993-47e7-81d9-254b2b07cc9c,sfr-eval-mteb,1719896097,1719896331,finished,1719896117,1719896331,A100-SXM4-80GB,8,1,64,448,20,214
ec8440e1-9925-42a2-8190-4e0fb1c7509d,sfr-eval-mteb,1719896391,1719896637,finished,1719896415,1719896637,A100-SXM4-80GB,8,1,64,448,24,222
99f83e02-3703-456d-bc05-d67dc564b78a,geogpt-lxz-sft-magpie-llama3-pro-2ep-72b,1719896422,1719896761,finished,1719896482,1719896761,A100-SXM4-80GB,8,16,64,448,60,279
15f7242f-d3e2-4726-8aec-27b0a69d8ceb,sfr-eval-mteb,1719896697,1719896944,finished,1719896717,1719896944,A100-SXM4-80GB,8,1,64,448,20,227
29ea5d6c-24c9-4873-a970-1814351109ee,geogpt-lxz-sft-magpie-llama3-pro-2ep-72b,1719896825,1719897162,finished,1719896886,1719897162,A100-SXM4-80GB,8,16,64,448,61,276
b935d4f6-3f76-47b1-924a-dc8243c2b794,sfr-eval-mteb,1719897003,1719897239,finished,1719897023,1719897239,A100-SXM4-80GB,8,1,64,448,20,216
a30c9f7b-d40c-42b0-9fa4-59158082b2b8,geogpt-lxz-sft-magpie-llama3-pro-2ep-72b,1719897225,1719897524,finished,1719897264,1719897524,A100-SXM4-80GB,8,16,64,448,39,260
c7771002-62b9-46a5-bd8e-7ed6e53abbea,sfr-eval-mteb,1719897305,1719897582,finished,1719897324,1719897582,A100-SXM4-80GB,8,1,64,448,19,258
6993e73d-dc3e-44d5-ba22-edff6c869c72,easycontext-2nodes,1719897403,1719904151,finished,1719897461,1719904151,A100-SXM4-80GB,8,2,64,448,58,6690
316ab2bb-8301-4c56-956d-ce31e0fca74b,geogpt-lxz-sft-magpie-llama3-pro-2ep-72b,1719897588,1719897924,finished,1719897648,1719897924,A100-SXM4-80GB,8,16,64,448,60,276
431b223b-1841-4ef5-a09d-1a961d749b95,sfr-eval-mteb,1719897642,1719897879,finished,1719897668,1719897879,A100-SXM4-80GB,8,1,64,448,26,211
ae3325da-d906-423e-998a-de0532c51e72,sfr-eval-mteb,1719897938,1719898164,finished,1719897957,1719898164,A100-SXM4-80GB,8,1,64,448,19,207
445cbad6-5df8-445a-baa2-1e8157e3687d,geogpt-lxz-sft-magpie-llama3-pro-2ep-72b,1719897988,1719898307,finished,1719898040,1719898307,A100-SXM4-80GB,8,16,64,448,52,267
dd3ff752-a171-48e5-ad30-273a2473a2ad,q72b-ties-w46-d100100-eed8d-auto,1719897995,1719900690,finished,1719898014,1719900690,A100-SXM4-80GB,8,1,64,448,19,2676
585014c7-1f73-4dd6-a5f9-c3cd2a095ecc,q72b-ties-w46-d7575-6cb38-auto,1719898016,1719900691,finished,1719898039,1719900691,A100-SXM4-80GB,8,1,64,448,23,2652
dc51281b-db15-4de4-aae9-4d6a474ddea4,q72b-ties-w46-d10050-7ad91-auto,1719898018,1719900691,finished,1719898039,1719900691,A100-SXM4-80GB,8,1,64,448,21,2652
d021329e-476c-44b7-9278-2801b4c38899,q72b-ties-w46-d50100-b94f2-auto,1719898020,1719900691,finished,1719898039,1719900691,A100-SXM4-80GB,8,1,64,448,19,2652
7a9b8656-08da-497d-95bd-8b298c03a7de,q72b-ties-w46-d75100-3e5b3-auto,1719898068,1719900692,finished,1719898287,1719900692,A100-SXM4-80GB,8,1,64,448,219,2405
41ac1408-0dac-482d-8ec4-224f081674c2,q72b-ties-w46-d7550-b37df-auto,1719898069,1719900693,finished,1719898288,1719900693,A100-SXM4-80GB,8,1,64,448,219,2405
2fb99e26-d8f8-4077-8ba1-a82a532548af,q72b-ties-w46-d10075-6c990-auto,1719898071,1719900694,finished,1719898150,1719900694,A100-SXM4-80GB,8,1,64,448,79,2544
eb9242b5-d709-4c23-a647-c0e3fcbc8b7d,sfr-eval-mteb,1719898242,1719898532,finished,1719898301,1719898532,A100-SXM4-80GB,8,1,64,448,59,231
8f25c5f8-6388-46ce-8220-e03f65c6e980,q72b-ties-w46-d10050-1ec20-auto,1719898543,1719899848,finished,1719898564,1719899848,A100-SXM4-80GB,8,1,64,448,21,1284
620bbc0b-85b1-4edb-b0ef-fe8e5f145243,q72b-ties-w46-d10075-023f8-auto,1719898566,1719900436,finished,1719898592,1719900436,A100-SXM4-80GB,8,1,64,448,26,1844
5011512c-fafe-4ab9-b570-9e4a42898a98,q72b-ties-w46-d7575-e18af-auto,1719898568,1719899525,finished,1719898592,1719899525,A100-SXM4-80GB,8,1,64,448,24,933
938daba3-c25c-4248-b18c-56e068768f7d,q72b-ties-w46-d75100-1a1a8-auto,1719898592,1719900508,finished,1719898636,1719900508,A100-SXM4-80GB,8,1,64,448,44,1872
826dea5a-e8cf-43ab-b5cf-c3e4390332ee,q72b-ties-w46-d100100-8d325-auto,1719898595,1719900509,finished,1719898636,1719900509,A100-SXM4-80GB,8,1,64,448,41,1873
2acc6843-63e7-415b-b3d7-0cb5a00fa964,q72b-ties-w46-d7550-65e94-auto,1719898597,1719899850,finished,1719898636,1719899850,A100-SXM4-80GB,8,1,64,448,39,1214
85dc2f7d-0209-4ae7-af47-104905835597,q72b-ties-w46-d100100-5c8f6-auto,1719898598,1719899576,finished,1719898636,1719899576,A100-SXM4-80GB,8,1,64,448,38,940
854d23c6-94ed-498f-ab65-ded856cbb1c4,q72b-ties-w46-d7550-bcac9-auto,1719898601,1719900631,finished,1719898636,1719900631,A100-SXM4-80GB,8,1,64,448,35,1995
560dd3d7-c703-46d0-9036-4177396d8f91,q72b-ties-w46-d7575-a9613-auto,1719898602,1719900437,finished,1719898636,1719900437,A100-SXM4-80GB,8,1,64,448,34,1801
ce36bb83-148c-415d-bd31-fd98db30ae08,q72b-ties-w46-d10075-af8d8-auto,1719898604,1719899875,finished,1719898636,1719899875,A100-SXM4-80GB,8,1,64,448,32,1239
c298a45d-8277-4a3e-8be3-d257c4703915,q72b-ties-w46-d50100-94e61-auto,1719898606,1719900632,finished,1719898637,1719900632,A100-SXM4-80GB,8,1,64,448,31,1995
eb955c7b-e506-432a-8edc-d6334f03e952,q72b-ties-w46-d75100-b1bbd-auto,1719898609,1719899728,finished,1719898637,1719899728,A100-SXM4-80GB,8,1,64,448,28,1091
3257156f-f67a-4925-9d5d-4723727d969d,q72b-ties-w46-d10050-c1e36-auto,1719898610,1719900656,finished,1719898637,1719900656,A100-SXM4-80GB,8,1,64,448,27,2019
01f18404-933d-4ef0-9345-8dcdac50cd14,q72b-ties-w46-d50100-6600d-auto,1719898612,1719899827,finished,1719898638,1719899827,A100-SXM4-80GB,8,1,64,448,26,1189
c60c9ec8-a932-41b3-b749-815f23fb710b,Mistral7B-ALPACAMOSAIClongtext2-cafc3-auto,1719899684,1719900613,finished,1719899711,1719900613,A100-SXM4-80GB,8,1,64,448,27,902
6d243b7f-f33d-41a7-b048-0778cafe71f0,qwen2-72b-instruct-87073-auto,1719899864,1719900594,finished,1719899889,1719900594,A100-SXM4-80GB,8,1,64,896,25,705
5255b391-2262-470e-899e-6fac8b3645a6,qwen2-72b-instruct-extra-128k-1adec-auto,1719900029,1719900543,finished,1719900054,1719900543,A100-SXM4-80GB,8,1,64,896,25,489
c904a7ba-bb4c-4774-b83e-df0859a27d37,megatron-gpt-16nodes,1719900483,1719901175,finished,1719900744,1719901175,A100-SXM4-80GB,8,16,64,448,261,431
e6e0761d-8ab1-429f-bf93-c36fad5070d2,geogpt-lxz-sft-magpie-llama3-pro-2ep-72b,1719900514,1719902040,finished,1719901604,1719902040,A100-SXM4-80GB,8,16,64,448,1090,436
90277115-158e-4b2a-a070-577b62d3983b,qwen2-cpt8k-extra,1719900544,1719923188,finished,1719900570,1719923188,A100-SXM4-80GB,8,1,64,448,26,22618
615c9144-5eaa-46bd-92d2-d8a25cd7eabc,q72b-ties-w64-d75100-79144-auto,1719900657,1719912761,finished,1719900695,1719912761,A100-SXM4-80GB,8,1,64,448,38,12066
2d898848-283f-42bb-8512-b6470a014159,q72b-ties-w64-d5075-37df3-auto,1719900659,1719901505,finished,1719900695,1719901505,A100-SXM4-80GB,8,1,64,448,36,810
379a63ad-dadd-4bf1-bde6-e4fc55855081,q72b-ties-w64-d10050-700d2-auto,1719900661,1719901882,finished,1719900695,1719901882,A100-SXM4-80GB,8,1,64,448,34,1187
c8ac41c7-063d-4962-9e19-c1588be09fe2,q72b-ties-w64-d7550-2578c-auto,1719900664,1719913724,finished,1719900696,1719913724,A100-SXM4-80GB,8,1,64,448,32,13028
62a400db-a28d-483f-9199-f301696b15cb,q72b-ties-w64-d75100-ec86b-auto,1719900666,1719901551,finished,1719900696,1719901551,A100-SXM4-80GB,8,1,64,448,30,855
0fa8bc99-3b3a-43ba-90e8-99698f82b87c,q72b-ties-w64-d100100-ddb7d-auto,1719900697,1719901699,finished,1719900728,1719901699,A100-SXM4-80GB,8,1,64,448,31,971
4d5fbb3f-b837-4b5b-97ca-1f9b0dfccbc4,q72b-ties-w64-d7575-18bc6-auto,1719900698,1719901721,finished,1719900729,1719901721,A100-SXM4-80GB,8,1,64,448,31,992
b7febac0-ff59-4378-9481-85b46b04617d,q72b-ties-w64-d7550-d20f0-auto,1719900700,1719901972,finished,1719900729,1719901972,A100-SXM4-80GB,8,1,64,448,29,1243
d688c38b-9b61-4a43-aaef-70aa538122f5,q72b-ties-w64-d50100-d5e44-auto,1719900702,1719901789,finished,1719900757,1719901789,A100-SXM4-80GB,8,1,64,448,55,1032
385591da-f116-420b-b58c-a83f5f5db8cd,q72b-ties-w64-d10075-9a237-auto,1719900703,1719901652,finished,1719900729,1719901652,A100-SXM4-80GB,8,1,64,448,26,923
29cd2afa-e01b-4ea2-af13-0a3efbf41686,q72b-ties-w64-d50100-9ff76-auto,1719900707,1719902551,finished,1719900729,1719902551,A100-SXM4-80GB,8,1,64,448,22,1822
eea67e5c-dd9f-443a-b57e-49ff284a926c,q72b-ties-w64-d5075-2d259-auto,1719900708,1719902851,finished,1719901116,1719902851,A100-SXM4-80GB,8,1,64,448,408,1735
5745b9ed-ec0c-440a-8fe7-45a816f95dfc,q72b-ties-w64-d10075-077ad-auto,1719900758,1719902967,finished,1719901117,1719902967,A100-SXM4-80GB,8,1,64,448,359,1850
8ee64685-a540-40bf-a637-8b0f64dd5394,q72b-ties-w64-d75100-31099-auto,1719900760,1719902968,finished,1719901117,1719902968,A100-SXM4-80GB,8,1,64,448,357,1851
4c7e88a5-7926-41fa-8966-d2853f32d9fb,q72b-ties-w64-d7550-62e42-auto,1719900762,1719903079,finished,1719901117,1719903079,A100-SXM4-80GB,8,1,64,448,355,1962
7cfbc2cf-5e6e-40a2-8a85-9a13d9d41184,q72b-ties-w64-d7575-2ee9b-auto,1719900764,1719902969,finished,1719901117,1719902969,A100-SXM4-80GB,8,1,64,448,353,1852
09ebb649-c63f-4469-b397-a0e1b172480e,q72b-ties-w64-d100100-95e10-auto,1719901187,1719913566,finished,1719901208,1719913566,A100-SXM4-80GB,8,1,64,448,21,12358
eb4bc97c-d234-4bb3-953b-c1e387f2d90e,q72b-ties-w64-d7575-7bcee-auto,1719901211,1719913519,finished,1719901232,1719913519,A100-SXM4-80GB,8,1,64,448,21,12287
811ef895-ba87-4660-83ce-5accf76a11d6,q72b-ties-w64-d50100-9b9de-auto,1719901255,1719913677,finished,1719901280,1719913677,A100-SXM4-80GB,8,1,64,448,25,12397
5920d48a-96d4-4994-a93b-d82709132e39,q72b-ties-w64-d10075-ebdef-auto,1719901257,1719913542,finished,1719901280,1719913542,A100-SXM4-80GB,8,1,64,448,23,12262
c5ee3ca3-35e9-4a2d-83e4-9ffa124a8a84,q72b-ties-w64-d10050-bb9e5-auto,1719901259,1719914071,finished,1719901280,1719914071,A100-SXM4-80GB,8,1,64,448,21,12791
c947c931-5d16-4854-8140-174fd10c4163,q72b-ties-w64-d5075-e9249-auto,1719901282,1719913520,finished,1719901308,1719913520,A100-SXM4-80GB,8,1,64,448,26,12212
5ef73a9b-c9bb-434f-8c12-dbc98ce3143b,mistral-longtext-146c8-auto,1719901399,1719902538,finished,1719901424,1719902538,A100-SXM4-80GB,8,1,64,448,25,1114
4ba07d97-7c3e-4e4f-b836-d91cc409ac8b,qwen-72b-test,1719901672,1719910980,finished,1719901696,1719910980,A100-SXM4-80GB,8,1,64,448,24,9284
ea31b511-b70f-4d49-b63d-6ed74358936c,qwen-72b-test,1719901856,1719991495,finished,1719901879,1719991495,A100-SXM4-40GB,8,1,32,320,23,89616
2f1246c8-b7de-463c-9eac-302c1a842c9d,geogpt-lxz-sft-magpie-llama3-pro-2ep-72b,1719902111,1719902457,finished,1719902181,1719902457,A100-SXM4-80GB,8,16,64,448,70,276
f3f1f482-cb2d-418c-985f-20d11ead5ddd,llama2-longtext2-785bf-auto,1719902143,1719903641,finished,1719902166,1719903641,A100-SXM4-80GB,8,1,64,448,23,1475
ed688d07-1bdd-4c3d-a577-70292a67d1f5,geogpt-dairui-model-merge-exp-1,1719902319,1719903874,finished,1719902342,1719903874,A100-SXM4-80GB,8,1,64,896,23,1532
71b55846-60c5-484d-91c4-f889593e7d2a,geogpt-lxz-sft-magpie-llama3-pro-2ep-72b,1719902530,1719902849,finished,1719902577,1719902849,A100-SXM4-80GB,8,16,64,448,47,272
e7dd04b1-0bd4-4de9-8aa5-2f1961cadba1,q72b-ties-w46-d5075-6d660-auto,1719902854,1719914980,finished,1719902877,1719914980,A100-SXM4-80GB,8,1,64,448,23,12103
04d6406a-ff8b-4a1f-96ec-4ecbdc096569,geogpt-lxz-sft-magpie-llama3-pro-2ep-72b,1719902923,1719903246,finished,1719902971,1719903246,A100-SXM4-80GB,8,16,64,448,48,275
34863754-c5d2-4be1-8e98-131febdb3ce6,geogpt-lxz-sft-magpie-llama3-pro-2ep-72b,1719903312,1719903613,finished,1719903355,1719903613,A100-SXM4-80GB,8,16,64,448,43,258
5b9cafb3-cbd1-4482-a039-4e3474b5242b,geogpt-lxz-sft-magpie-llama3-pro-2ep-72b,1719903682,1719904024,finished,1719903745,1719904024,A100-SXM4-80GB,8,16,64,448,63,279
26168279-c454-44d7-83fe-818dd962208c,geogpt-dairui-model-merge-exp-1,1719903874,1719910032,finished,1719903895,1719910032,A100-SXM4-80GB,8,1,64,896,21,6137
3d46477b-2240-4091-a04e-c8dc56ec2d87,geogpt-lxz-sft-magpie-llama3-pro-2ep-72b,1719904092,1719904438,finished,1719904158,1719904438,A100-SXM4-80GB,8,16,64,448,66,280
e59a4893-4ea5-4bb3-b7db-f21228e725d9,llama-factory-long,1719904107,1719904331,finished,1719904179,1719904331,A100-SXM4-80GB,8,2,64,448,72,152
7b7149b5-c926-4b91-beaf-ae17764b5b27,geogpt-dairui-model-merge-exp-2,1719904290,1719904437,finished,1719904313,1719904437,A100-SXM4-80GB,8,1,64,896,23,124
407274c3-3be7-4fcc-8090-39972a7675e6,q72b-linear-w55-c21c4-auto,1719904295,1719905201,finished,1719904317,1719905201,A100-SXM4-80GB,8,1,64,448,22,884
efbc0b9a-ea09-4357-9a80-7f8b00088afd,geogpt-lxz-sft-magpie-llama3-pro-2ep-72b,1719904504,1719904984,finished,1719904546,1719904984,A100-SXM4-80GB,8,16,64,448,42,438
8f257678-0e2d-4604-b8b1-091ed1c9f5df,geogpt-moe-alpaca-sft-merge-model,1719904648,1719905454,finished,1719904719,1719905454,A100-SXM4-80GB,8,2,64,448,71,735
79b53faa-7086-47f9-aa72-e038191302a5,llama-factory-long,1719904698,1719904977,finished,1719904742,1719904977,A100-SXM4-80GB,8,2,64,448,44,235
88d3730f-75e6-4fab-9631-c3b5f6d25b13,citysora-modelv4plus-256,1719905056,1719905324,finished,1719905172,1719905324,A100-SXM4-80GB,8,8,64,896,116,152
e14662d0-43a4-4f71-83ab-c4ce7308ebf2,geogpt-lxz-sft-magpie-llama3-pro-2ep-72b,1719905059,1719905506,finished,1719905102,1719905506,A100-SXM4-80GB,8,16,64,448,43,404
713a8751-603e-4d45-aa2f-7f9fc208f866,citysora-modelv4plus-512,1719905129,1719915429,finished,1719905196,1719915429,A100-SXM4-80GB,8,5,64,896,67,10233
e84c9f3f-37ab-4a0a-992d-f3365ba1a0e8,llama-factory-long,1719905341,1719905816,finished,1719905411,1719905816,A100-SXM4-80GB,8,2,64,448,70,405
1b531951-f225-49d2-9f4a-9b4fe8071c4a,run-reward-model,1719905350,1719905801,finished,1719905375,1719905801,A100-SXM4-80GB,8,1,64,448,25,426
f1b821b6-97f0-4622-9cb2-412493e6cf65,citysora-modelv4plus-256,1719905393,1719905637,finished,1719905436,1719905637,A100-SXM4-80GB,8,8,64,896,43,201
342524f9-71ab-4c0e-8af5-6da50422c10b,geogpt-dairui-model-merge-exp-2,1719905524,1719905666,finished,1719905548,1719905666,A100-SXM4-80GB,8,1,64,896,24,118
62088b94-b571-4ab2-a62b-1d3061f8ca4d,geogpt-lxz-sft-magpie-llama3-pro-2ep-72b,1719905578,1719905931,finished,1719905641,1719905931,A100-SXM4-80GB,8,16,64,448,63,290
b7eb5726-22a0-423b-8ca4-200855ec9bcd,citysora-modelv4plus-256,1719905687,1719906240,finished,1719905731,1719906240,A100-SXM4-80GB,8,8,64,896,44,509
7706dd94-c44b-44fa-ae40-6f92cf0b70cd,easycontext-zj-8b,1719905772,1719906151,finished,1719905793,1719906151,A100-SXM4-80GB,8,1,64,896,21,358
2b452b6f-82f2-433f-b37c-da1c62a921ac,llama-factory-long,1719905859,1719906151,finished,1719905903,1719906151,A100-SXM4-80GB,8,2,64,448,44,248
d82e4848-84ea-4577-bb90-0038fa2bfb76,cft-1-8m-sub-plus-mt-qwen2-72b,1719905866,1720059404,finished,1719905888,1720059404,A100-SXM4-80GB,8,1,64,448,22,153516
b325eb61-f763-4785-a98f-d5a5d09cd8a3,geogpt-lxz-sft-magpie-llama3-pro-2ep-72b,1719905998,1719906358,finished,1719906068,1719906358,A100-SXM4-80GB,8,16,64,448,70,290
1cb61f62-6233-42a6-8832-deaeef75765c,q72b-ties-w64-d100100-235fb-auto,1719906046,1719907832,finished,1719906068,1719907832,A100-SXM4-80GB,8,1,64,448,22,1764
150c6cc6-0616-43f8-ada7-0c4018d53d96,easycontext-zj-8b,1719906151,1719906697,finished,1719906172,1719906697,A100-SXM4-80GB,8,1,64,896,21,525
5606e0c6-6ea5-419a-9517-bd038008707f,q72b-ties-w64-d10050-6cbff-auto,1719906223,1719908238,finished,1719906245,1719908238,A100-SXM4-80GB,8,1,64,448,22,1993
b216c9c3-af08-43a9-a26c-46bec6bc7865,geogpt-dairui-model-merge-exp-2,1719906263,1719906427,finished,1719906287,1719906427,A100-SXM4-80GB,8,1,64,896,24,140
bb68029f-5eec-48e7-b6a8-e8abe12de9ba,geogpt-moe-0-5B-tag-1-fire-attn,1719906310,1719906379,finished,1719906333,1719906379,A100-SXM4-80GB,8,1,64,896,23,46
cfaeede9-6d19-4fd2-b704-e7d1023fab8b,llama-factory-long,1719906352,1719906805,finished,1719906422,1719906805,A100-SXM4-80GB,8,2,64,448,70,383
e9e368bc-afdf-4f93-b8a6-8d60ea6edbb3,easycontext-zj-8b-cg,1719906374,1719906697,finished,1719906395,1719906697,A100-SXM4-80GB,8,1,64,896,21,302
61642547-f4d8-4789-b9e1-ef5200449c8b,geogpt-lxz-sft-magpie-llama3-pro-2ep-72b,1719906430,1719906770,finished,1719906499,1719906770,A100-SXM4-80GB,8,16,64,448,69,271
da107bf4-2213-47aa-b10b-ae9b3d15f1ba,citysora-modelv4plus-256,1719906472,1719907363,finished,1719906544,1719907363,A100-SXM4-80GB,8,8,64,896,72,819
7e3d9f06-2049-454d-8cf3-9f813e869706,geogpt-moe-0-5B-tag-1-fire-attn,1719906473,1719906548,finished,1719906523,1719906548,A100-SXM4-80GB,8,2,64,896,50,25
261b43ba-f888-43e2-b010-5bbb1c2d842d,geogpt-dairui-model-merge-exp-2,1719906612,1719911586,finished,1719906633,1719911586,A100-SXM4-80GB,8,1,64,896,21,4953
aefa8750-f18e-4a1e-bf68-385df5ff1f85,easycontext-zj-8b-cg,1719906697,1719907269,finished,1719906719,1719907269,A100-SXM4-80GB,8,1,64,896,22,550
32c8183f-d580-44ca-86f6-75c59cdc47b4,easycontext-zj-8b,1719906697,1719907223,finished,1719906719,1719907223,A100-SXM4-80GB,8,1,64,896,22,504
f1943419-6ba8-4079-ad90-2cbc6c8cb0c0,geogpt-lxz-sft-magpie-llama3-pro-2ep-72b,1719906838,1719907322,finished,1719906881,1719907322,A100-SXM4-80GB,8,16,64,448,43,441
6b56016e-2862-487d-bc32-bf2e00a32b9d,slimorca-geo-mtm1-geotable-nt-14b,1719907119,1720057073,finished,1719907141,1720057073,A100-SXM4-80GB,8,1,64,448,22,149932
3ee51916-a9d3-4bde-b850-8513ec780dcf,llama-factory-long,1719907135,1719908418,finished,1719907202,1719908418,A100-SXM4-80GB,8,2,64,448,67,1216
10161f2f-a603-4d84-a379-0b64912004aa,slimorca-geo-mtm1-funcfil2-14b,1719907186,1720057073,finished,1719907208,1720057073,A100-SXM4-80GB,8,1,64,448,22,149865
53ea3bbf-414d-42a5-88cd-67762359ca61,easycontext-zj-8b,1719907223,1719907409,finished,1719907246,1719907409,A100-SXM4-80GB,8,1,64,896,23,163
b5c14580-e145-45ee-a483-3dea0c4e265c,easycontext-zj-8b-cg,1719907269,1719907462,finished,1719907292,1719907462,A100-SXM4-80GB,8,1,64,896,23,170
6f033016-c8f7-42cf-a091-c0912f9f1fd6,citysora-modelv4plus-256,1719907363,1719907964,finished,1719907435,1719907964,A100-SXM4-80GB,8,8,64,896,72,529
5c3af4a6-baaf-4558-bc14-33837861cdbf,geogpt-lxz-sft-magpie-llama3-pro-2ep-72b,1719907395,1719907714,finished,1719907442,1719907714,A100-SXM4-80GB,8,16,64,448,47,272
0c80d381-f2e7-4699-870d-26e7f281e9e1,txchen-eval,1719907521,1719916552,finished,1719907545,1719916552,A100-SXM4-80GB,8,1,64,448,24,9007
da6bdd4e-0ed0-44a9-ab5f-82ee870925a3,geogpt-moe-0-5B-tag-1-fire-attn,1719907556,1719941322,finished,1719907601,1719941322,A100-SXM4-80GB,8,2,64,896,45,33721
1662a7d8-be65-4523-bed6-f9622d8f0123,reranker-base,1719907727,1719911463,finished,1719907751,1719911463,A100-SXM4-80GB,8,1,64,896,24,3712
1a6e5d7c-30c5-4d27-b409-f01f8675af2f,geogpt-lxz-sft-magpie-llama3-pro-2ep-72b,1719907788,1719908122,finished,1719907854,1719908122,A100-SXM4-80GB,8,16,64,448,66,268
3b9a73f5-cc67-45ed-bef7-6fd6348de741,geogpt-0612-merge-linear-w55,1719907815,1719927607,finished,1719907838,1719927607,A100-SXM4-80GB,8,1,64,448,23,19769
23a18005-8ce3-42cd-8c46-00e980d8d0c0,citysora-modelv4plus-256,1719907964,1719913192,finished,1719908010,1719913192,A100-SXM4-80GB,8,8,64,896,46,5182
df5a6365-b71c-40a7-a828-930e9b8937c0,geogpt-72b-test-cw,1719907988,1719908235,finished,1719908056,1719908235,A100-SXM4-80GB,8,4,64,896,68,179
932054d3-7823-46c9-9fe4-e896e0b6a356,geogpt-lxz-sft-magpie-llama3-pro-2ep-72b,1719908195,1719908713,finished,1719908261,1719908713,A100-SXM4-80GB,8,16,64,448,66,452
3f25cb07-8e15-453f-933d-c6b290d4cbb8,geogpt-sft-common-mix-new-30w-llama3-8b,1719908269,1719928114,finished,1719908312,1719928114,A100-SXM4-80GB,8,4,64,448,43,19802
69a73ed6-e5eb-4931-b055-ab18617f5243,llama-factory-long,1719908418,1719909487,finished,1719908463,1719909487,A100-SXM4-80GB,8,2,64,448,45,1024
6b173fa2-aa0b-4a6b-af1a-8f73b98dc434,geogpt-sft-common-mix-new-llama3-8b,1719908428,1719971031,finished,1719908494,1719971031,A100-SXM4-80GB,8,4,64,448,66,62537
a4e4fab7-5436-4ef5-ba44-eb9cc95d5327,sfr-embedding-test,1719908508,1720081869,finished,1719908530,1720081869,A100-SXM4-80GB,8,1,64,448,22,173339
ad8612a1-4e1a-4591-b76c-40145050d3b3,geo-cpt-05B-geo-common-hsl,1719908687,1720225796,finished,1719908709,1720225796,A100-SXM4-80GB,8,1,64,896,22,317087
dddda8fd-3a58-40bb-bcf8-0bb1e9d5cec8,geogpt-lxz-sft-magpie-llama3-pro-2ep-72b,1719908785,1719909126,finished,1719908855,1719909126,A100-SXM4-80GB,8,16,64,448,70,271
3d86492b-27d0-4be8-aa11-d9b64fcae9bb,geogpt-moe-0-5B-tag-0-1-fire-attn,1719908826,1719941374,finished,1719908879,1719941374,A100-SXM4-80GB,8,2,64,896,53,32495
2839ac4f-0f05-4026-b968-fe7b07b3262f,geogpt-moe-0-5B-tag-0-fire-attn,1719908850,1719941374,finished,1719908922,1719941374,A100-SXM4-80GB,8,2,64,896,72,32452
4fe0b814-b919-4cff-9f2f-f84f2858eb5f,rag-rank,1719908962,1719919113,finished,1719908984,1719919113,A100-SXM4-80GB,8,1,64,448,22,10129
c9accd45-2188-4b44-9d02-b0650b9e92bb,rag-rank,1719909009,1719910601,finished,1719909031,1719910601,A100-SXM4-80GB,8,1,64,448,22,1570
044508f9-b9b5-4744-bc5e-908a474d152a,q72b-ties-w46-d5075-48f1f-auto,1719909042,1719910868,finished,1719909064,1719910868,A100-SXM4-80GB,8,1,64,448,22,1804
c9d5e7c8-0119-48ae-bb22-d586f53f1407,rag-rank,1719909160,1719910785,finished,1719909187,1719910785,A100-SXM4-80GB,8,1,64,448,27,1598
c6385833-f0a5-4fe9-992c-ff4cdb1aa374,geogpt-lxz-sft-magpie-llama3-pro-2ep-72b,1719909193,1719909541,finished,1719909262,1719909541,A100-SXM4-80GB,8,16,64,448,69,279
4deb8b2c-d937-4300-97fd-ad24bcf870db,q72b-ties-w46-d75100-13b85-auto,1719909314,1719910938,finished,1719909337,1719910938,A100-SXM4-80GB,8,1,64,448,23,1601
d108e9ad-5bfb-4171-ae08-595bcb76fd4b,geogpt-72b-test-cw,1719909331,1719909560,finished,1719909380,1719909560,A100-SXM4-80GB,8,4,64,896,49,180
64d10c0c-9ee5-4b44-961c-2585e5ce46b4,llama-factory-long,1719909487,1719910446,finished,1719909555,1719910446,A100-SXM4-80GB,8,2,64,448,68,891
6f38ce16-7aa1-4bd3-8322-36f9eb5e839f,geogpt-lxz-sft-magpie-llama3-pro-2ep-72b,1719909613,1719909963,finished,1719909681,1719909963,A100-SXM4-80GB,8,16,64,448,68,282
d3fb42e0-be31-423a-8f52-aebca4191495,q72b-ties-w46-d10075-46f32-auto,1719909799,1719911686,finished,1719909821,1719911686,A100-SXM4-80GB,8,1,64,448,22,1865
798445b8-06b8-434e-bc14-072a5db1d6c0,train-0701,1719909835,1719927002,finished,1719909861,1719927002,A100-SXM4-80GB,8,1,64,896,26,17141
667d85a8-a0bb-4e1d-bad4-6ea6ac0b5107,easycontext-zj-8b,1719909909,1719910171,finished,1719909932,1719910171,A100-SXM4-80GB,8,1,64,896,23,239
f69747ec-29bd-4fb0-9e9a-1c4bb84ea309,geogpt-72b-test-cw,1719909914,1719910176,finished,1719909981,1719910176,A100-SXM4-80GB,8,4,64,896,67,195
7c370dd5-1e47-43be-a9c2-8c4fd9244902,geogpt-lxz-sft-magpie-llama3-pro-2ep-72b,1719910035,1719910372,finished,1719910104,1719910372,A100-SXM4-80GB,8,16,64,448,69,268
8f78a898-025a-418a-a5d1-da31c8ace602,easycontext-zj-8b,1719910171,1719911207,finished,1719910195,1719911207,A100-SXM4-80GB,8,1,64,896,24,1012
d9242690-6dba-4a0b-8281-41c1df872fa3,GeoGPT-0412-f4f43-auto,1719910187,1719927607,finished,1719910209,1719927607,A100-SXM4-80GB,8,1,64,448,22,17398
7e0c5bc7-f62a-48c7-83d0-52328f09db08,GeoGPT-0206-2b0b9-auto,1719910234,1719910432,finished,1719910257,1719910432,A100-SXM4-80GB,8,1,64,448,23,175
69080f79-bf08-4d95-8f34-a43f36f80332,GeoGPT-0206-7f042-auto,1719910258,1719927404,finished,1719910281,1719927404,A100-SXM4-80GB,8,1,64,448,23,17123
97f1f0ea-86ba-441b-bae4-d032a9adb42f,megatron-gpt-16nodes,1719910338,1719912847,finished,1719910439,1719912847,A100-SXM4-80GB,8,16,64,448,101,2408
17d7c8c6-99b5-4065-af4e-036aef1febfe,q72b-ties-w46-d100100-49963-auto,1719910458,1719912269,finished,1719910492,1719912269,A100-SXM4-80GB,8,1,64,448,34,1777
b7be8300-0b27-4324-a2e9-2d4f06d73101,geogpt-lxz-sft-magpie-llama3-pro-2ep-72b,1719910458,1719913173,finished,1719912899,1719913173,A100-SXM4-80GB,8,16,64,448,2441,274
1f0d2792-60ad-420d-9768-31c0c5bb6bc7,GeoGPT-1215-2d466-auto,1719910471,1719927380,finished,1719910501,1719927380,A100-SXM4-80GB,8,1,64,448,30,16879
f8e29316-0f97-4683-9cbc-098ea46fc0d4,llama2-mosaic-3epo-077bf-auto,1719910503,1719911764,finished,1719910529,1719911764,A100-SXM4-80GB,8,1,64,448,26,1235
38a194b9-c2d8-4931-a69f-bd13a87becba,geogpt-72b-test-cw,1719910516,1719912805,finished,1719912264,1719912805,A100-SXM4-80GB,8,4,64,896,1748,541
5e09b1bd-8d8a-4c26-a95f-0e8526062f3f,geogpt-dairui-model-merge-exp-1,1719910516,1719910698,finished,1719910583,1719910698,A100-SXM4-80GB,8,1,64,896,67,115
0a5e838d-5db2-4612-a848-5a6049651978,q72b-linear-w55-be0d9-auto,1719910523,1719912292,finished,1719910544,1719912292,A100-SXM4-80GB,8,1,64,448,21,1748
4aad995a-10d4-40f7-a336-69015cdd257e,llama-factory-long,1719910602,1719911703,finished,1719911023,1719911703,A100-SXM4-80GB,8,2,64,448,421,680
1a74c85b-c265-4b05-aa49-33bcbb056f21,test,1719910667,1719997457,finished,1719910691,1719997457,A100-SXM4-80GB,8,1,64,448,24,86766
1d629473-23ab-4b21-931e-d87649dbfd20,mistral-mosaic-baseline-e3b54-auto,1719910803,1719912114,finished,1719910828,1719912114,A100-SXM4-80GB,8,1,64,448,25,1286
704dbd78-0473-49ec-9968-21d7a7d6d2bc,qwen-72b-test,1719911050,1719919519,finished,1719911073,1719919519,A100-SXM4-80GB,8,1,64,448,23,8446
b0d29d14-d39e-4de7-b2bc-0fc610d0fa72,easycontext-zj-8b,1719911207,1719912238,finished,1719911231,1719912238,A100-SXM4-80GB,8,1,64,896,24,1007
b9654fea-5239-4923-9904-e77cf011b51f,rag-rank,1719911231,1719919198,finished,1719911703,1719919198,A100-SXM4-80GB,8,1,64,448,472,7495
7ede35f0-0820-486a-8c94-8d23e419f772,rag-rank,1719911416,1719913334,finished,1719911606,1719913334,A100-SXM4-80GB,8,1,64,448,190,1728
68700e82-c6a4-4286-8cf1-de0f5a21c40e,reranker-base,1719911464,1719969156,finished,1719911488,1719969156,A100-SXM4-80GB,8,1,64,896,24,57668
85bf4021-12eb-4e57-b857-39f8c71cfd3b,geogpt-dairui-model-merge-exp-2,1719911586,1719912033,finished,1719911683,1719912033,A100-SXM4-80GB,8,1,64,896,97,350
38ee12d7-ee91-4c97-95b8-3dd7307e7f16,llama-factory-long,1719911797,1719911983,finished,1719911845,1719911983,A100-SXM4-80GB,8,2,64,448,48,138
5352db0b-805b-4510-8ec9-be2bff15ac63,easycontext-zj-8b-cg,1719911821,1719912490,finished,1719911960,1719912490,A100-SXM4-80GB,8,1,64,896,139,530
794cf502-5deb-4948-8bc2-8ba997f24046,geogpt-dairui-model-merge-exp-2,1719912033,1719912449,finished,1719912055,1719912449,A100-SXM4-80GB,8,1,64,896,22,394
176c367a-a2ef-41d6-afd3-2ae2886e5016,llama-factory-long,1719912099,1719912307,finished,1719912168,1719912307,A100-SXM4-80GB,8,2,64,448,69,139
8e42693b-ea62-4ab7-82fd-2dceba775013,easycontext-zj-8b,1719912353,1719913054,finished,1719912376,1719913053,A100-SXM4-80GB,8,1,64,896,23,677
612fbad2-1b6d-4674-a385-08ff9c567a91,geogpt-dairui-model-merge-exp-2,1719912449,1719914931,finished,1719912472,1719914931,A100-SXM4-80GB,8,1,64,896,23,2459
ca02d774-3e8b-4f90-8c8d-cf9db89ca409,llama-factory-long,1719912600,1719912800,finished,1719912645,1719912800,A100-SXM4-80GB,8,2,64,448,45,155
a346f65b-802a-48a5-9089-2dc1d2235caa,llama-factory-long,1719912893,1719913120,finished,1719912964,1719913120,A100-SXM4-80GB,8,2,64,448,71,156
342be936-f009-462f-8b52-4635d4da6227,easycontext-zj-8b-cg,1719913031,1719913556,finished,1719913054,1719913556,A100-SXM4-80GB,8,1,64,896,23,502
4b81496e-e7cd-435f-9b36-139c6551e037,easycontext-zj-8b,1719913054,1719913802,finished,1719913076,1719913802,A100-SXM4-80GB,8,1,64,896,22,726
c37f8f57-8a0e-41cd-91ab-5bc5d285e6fd,citysora-modelv4plus-256,1719913192,1719913447,finished,1719913262,1719913447,A100-SXM4-80GB,8,8,64,896,70,185
b1511e66-e68d-421c-932c-5c5eddd06e34,geogpt-lxz-sft-magpie-llama3-pro-2ep-72b,1719913245,1719913567,finished,1719913291,1719913567,A100-SXM4-80GB,8,16,64,448,46,276
2e9adfab-9ae4-4394-805d-7c9f9be3f3ba,citysora-modelv4plus-256,1719913515,1719915458,finished,1719913560,1719915458,A100-SXM4-80GB,8,8,64,896,45,1898
6f5e2052-af5d-4aea-a880-8504986ee600,geogpt-lxz-sft-magpie-llama3-pro-2ep-72b,1719913634,1719913956,finished,1719913678,1719913956,A100-SXM4-80GB,8,16,64,448,44,278
1471f5cf-047a-44bf-85ed-e454b4dad10e,easycontext-zj-8b,1719913802,1719915019,finished,1719913823,1719915019,A100-SXM4-80GB,8,1,64,896,21,1196
d160acf1-f19f-43b8-adca-b6ea787f7ba1,geogpt-72b-test-cw,1719913911,1719914594,finished,1719913953,1719914594,A100-SXM4-80GB,8,4,64,896,42,641
95a28502-7979-4657-b699-fbb1ccdcb158,q72b-ties-w46-d7550-b97b8-auto,1719913978,1719974707,finished,1719914004,1719974707,A100-SXM4-80GB,8,1,64,448,26,60703
57eebe6e-4de1-487f-9aa8-8d66a7c27d7b,geogpt-lxz-sft-magpie-llama3-pro-2ep-72b,1719914028,1719914364,finished,1719914091,1719914364,A100-SXM4-80GB,8,16,64,448,63,273
90d54da6-4cfb-4473-b5ed-8c8ef6227285,geogpt-mixtral-test,1719914051,1719969624,finished,1719914117,1719969624,A100-SXM4-80GB,8,16,64,896,66,55507
500463c9-c7ce-4cbd-8ee8-9c53de95e931,geogpt-lxz-sft-magpie-llama3-pro-2ep-72b,1719914430,1719914733,finished,1719914469,1719914733,A100-SXM4-80GB,8,16,64,448,39,264
11817cee-08b2-4f4c-99a1-9fd7e74e2bb4,q72b-ties-w46-d10075-9f6cc-auto,1719914754,1719974708,finished,1719914781,1719974708,A100-SXM4-80GB,8,1,64,448,27,59927
08037ff5-c915-4665-8159-31d7aceec748,geogpt-lxz-sft-magpie-llama3-pro-2ep-72b,1719914801,1719915291,finished,1719914845,1719915291,A100-SXM4-80GB,8,16,64,448,44,446
50ef7d37-97d7-430b-ab3f-2fa39ceb7f2f,q72b-ties-w46-d10050-cc3bc-auto,1719914804,1719974708,finished,1719914825,1719974708,A100-SXM4-80GB,8,1,64,448,21,59883
44da2a79-65de-456f-82b3-192b3d566ef6,geogpt-dairui-model-merge-exp-2,1719914931,1720006909,finished,1719914953,1720006909,A100-SXM4-80GB,8,1,64,896,22,91956
95850090-c409-4d54-b78b-d0eb0a537441,q72b-ties-w46-d50100-6d408-auto,1719914957,1719974709,finished,1719914981,1719974709,A100-SXM4-80GB,8,1,64,448,24,59728
8f4a639b-349c-4773-85bc-6682b60d06db,q72b-linear-w55-957e9-auto,1719914960,1719974710,finished,1719914981,1719974710,A100-SXM4-80GB,8,1,64,448,21,59729
aea41af5-3924-4d0c-aaf0-983ab8a0ee05,q72b-ties-w46-d75100-3ca9e-auto,1719915003,1719974710,finished,1719915025,1719974710,A100-SXM4-80GB,8,1,64,448,22,59685
1cb56c3f-bbbf-48e1-aa60-293149007e91,q72b-ties-w46-d7575-1f382-auto,1719915005,1719974711,finished,1719915025,1719974711,A100-SXM4-80GB,8,1,64,448,20,59686
0660752f-d004-4b60-b212-35d1dd5db278,geogpt-lxz-sft-magpie-llama3-pro-2ep-72b,1719915360,1719915710,finished,1719915435,1719915710,A100-SXM4-80GB,8,16,64,448,75,275
42f476df-b756-4982-8775-343f453114f7,citysora-modelv4plus-512,1719915429,1720020168,finished,1719915482,1720020168,A100-SXM4-80GB,8,5,64,896,53,104686
374958ba-b473-446f-9d29-4d0c6a90eb47,citysora-modelv4plus-256,1719915458,1720060913,finished,1719915505,1720060913,A100-SXM4-80GB,8,8,64,896,47,145408
b2f2ed3c-8457-4cd4-9646-80aa58d4c40e,q72b-ties-w46-d100100-1b403-auto,1719915464,1719974711,finished,1719915487,1719974711,A100-SXM4-80GB,8,1,64,448,23,59224
5a1db148-7c63-4f3b-a35e-d95adf11cd8b,llama-factory-long,1719915658,1719916401,finished,1719915702,1719916401,A100-SXM4-80GB,8,2,64,448,44,699
1875eed5-7e05-4d9e-8811-5e4a3752eac6,geogpt-lxz-sft-magpie-llama3-pro-2ep-72b,1719915781,1719916111,finished,1719915825,1719916111,A100-SXM4-80GB,8,16,64,448,44,286
508b7603-9171-47ce-bbf1-cd23fde94848,geogpt-lxz-sft-magpie-llama3-pro-2ep-72b,1719916181,1719916498,finished,1719916223,1719916498,A100-SXM4-80GB,8,16,64,448,42,275
9ad79297-d095-40ab-b969-f745d9c55eaf,easycontext-zj-8b,1719916268,1719917834,finished,1719916401,1719917834,A100-SXM4-80GB,8,1,64,896,133,1433
f40b9323-9b3b-4224-8ae1-1b24ac115599,llama-factory-long,1719916401,1719917076,finished,1719916512,1719917076,A100-SXM4-80GB,8,2,64,448,111,564
3677ab67-6d7e-461b-b446-9afcfff0fba0,geogpt-lxz-sft-magpie-llama3-pro-2ep-72b,1719916567,1719916901,finished,1719916632,1719916901,A100-SXM4-80GB,8,16,64,448,65,269
b80b5f02-fedc-479c-a723-a1a1b9569dae,formula-iso-002,1719916700,1719923189,finished,1719916722,1719923189,A100-SXM4-40GB,1,1,8,96,22,6467
3c3ef4b3-4a18-4957-a4eb-0bae7707e1df,table-iso-002,1719916744,1720765395,finished,1719916767,1720765395,A100-SXM4-40GB,1,1,16,256,23,848628
9926169d-854a-401a-b64a-a679047ede8c,docxchain-iso-002,1719916744,1719983063,finished,1719916767,1719983063,A100-SXM4-40GB,1,1,8,32,23,66296
10e5f49f-3158-43b7-b433-8a0d2df90bc8,geogpt-lxz-sft-magpie-llama3-pro-2ep-72b,1719916971,1719917278,finished,1719917014,1719917278,A100-SXM4-80GB,8,16,64,448,43,264
224d53bd-1bc5-49ce-8f42-d0654fa522d9,geogpt-lxz-sft-magpie-llama3-pro-2ep-72b,1719917346,1719917676,finished,1719917412,1719917676,A100-SXM4-80GB,8,16,64,448,66,264
b24d0ea1-33d3-41b2-841d-f48f7f725c42,test-xiaodianq,1719917404,1719921887,finished,1719917432,1719921887,A100-SXM4-80GB,8,1,64,896,28,4455
cff71f7c-67ad-4295-b796-f74f92d1d929,geogpt-lxz-sft-magpie-llama3-pro-2ep-72b,1719917746,1719918103,finished,1719917814,1719918103,A100-SXM4-80GB,8,16,64,448,68,289
b4b25b95-eb40-4e4c-8d0e-c335961c7144,easycontext-zj-8b,1719917834,1719918096,finished,1719917856,1719918096,A100-SXM4-80GB,8,1,64,896,22,240
0ed24627-c327-4cfc-aa94-e98da6581506,llama-factory-long,1719917880,1719918554,finished,1719918140,1719918554,A100-SXM4-80GB,8,2,64,448,260,414
2707b9c6-4f29-4b8c-b37f-8492db9a00dd,easycontext-zj-8b,1719918096,1719918737,finished,1719918118,1719918737,A100-SXM4-80GB,8,1,64,896,22,619
bb13d9f9-da43-4e28-83c7-08b87b06a17d,geogpt-lxz-sft-magpie-llama3-pro-2ep-72b,1719918174,1719918855,finished,1719918585,1719918855,A100-SXM4-80GB,8,16,64,448,411,270
733d08d2-c187-4b6c-8598-5a310a921bc4,llama-factory-long,1719918606,1719919470,finished,1719918889,1719919470,A100-SXM4-80GB,8,2,64,448,283,581
1b12b4e6-6170-44d1-b0f1-d827873c2e51,easycontext-zj-8b,1719918738,1719919638,finished,1719918759,1719919638,A100-SXM4-80GB,8,1,64,896,21,879
df437bb2-f16e-4361-a02f-89d4c83ab07f,geogpt-lxz-sft-magpie-llama3-pro-2ep-72b,1719918920,1719919502,finished,1719919228,1719919502,A100-SXM4-80GB,8,16,64,448,308,274
5c4bb6c9-2fa3-43cf-a278-85390e4fe35a,easycontext-zj-8b-cg,1719919068,1719919811,finished,1719919091,1719919811,A100-SXM4-80GB,8,1,64,896,23,720
8331e0b4-c8c4-4b1f-b794-2c7f74aa9af2,llama-factory-long,1719919470,1719920045,finished,1719919539,1719920045,A100-SXM4-80GB,8,2,64,448,69,506
3058ac03-6d98-42f8-88f2-a7689833214d,slimorca-geo-mtm1-fcv2-14b,1719919478,1720059797,finished,1719919500,1720059797,A100-SXM4-80GB,8,1,64,448,22,140297
7ff6b32e-db11-42f9-809d-b5850ccfb186,geogpt-lxz-sft-magpie-llama3-pro-2ep-72b,1719919571,1719919882,finished,1719919617,1719919882,A100-SXM4-80GB,8,16,64,448,46,265
bb14742f-6659-4814-bf11-62c421a0fff9,qwen-72b-test,1719919590,1720006354,finished,1719919612,1720006354,A100-SXM4-80GB,8,1,64,448,22,86742
d447056c-e8b1-460c-94ef-07b6d962a390,geogpt-7b-slp40-25bcpt,1719919712,1719920058,finished,1719919909,1719920058,A100-SXM4-80GB,8,16,64,448,197,149
2f33a676-5aca-486e-9631-a49561b8c2ee,geogpt-ultrafuser-direct-eval,1719919797,1719919882,finished,1719919819,1719919882,A100-SXM4-80GB,8,1,64,448,22,63
8aa05711-52d7-48cc-9668-c76853d1b892,geogpt-lxz-sft-magpie-llama3-pro-2ep-72b,1719919960,1719920343,finished,1719920077,1719920343,A100-SXM4-80GB,8,16,64,448,117,266
e12e4b87-3108-406c-abde-a5ac5902017f,llama-factory-long,1719920046,1719937158,finished,1719920120,1719937158,A100-SXM4-80GB,8,2,64,448,74,17038
e290910d-888a-4eed-a656-dcdbc49ac268,geogpt-ultrafuser-direct-eval,1719920053,1719979163,finished,1719920077,1719979163,A100-SXM4-80GB,8,1,64,448,24,59086
9593659f-3757-4ed2-a686-ef04c2d4cf7d,geogpt-lxz-sft-magpie-llama3-pro-2ep-72b,1719920414,1719920743,finished,1719920477,1719920743,A100-SXM4-80GB,8,16,64,448,63,266
4e482f57-efeb-46be-8f0f-2ed63d465417,geogpt-lxz-sft-magpie-llama3-pro-2ep-72b,1719920814,1719921147,finished,1719920880,1719921147,A100-SXM4-80GB,8,16,64,448,66,267
6c067269-d403-4230-9b0e-26594522b0a9,geogpt-lxz-sft-magpie-llama3-pro-2ep-72b,1719921215,1719921528,finished,1719921259,1719921528,A100-SXM4-80GB,8,16,64,448,44,269
8afb6954-f4a2-4347-9da0-5ccb0e7a2b3d,txchen-cpu-task,1719921535,1719921612,finished,1719921557,1719921612,A100-SXM4-80GB,8,1,64,448,22,55
210d5c84-5aa3-4bfa-951d-e468d4a1cd54,geogpt-lxz-sft-magpie-llama3-pro-2ep-72b,1719921601,1719921920,finished,1719921651,1719921920,A100-SXM4-80GB,8,16,64,448,50,269
105a417d-b216-4ff2-928e-a1712d111ecf,txchen-cpu-task,1719921794,1719922218,finished,1719921816,1719922218,A100-SXM4-80GB,8,1,64,448,22,402
cb094350-8a08-4a7c-a31e-79918619515a,geogpt-lxz-sft-magpie-llama3-pro-2ep-72b,1719921987,1719922341,finished,1719922055,1719922341,A100-SXM4-80GB,8,16,64,448,68,286
e21d3913-f868-4483-9475-d9a591e0202b,geogpt-lxz-sft-magpie-llama3-pro-2ep-72b,1719922412,1719922725,finished,1719922455,1719922725,A100-SXM4-80GB,8,16,64,448,43,270
8a9ddd3a-8f45-473a-8ec5-b0020acec611,geogpt-lxz-sft-magpie-llama3-pro-2ep-72b,1719922795,1719923196,finished,1719922861,1719923196,A100-SXM4-80GB,8,16,64,448,66,335
c72b6c23-391c-4067-a0be-c9b9a67349c0,qwen2-cpt8k-extra,1719923188,1719926166,finished,1719923211,1719926166,A100-SXM4-80GB,8,1,64,448,23,2955
08e89998-75c8-4573-9039-066828b9d1fa,formula-iso-002,1719923189,1719984469,finished,1719923212,1719984469,A100-SXM4-40GB,1,1,8,96,23,61257
6ed95dca-8b60-4116-a595-840f3f8bed64,geogpt-lxz-sft-magpie-llama3-pro-2ep-72b,1719923268,1719923637,finished,1719923334,1719923637,A100-SXM4-80GB,8,16,64,448,66,303
77b6fdd0-3e58-4c4f-9ab1-0672d52be271,data-gen-magpie-3,1719923497,1719923992,finished,1719923661,1719923992,A100-SXM4-80GB,8,1,64,448,164,331
1ad34ab5-3da2-48fe-b757-e26206f2284e,elastic-test,1719923643,1719923770,finished,1719923718,1719923770,A100-SXM4-80GB,8,4,64,448,75,52
95a6c67d-ea60-4b20-844d-68ca5965409a,geogpt-7b-slp40-25bcpt,1719923792,1720095315,finished,1719924750,1720095315,A100-SXM4-80GB,8,16,64,448,958,170565
46b99f27-a412-4428-bde1-63252280a658,elastic-test,1719923815,1719924755,finished,1719923860,1719924755,A100-SXM4-80GB,8,8,64,448,45,895
f1f48295-52ec-433c-a758-c3b004f44ceb,txchen-train-task2,1719923979,1719955207,finished,1719924001,1719955207,A100-SXM4-80GB,8,1,64,448,22,31206
fd274769-2939-4b58-914b-71584958173b,qwen1-5-7b-chat-12461-auto,1719924374,1719926276,finished,1719924397,1719926276,A100-SXM4-80GB,8,1,64,448,23,1879
501a6521-9f13-42a2-afc2-a1a932442434,qwen2-GMC-class-split-mosaic-2c73b-auto,1719924893,1719926280,finished,1719924916,1719926280,A100-SXM4-80GB,8,1,64,448,23,1364
8c6952ff-d282-4946-8bc9-620c04095a3b,llama-factory-long-wosp,1719924946,1719926778,finished,1719924993,1719926778,A100-SXM4-80GB,8,2,64,448,47,1785
4af65e5d-ffb1-43b5-9091-8c273153797f,data-gen-magpie-3,1719926128,1719945477,finished,1719932066,1719945477,A100-SXM4-80GB,8,1,64,448,5938,13411
013380c9-05d8-4018-9b98-a038807de89b,geogpt-lxz-sft-magpie-llama3-pro-2ep-72b,1719926130,1719935146,finished,1719934671,1719935146,A100-SXM4-80GB,8,16,64,448,8541,475
6d86affa-c2fb-4f23-993f-c1ab27778900,geogpt-sft-1-8m-wo-geo-filtered-llama3-8b,1719926134,1720010094,finished,1719941469,1720010094,A100-SXM4-80GB,8,8,64,448,15335,68625
3b85e35b-6f31-4ea7-b6cf-c9fa97a5a66d,qwen2-cpt8k-extra,1719926166,1719977734,finished,1719926190,1719977734,A100-SXM4-80GB,8,1,64,448,24,51544
14350181-52e6-4aad-9568-2251c0ab1eda,qwen2-GMC-noclass-split-mosaic-656bd-auto,1719926232,1719935390,finished,1719926305,1719935390,A100-SXM4-80GB,8,1,64,448,73,9085
5f0f2825-a092-423f-b6d0-a266b1a8e349,elastic-test,1719926253,1719928332,finished,1719927446,1719928332,A100-SXM4-80GB,8,8,64,448,1193,886
da4f7817-b4ad-4caa-9811-5e44a678e7a1,geogpt-0612-merge-w37,1719926302,1720020255,finished,1719941431,1720020255,A100-SXM4-80GB,8,1,64,448,15129,78824
93c37828-4124-4855-942c-938435f9264f,qwen2-GMC-class-split-mosaic-2c73b-auto,1719926372,1719935597,finished,1719926396,1719935597,A100-SXM4-80GB,8,1,64,448,24,9201
7e8de20f-0313-4406-9fe5-ab9246aa48b7,qwen1-5-7b-chat-12461-auto,1719926391,1719943568,finished,1719932075,1719943568,A100-SXM4-80GB,8,1,64,448,5684,11493
76a2874a-2934-4ee1-bfd0-c351c65159a6,train-0701,1719927002,1719974621,finished,1719927024,1719974621,A100-SXM4-80GB,8,1,64,896,22,47597
4841aa9f-29c3-4474-b45b-a3fcfd58a71b,geogpt-0521-llama3,1719928896,1720019784,finished,1719932079,1720019784,A100-SXM4-80GB,8,1,64,448,3183,87705
9f38d4af-62cc-4e5e-a651-60b362cfef5c,test-xiaodianq,1719929246,1720050485,finished,1719929267,1720050485,A100-SXM4-80GB,8,1,64,896,21,121218
191055cc-fcb3-4ba1-a94e-e79f1f113a55,test-zz,1719929268,1719950781,finished,1719929289,1719950781,A100-SXM4-80GB,8,1,64,896,21,21492
6d2630b8-6c33-499e-b535-0fc609131225,geogpt-dynamic-fewshot-generation-cw-01,1719930585,1719930677,finished,1719930610,1719930677,A100-SXM4-80GB,8,1,64,896,25,67
27b35946-4bf6-49bc-a83c-d2471b144a0e,geogpt-dynamic-fewshot-generation-cw-02,1719930585,1719930677,finished,1719930610,1719930677,A100-SXM4-80GB,8,1,64,896,25,67
1daa3088-2b49-480e-9b42-b7ebde80fb14,geogpt-dynamic-fewshot-generation-cw-03,1719930611,1719930699,finished,1719930634,1719930699,A100-SXM4-80GB,8,1,64,896,23,65
ead3c5ff-bd3e-4207-ae9f-39ca67a838da,geogpt-dynamic-fewshot-generation-cw-04,1719930612,1719930699,finished,1719930634,1719930699,A100-SXM4-80GB,8,1,64,896,22,65
29a8e2e2-92d3-4d24-931b-8176f912ddcc,elastic-test,1719930792,1719941404,finished,1719935223,1719941404,A100-SXM4-80GB,8,16,64,448,4431,6181
b3247ca5-0ec9-43c4-a3a9-e4e891c2d237,geogpt-dynamic-fewshot-generation-cw-01,1719930872,1719931413,finished,1719930894,1719931413,A100-SXM4-80GB,8,1,64,896,22,519
b1275fe9-3d63-4220-93fa-f2084fd19a59,GeoGPT-Llama3-0628,1719931933,1720019179,finished,1719932075,1720019179,A100-SXM4-80GB,8,1,64,448,142,87104
415923de-c895-4092-9963-a9b98ef6ac66,geogpt-dynamic-fewshot-generation-cw-01,1719931992,1719961535,finished,1719932015,1719961535,A100-SXM4-80GB,8,1,64,896,23,29520
32e09ef2-3cb7-42ab-a0be-658021e0edee,geogpt-dynamic-fewshot-generation-cw-02,1719932060,1719954077,finished,1719932090,1719954077,A100-SXM4-80GB,8,1,64,896,30,21987
7c70c177-89b4-412e-b057-c98f7cf5312c,q72b-0701dpo-v1-linear-w37-a4c0c-auto,1719932072,1719943995,finished,1719934627,1719943995,A100-SXM4-80GB,8,1,64,448,2555,9368
c9850b05-9716-4cff-a987-298a4783e436,geogpt-dynamic-fewshot-generation-cw-03,1719932090,1719948511,finished,1719932116,1719948511,A100-SXM4-80GB,8,1,64,896,26,16395
4cf1f35d-728b-4342-bea5-6afee463b737,geogpt-dynamic-fewshot-generation-cw-04,1719932091,1719943399,finished,1719932116,1719943399,A100-SXM4-80GB,8,1,64,896,25,11283
f526ae7a-56a6-47b1-bf47-8a06097b0016,q72b-0701dpo-v1-linear-w37-b4f13-auto,1719932098,1719942296,finished,1719941424,1719942296,A100-SXM4-80GB,8,1,64,448,9326,872
1b2f1414-a9f7-4a32-8a27-64c75b90aa95,q72b-0701dpo-v1-linear-w46-b1f56-auto,1719932144,1719935498,finished,1719934627,1719935498,A100-SXM4-80GB,8,1,64,448,2483,871
a9283628-791e-4aac-8eae-9d27940251e3,q72b-0701dpo-v1-linear-w46-1a290-auto,1719932147,1719945702,finished,1719935522,1719945702,A100-SXM4-80GB,8,1,64,448,3375,10180
2de130f3-bae2-4f1a-bb89-4018d5893039,q72b-0701dpo-v1-linear-w55-9f942-auto,1719932149,1719935498,finished,1719934627,1719935498,A100-SXM4-80GB,8,1,64,448,2478,871
9ff33476-6270-41b3-b6b5-9923ec8157d3,q72b-0701dpo-v1-linear-w73-17153-auto,1719932151,1719948958,finished,1719935522,1719948958,A100-SXM4-80GB,8,1,64,448,3371,13436
23172767-958a-40c2-b671-14aed76be74a,q72b-0701dpo-v1-linear-w64-081ba-auto,1719932153,1719935499,finished,1719934627,1719935499,A100-SXM4-80GB,8,1,64,448,2474,872
f7d37414-3f53-47c5-91fd-65fb07cfd70f,q72b-0701dpo-v1-linear-w73-dd34d-auto,1719932155,1719942297,finished,1719941424,1719942297,A100-SXM4-80GB,8,1,64,448,9269,873
e82b16c3-2798-4999-a082-da77adaf6d5a,q72b-0701dpo-v1-linear-w64-b471a-auto,1719932181,1719954081,finished,1719941424,1719954081,A100-SXM4-80GB,8,1,64,448,9243,12657
a67564b6-dc29-4537-9c0e-2ed20bae0dff,q72b-0701dpo-v1-linear-w55-154ad-auto,1719932182,1719947102,finished,1719935522,1719947102,A100-SXM4-80GB,8,1,64,448,3340,11580
389541c8-5cc1-4e47-aacc-79354dd98030,geogpt-lxz-sft-magpie-llama3-pro-2ep-72b,1719935216,1719969549,finished,1719969112,1719969549,A100-SXM4-80GB,8,16,64,448,33896,437
07968b34-7d51-4b36-b5c2-81cd39c90705,geogpt-0612-merge-linear-w37,1719938015,1720020256,finished,1719941431,1720020256,A100-SXM4-80GB,8,1,64,448,3416,78825
1767f9de-a96a-4039-89e4-1ff33ff226dd,geo-72B-test,1719940612,1719942199,finished,1719941368,1719942199,A100-SXM4-80GB,8,16,64,896,756,831
e37deeca-4aab-4342-b1f7-f46daafcefac,geo-72B-test,1719946576,1719947321,finished,1719946643,1719947321,A100-SXM4-80GB,8,16,64,896,67,678
3c1d394a-71a8-4809-a861-e2524f4778fa,geogpt-0612-merge-linear-w55,1719962672,1720136102,finished,1719962696,1720136102,A100-SXM4-80GB,8,1,64,448,24,173406
7cb4ea11-f097-44fd-a3d1-0c28c61bdba6,geogpt-72b-0412,1719962762,1720020333,finished,1719962786,1720020333,A100-SXM4-80GB,8,1,64,448,24,57547
451ae81d-c2bd-41db-9d34-e170e6f86634,geogpt-llama3-70b-0521,1719962829,1720506557,finished,1719962851,1720506557,A100-SXM4-40GB,8,1,32,320,22,543706
a92903f8-9982-4e0c-a47b-b1fe663fa39a,geogpt-72b-0206,1719963619,1720020305,finished,1719963644,1720020305,A100-SXM4-80GB,8,1,64,448,25,56661
ffbb9037-9262-4f47-b3ba-a83452c7ef9a,geogpt-72b-1215,1719963644,1720020333,finished,1719963668,1720020333,A100-SXM4-80GB,8,1,64,448,24,56665
0eca9a7a-1fea-412d-97fe-b2169e63db1c,geogpt-0612,1719964743,1720020305,finished,1719964767,1720020305,A100-SXM4-80GB,8,1,64,448,24,55538
14276f8d-f513-40e1-8aa9-384de1d9f517,elastic-test-2,1719968717,1719972499,finished,1719968787,1719972499,A100-SXM4-80GB,8,16,64,448,70,3712
7fba826c-b118-4963-b435-a620457f7011,reranker-base,1719969157,1719969293,finished,1719969180,1719969293,A100-SXM4-80GB,8,1,64,896,23,113
c5c6e504-1361-4a78-ae20-ff1316d47548,reranker2-inference,1719969429,1719989512,finished,1719969543,1719989512,A100-SXM4-80GB,8,1,64,448,114,19969
254e524d-68b3-45c9-a698-7faa74850e0e,reranker-base,1719969431,1719991799,finished,1719969453,1719991799,A100-SXM4-80GB,8,1,64,896,22,22346
dd7da490-a731-4749-a318-d9d7d5afd395,geogpt-lxz-sft-magpie-llama3-pro-2ep-72b,1719969624,1719969949,finished,1719969668,1719969949,A100-SXM4-80GB,8,16,64,448,44,281
e4719a36-fd5e-4942-84a7-0421d67ecb83,llama-factory-long-wosp,1719969965,1719970185,finished,1719970018,1719970185,A100-SXM4-80GB,8,2,64,448,53,167
930bbbfc-f52f-403e-b6d3-5d72a68e81bb,llama-factory-long,1719969989,1719970207,finished,1719970065,1719970207,A100-SXM4-80GB,8,2,64,448,76,142
e97902c1-04cf-47c8-9c6c-539619a6620e,geogpt-lxz-sft-magpie-llama3-pro-2ep-72b,1719970027,1719970357,finished,1719970073,1719970357,A100-SXM4-80GB,8,16,64,448,46,284
5f3c8781-7757-4928-af29-0cd3e195f878,reranker-inference11,1719970042,1719974212,finished,1719970065,1719974212,A100-SXM4-80GB,8,1,64,448,23,4147
336bb376-8d51-4620-9c13-43878fe4dc0d,llama-factory-long-wosp,1719970324,1719971933,finished,1719970371,1719971933,A100-SXM4-80GB,8,2,64,448,47,1562
b766b439-b425-4afe-9266-c1c62d0324c2,llama-factory-long,1719970348,1719971117,finished,1719970395,1719971117,A100-SXM4-80GB,8,2,64,448,47,722
83aaca95-2718-415d-aea7-49c6b20dfe90,geogpt-lxz-sft-magpie-llama3-pro-2ep-72b,1719970433,1719970806,finished,1719970498,1719970806,A100-SXM4-80GB,8,16,64,448,65,308
d193ea62-8e64-4298-a9fa-6397cf2d905a,megatron-gpt-16nodes,1719970725,1719972757,finished,1719970842,1719972757,A100-SXM4-80GB,8,16,64,448,117,1915
a0e6fe0b-3fe7-44f5-b792-ccd1ac7724a4,slimorca-geo-mtm1-mt-ultra-14b,1719970757,1720057463,finished,1719970781,1720057463,A100-SXM4-80GB,8,1,64,448,24,86682
b737cceb-5006-410c-9b7a-50b425d834e0,geogpt-lxz-sft-magpie-llama3-pro-2ep-72b,1719970890,1719972272,finished,1719971988,1719972272,A100-SXM4-80GB,8,16,64,448,1098,284
98051326-ba12-440a-aa6a-780ae7555239,debug,1719971022,1719971143,finished,1719971071,1719971143,A100-SXM4-80GB,8,2,64,896,49,72
d1f0ae36-cfd6-4359-97c3-95515b0ca2e0,llama-factory-long,1719971117,1719971956,finished,1719971165,1719971956,A100-SXM4-80GB,8,2,64,448,48,791
ec23bcc4-7fa0-41b1-88a0-2ad6a9fb079a,debug,1719971236,1719973114,finished,1719971262,1719973114,A100-SXM4-80GB,8,1,64,896,26,1852
47498e5a-5fc6-4c9b-9c62-63b8053b2301,sfr-embedding,1719971283,1719975683,finished,1719971306,1719975683,A100-SXM4-80GB,8,1,64,448,23,4377
1f72dbdb-4ea1-408c-8b90-fd673693b411,slimorca-mtm1-func-14b,1719971473,1720058363,finished,1719971497,1720058363,A100-SXM4-80GB,8,1,64,448,24,86866
012e316c-e5f3-43be-8f04-2dac29668e76,geogpt-qwen2-72bb-lp84-s2-gate,1719971756,1720100812,finished,1719972492,1720100812,A100-SXM4-80GB,8,20,64,448,736,128320
46e89a4a-1afb-491a-b3ef-25ecd76ca596,geogpt-sft-tuluv2-llama3-8b,1719972019,1720001197,finished,1719972295,1720001197,A100-SXM4-80GB,8,4,64,448,276,28902
6d552182-e466-46d8-8851-bfa3c3ce933a,elastic-test-2,1719972499,1719979018,finished,1719972793,1719979018,A100-SXM4-80GB,8,16,64,448,294,6225
5ae21f0c-bfab-4372-a336-5e2c1d648186,qwen1-5-7b-chat-12461-auto,1719972642,1719973370,finished,1719972667,1719973370,A100-SXM4-80GB,8,1,64,448,25,703
a2cfbbdd-08c5-438a-af07-92568f7c7d3a,GeoGPT-0628-Llama3-f246c-auto,1719972715,1719977876,finished,1719972744,1719977876,A100-SXM4-80GB,8,1,64,448,29,5132
eced42dc-ae8d-4482-b0eb-f68a5658c69f,GeoGPT-0521-Llama3-813af-auto,1719972822,1719977877,finished,1719972846,1719977877,A100-SXM4-80GB,8,1,64,448,24,5031
222fe301-ffc3-4d94-b492-e77b95143089,qwen1-14B,1719973282,1719973454,finished,1719973358,1719973454,A100-SXM4-80GB,8,2,64,896,76,96
6b21b4c5-290a-4413-9c9c-7c2260fe1cc7,geo-base-offline-eval,1719973286,1719985517,finished,1719973312,1719985517,A100-SXM4-80GB,8,1,64,448,26,12205
49f5991d-2e7a-4163-b5cc-293756e6b4b7,ls2,1719973307,1719980619,finished,1719973333,1719980619,A100-SXM4-80GB,8,1,64,896,26,7286
043cdb24-a982-4130-8c4e-d57dd214ba07,qwen1-5-7b-chat-27653-auto,1719973699,1719977877,finished,1719973724,1719977877,A100-SXM4-80GB,8,1,64,448,25,4153
e20e4be6-94e2-49b0-8e48-eee97d93ce28,llama-factory-long-wosp,1719973760,1719974310,finished,1719973810,1719974310,A100-SXM4-80GB,8,2,64,448,50,500
719402a4-e2fd-480d-b42d-e0707428660c,geogept-gate-chat-eval-geo,1719973846,1719976893,finished,1719973870,1719976893,A100-SXM4-80GB,8,1,64,448,24,3023
542d0fa2-baa6-46fd-b05b-aca87b8a90ce,geogpt-gate-chat-eval,1719973893,1720277556,finished,1719973917,1720277556,A100-SXM4-80GB,8,1,64,448,24,303639
3b2c2466-f93b-4804-88ca-aebb4b5c17d1,qwen1-5-7b-chat-c67e2-auto,1719973989,1719976463,finished,1719974297,1719976463,A100-SXM4-80GB,8,1,64,448,308,2166
1ed400ad-b3e2-4400-a069-d14350a92762,reranker-inference,1719974188,1720147216,finished,1719974236,1720147216,A100-SXM4-80GB,8,1,64,448,48,172980
e40f05fd-53e6-4197-b2d8-d9ed4a589c08,reranker-inference11,1719974212,1719991999,finished,1719974309,1719991999,A100-SXM4-80GB,8,1,64,448,97,17690
0057eaa1-9e91-45ba-95a2-c52a8014b8a2,llama-factory-long-wosp,1719974310,1719975803,finished,1719974773,1719975803,A100-SXM4-80GB,8,2,64,448,463,1030
3a22face-5b3c-4bce-af23-9a794f714a0d,qwen1-14B,1719974311,1719974866,finished,1719974774,1719974866,A100-SXM4-80GB,8,2,64,896,463,92
914334ca-2e81-45a6-9d60-cf9946b02dd9,rag-rank,1719974382,1719986611,finished,1719974749,1719986611,A100-SXM4-80GB,8,1,64,448,367,11862
421abc9a-99ef-4f40-87d8-77610dc135f7,train-0703,1719974405,1719975077,finished,1719974647,1719975077,A100-SXM4-80GB,8,1,64,896,242,430
d78c5885-61db-4d7e-9721-8f7e65759fd9,easycontext-zj-8b,1719974597,1719975124,finished,1719974749,1719975124,A100-SXM4-80GB,8,1,64,896,152,375
def79526-f509-4c70-9f3f-dbd6a4ce3f20,geogpt-moe-0-5B-baseline,1719974628,1719974893,finished,1719974870,1719974893,A100-SXM4-80GB,8,2,64,896,242,23
2755aa69-5665-4dd6-8d9e-e0636aa40e8b,qwen1-5-7b-7a8e3-auto,1719974687,1719977850,finished,1719974736,1719977850,A100-SXM4-80GB,8,1,64,448,49,3114
e98f5bf3-e0cc-4a94-b8e4-f5489a120604,geogpt-moe-0-5B-tag-0-fire-attn-lr5e-5,1719974846,1719974943,finished,1719974914,1719974943,A100-SXM4-80GB,8,2,64,896,68,29
66717ed6-c71c-40fc-b859-486dcd510ecc,q72b-0701dpo-v1-linear-w46-2c9e6-auto,1719974919,1719976766,finished,1719974946,1719976765,A100-SXM4-80GB,8,1,64,448,27,1819
1377a112-de0d-4a2f-b70e-d0b01d27d177,q72b-0701dpo-v1-linear-w37-aeceb-auto,1719974920,1719976866,finished,1719974946,1719976866,A100-SXM4-80GB,8,1,64,448,26,1920
30b55550-bb28-426d-9169-7e18674c52bc,q72b-0701dpo-v1-linear-w64-16760-auto,1719974948,1719976890,finished,1719974973,1719976890,A100-SXM4-80GB,8,1,64,448,25,1917
94c0bb13-7344-4c81-85b6-467bf181853b,q72b-0701dpo-v1-linear-w55-45b78-auto,1719974949,1719977823,finished,1719975786,1719977823,A100-SXM4-80GB,8,1,64,448,837,2037
a01959e5-faea-4e25-adae-fa2505554010,q72b-0701dpo-v1-linear-w73-a15f0-auto,1719974952,1719977824,finished,1719975786,1719977824,A100-SXM4-80GB,8,1,64,448,834,2038
38c38bc8-4a55-4864-be95-50b1aaf8bd1b,train-0701,1719975054,1720236491,finished,1719975099,1720236491,A100-SXM4-80GB,8,1,64,896,45,261392
1e926057-119f-4409-bcbf-a315a9a202c2,easycontext-zj-8b,1719975124,1719975660,finished,1719975147,1719975660,A100-SXM4-80GB,8,1,64,896,23,513
13d2697a-6735-4b18-89c7-0a836e8f9ca1,qwen2-72b-instruct-extra-128k-a0477-auto,1719975238,1719977863,finished,1719975682,1719977863,A100-SXM4-80GB,8,1,64,448,444,2181
baf2f088-31e6-43a0-a2f8-8f850fc91b09,geo-05b-combine,1719975295,1720065535,finished,1719976480,1720065535,A100-SXM4-80GB,8,1,64,896,1185,89055
bc038f05-4dac-4ccb-b227-5a13d60a49b8,qwen1-5-7b-lp40-25bgeo-d3b3d-auto,1719975325,1719977827,finished,1719976799,1719977827,A100-SXM4-80GB,8,1,64,448,1474,1028
c2866d84-208c-4771-a03f-bc6a1e28d792,easycontext-zj-8b,1719975660,1719977787,finished,1719976882,1719977787,A100-SXM4-80GB,8,1,64,896,1222,905
7f366fe3-b913-40b0-aa5c-c92cd82d3102,sfr-embedding,1719975683,1719986003,finished,1719975706,1719986003,A100-SXM4-80GB,8,1,64,448,23,10297
45cb3f2b-875b-4c82-addf-322a329028ab,geogpt-mixtral-eval-commonbench,1719975857,1719976390,finished,1719976222,1719976390,A100-SXM4-80GB,8,1,64,896,365,168
5d19e0b1-1161-4cf2-8ff5-048d30a1e71f,geogpt-gate-base-val-common,1719976298,1720154986,finished,1719976393,1720154986,A100-SXM4-80GB,8,1,64,448,95,178593
4a545bee-a095-45a2-b563-ca5cea30ae65,geogpt-moe-0-5B-baseline,1719976815,1719976982,finished,1719976935,1719976982,A100-SXM4-80GB,8,2,64,896,120,47
2f6c9f03-32b6-4841-aa9b-b92a4124c62c,geogpt-mixtral-eval-commonbench,1719976937,1719977169,finished,1719976960,1719977169,A100-SXM4-80GB,8,1,64,896,23,209
6153903a-b086-4c27-b991-c9064933b34f,intent-train-llm-lora-gpt,1719977025,1719978292,finished,1719977049,1719978292,A100-SXM4-80GB,8,1,64,448,24,1243
97cf1f58-0435-4aa3-a615-4a01fd9df496,geogpt-mixtral-eval-commonbench,1719977169,1720194751,finished,1719977192,1720194751,A100-SXM4-80GB,8,1,64,896,23,217559
a2a1e9ee-f4f5-44c8-a289-e6c3cc4b1f9c,qwen2-72b-open-vllm-test,1719977507,1719977738,finished,1719977531,1719977738,A100-SXM4-40GB,8,1,32,320,24,207
af2a7692-1583-47c9-902b-77804ff8d331,megatron-gpt-16nodes,1719977555,1720057979,finished,1719996926,1720057979,A100-SXM4-80GB,8,16,64,448,19371,61053
e63add3f-63b9-4a9c-ae47-1855d5734bc1,llama-factory-long-wosp,1719977561,1719980156,finished,1719977914,1719980156,A100-SXM4-80GB,8,2,64,448,353,2242
f3dafc1e-3568-454d-8f93-a9b6c56cb8f0,geogpt-moe-0-5B-tag-0-fire-attn-lr5e-5,1719977694,1719978206,finished,1719977940,1719978206,A100-SXM4-80GB,8,2,64,896,246,266
954ad328-4356-4914-951b-b8d779d8d36d,geogpt-lxz-sft-magpie-llama3-pro-2ep-72b,1719977704,1720040875,finished,1720040586,1720040875,A100-SXM4-80GB,8,16,64,448,62882,289
e751ee07-a79b-45a6-969c-d82afa34775a,geogept-gate-chat-eval-geo,1719977713,1719981965,finished,1719977747,1719981965,A100-SXM4-80GB,8,1,64,448,34,4218
fb2db26a-afea-4ae8-b850-115351157d5d,qwen2-cpt8k-extra,1719977735,1719984701,finished,1719977787,1719984701,A100-SXM4-80GB,8,1,64,448,52,6914
8a912556-156b-43aa-ae92-231f59d44ba6,qwen2-72b-open-vllm-test,1719977738,1719979085,finished,1719977764,1719979085,A100-SXM4-40GB,8,1,32,320,26,1321
cc6f7f55-d219-4bc0-93e6-0d7f0ca72d72,qwen1-5-7b-lp40-s2regate-m-50e18-auto,1719977800,1720147714,finished,1719977850,1720147714,A100-SXM4-80GB,8,1,64,448,50,169864
848241e1-4497-42f6-be6e-8a4371e2928c,geogpt-moe-0-5B-baseline,1719977844,1720009401,finished,1719977918,1720009401,A100-SXM4-80GB,8,2,64,896,74,31483
d7af2dcc-7d6c-4473-be2f-ebd82829fcc8,txchen-lm-eval2,1719977882,1719985659,finished,1719977906,1719985659,A100-SXM4-80GB,8,1,64,448,24,7753
96ebbe77-9170-4f27-ba44-59b1497bfbbc,qwen1-5-7b-lp40-25bgeo-d3b3d-auto,1719977947,1720147748,finished,1719979018,1720147748,A100-SXM4-80GB,8,1,64,448,1071,168730
186a30a7-b4dd-44f1-a928-51e03e2e578a,q72b-0701dpo-v1-linear-w73-a15f0-auto,1719977967,1719978856,finished,1719978276,1719978856,A100-SXM4-80GB,8,1,64,448,309,580
423aa607-51f9-4f99-9f35-68571b0c5ba0,q72b-0701dpo-v1-linear-w55-45b78-auto,1719977969,1719979446,finished,1719979015,1719979446,A100-SXM4-80GB,8,1,64,448,1046,431
1451e4ce-c60e-42ce-9920-62016d937311,qwen2-72B-accda-auto,1719977996,1720011128,finished,1719978190,1720011128,A100-SXM4-80GB,8,1,64,448,194,32938
f59d9225-d5fb-44e7-85ad-6e819068f882,qwen1-5-7b-7a8e3-auto,1719977997,1720147748,finished,1719979973,1720147748,A100-SXM4-80GB,8,1,64,448,1976,167775
7f5c06d7-4721-450d-ae01-13131634f355,qwen2-72b-instruct-extra-128k-a0477-auto,1719978010,1720077512,finished,1719979029,1720077511,A100-SXM4-80GB,8,1,64,448,1019,98482
9e7e52b9-b22e-42b6-af38-49abd36623c7,GeoGPT-0521-Llama3-813af-auto,1719978025,1719991836,finished,1719979018,1719991836,A100-SXM4-80GB,8,1,64,448,993,12818
65d445aa-60fd-4616-af35-a98e759b3fb9,GeoGPT-0628-Llama3-f246c-auto,1719978027,1719991099,finished,1719979018,1719991099,A100-SXM4-80GB,8,1,64,448,991,12081
07567bfc-8edc-47fb-8a6f-49bbe7eca82d,qwen1-5-7b-chat-27653-auto,1719978028,1719986346,finished,1719978190,1719986346,A100-SXM4-80GB,8,1,64,448,162,8156
590438ef-24a3-4ea7-8398-8ea4a3ca8b6d,data-gen-magpie-2,1719978073,1719999856,finished,1719979013,1719999856,A100-SXM4-80GB,8,1,64,448,940,20843
e3c9ff2a-7883-4cb2-86a8-0a16720b248f,qwen2-72b-lp84-6bgeo-589e9-auto,1719978167,1720147256,finished,1719979901,1720147256,A100-SXM4-80GB,8,1,64,448,1734,167355
a0233c3e-e010-4ca3-ae7c-eecd4b0edba9,q72b-0701dpo-v1-linear-fw46-1f8f5-auto,1719978436,1719979399,finished,1719979063,1719979399,A100-SXM4-80GB,8,1,64,448,627,336
1f09e288-0daa-4f1d-922d-6d291b788e7a,q72b-0701dpo-v1-linear-fw64-96e39-auto,1719978459,1719979755,finished,1719978878,1719979755,A100-SXM4-80GB,8,1,64,448,419,877
b0bd79e5-1b82-425d-bbc1-d31fc6816573,q72b-0701dpo-v1-linear-fw55-ba3a8-auto,1719978462,1719990827,finished,1719979470,1719990827,A100-SXM4-80GB,8,1,64,448,1008,11357
af0caabe-6572-4733-a5bc-70abc5a0418e,q72b-0701dpo-v1-linear-fw37-7919a-auto,1719978463,1719980385,finished,1719979422,1719980385,A100-SXM4-80GB,8,1,64,448,959,963
6edd626c-2e53-46ca-888f-dc94e6e6a67c,q72b-0701dpo-v1-linear-fw73-98656-auto,1719978466,1719979945,finished,1719979015,1719979945,A100-SXM4-80GB,8,1,64,448,549,930
6a95e495-405a-4bc0-97aa-683e83a48b5f,q72b-0701dpo-v1-linear-fw46-101d6-auto,1719978467,1719979945,finished,1719979015,1719979945,A100-SXM4-80GB,8,1,64,448,548,930
db66585a-0057-4d51-a31c-e244402c8920,q72b-0701dpo-v1-linear-fw55-f59d2-auto,1719978470,1719980975,finished,1719979898,1719980975,A100-SXM4-80GB,8,1,64,448,1428,1077
fb67f580-d84c-4929-a374-57fc15a71015,q72b-0701dpo-v1-linear-fw37-9b79c-auto,1719978471,1719989838,finished,1719980410,1719989838,A100-SXM4-80GB,8,1,64,448,1939,9428
eb39711f-b4c7-4652-9949-95b4d0f036a0,q72b-0701dpo-v1-linear-fw73-25d67-auto,1719978518,1719993048,finished,1719979970,1719993048,A100-SXM4-80GB,8,1,64,448,1452,13078
3beb94a2-a5df-4523-b670-01c4c951db73,geogpt-sft-construct-magpie-qwen2-llama3-8b,1719978923,1720035169,finished,1719979064,1720035169,A100-SXM4-80GB,8,8,64,448,141,56105
81e40eb7-8d9f-4eb5-904d-1fbf1d844838,qwen2-72b-open-vllm-test,1719979206,1719979442,finished,1719979229,1719979442,A100-SXM4-40GB,8,1,32,320,23,213
65f1e773-a6f1-4386-9f2a-164e1b94d70f,geogpt-qwen2-chat-0612dpo-linear-w55,1719979468,1720006208,finished,1719979777,1720006208,A100-SXM4-80GB,8,1,64,448,309,26431
f5c59c9b-5a76-40b2-adc5-9399ec1086b0,q72b-0701dpo-v1-linear-fw64-8f2ac-auto,1719979496,1719992821,finished,1719980140,1719992821,A100-SXM4-80GB,8,1,64,448,644,12681
61a088d6-8611-439b-9b2c-a058848c95d8,qwen2-72b-open-vllm-test,1719979562,1719981044,finished,1719979587,1719981044,A100-SXM4-40GB,8,1,32,320,25,1457
357bc2d5-86d8-4c0a-b3d0-8127dec737c4,qwen2-72b-open-vllm-test2,1719980013,1719980573,finished,1719980038,1719980573,A100-SXM4-40GB,8,1,32,320,25,535
788e3a1d-1b7d-4c3b-be62-c54d397ee4a0,q72b-ties-mlp-w2575-67699-auto,1719980094,1719989652,finished,1719980140,1719989652,A100-SXM4-80GB,8,1,64,448,46,9512
c27c327a-e57a-4c58-892b-20b5fd5a8d5b,geogpt-gate-base-geo,1719980339,1719980438,finished,1719980363,1719980438,A100-SXM4-80GB,8,1,64,448,24,75
9064da71-297a-4519-9163-d12e530147b1,geogpt-gate-base-common-2,1719980364,1720158044,finished,1719980413,1720158044,A100-SXM4-80GB,8,1,64,448,49,177631
57d77650-adc0-47f3-9fb3-d19d3132288a,qwen2-72b-open-vllm-test2,1719980574,1720062766,finished,1719980598,1720062766,A100-SXM4-40GB,8,1,32,320,24,82168
8cf2222a-5a38-4b9e-8ceb-030cd7476c12,q72b-ties-mlp-w1000-80810-auto,1719980730,1719997160,finished,1719980755,1719997160,A100-SXM4-80GB,8,1,64,448,25,16405
ec76222c-26ec-4852-add0-50f8d35bb9bc,q72b-ties-mlp-w7525-b24eb-auto,1719981273,1719995204,finished,1719981298,1719995204,A100-SXM4-80GB,8,1,64,448,25,13906
b599603e-8212-4a39-94f6-8d082a163b0c,syh-subspace-eval,1719982622,1720000280,finished,1719982647,1720000280,A100-SXM4-80GB,8,1,64,448,25,17633
ddc6ef3b-ca1a-4a26-aa1c-a9cb32f8090c,tq-embedding-2,1719982877,1720450410,finished,1719982904,1720450410,A100-SXM4-40GB,1,32,8,32,27,467506
c5950fd6-d00e-4717-a59a-6aa5ec59bf98,tq-embedding-3,1719983356,1720450533,finished,1719983383,1720450533,A100-SXM4-40GB,1,32,8,32,27,467150
69a25200-fd4c-4603-a25c-a06162abfbcc,llama-factory-long,1719983797,1719989194,finished,1719985564,1719989194,A100-SXM4-80GB,8,2,64,448,1767,3630
ef476901-e9d6-4872-9f6d-4a6f0a58a6f9,formula-iso-002,1719984469,1720765396,finished,1719984496,1720765396,A100-SXM4-40GB,1,1,8,96,27,780900
8f344494-669f-4653-9d7a-581c6b8918c0,qwen1-14B,1719985539,1719986741,finished,1719986665,1719986741,A100-SXM4-80GB,8,2,64,896,1126,76
16f8d8be-d45e-4eee-ae95-28a35222d8a8,txchen-lm-eval2,1719985659,1719985994,finished,1719985684,1719985994,A100-SXM4-80GB,8,1,64,448,25,310
409df2e8-d7f3-42bb-b78f-cf5b05d03710,rag-rank,1719985921,1719986284,finished,1719986028,1719986284,A100-SXM4-80GB,8,1,64,448,107,256
6bd1058c-8541-4677-af36-b4fc38484571,txchen-lm-eval2,1719985994,1719992210,finished,1719986275,1719992210,A100-SXM4-80GB,8,1,64,448,281,5935
2540f0b8-61b5-4434-91f1-781329ab25be,sfr-embedding,1719986003,1719989725,finished,1719986029,1719989725,A100-SXM4-80GB,8,1,64,448,26,3696
e9429611-030d-4506-9acc-f827dbd3007c,geogpt-gate-base-geo,1719986244,1719986446,finished,1719986371,1719986446,A100-SXM4-80GB,8,1,64,448,127,75
2cbd9aec-ca56-48ae-8faa-8eee089181d3,geogpt-gate-base-geo,1719986701,1720037836,finished,1719986726,1720037836,A100-SXM4-80GB,8,1,64,448,25,51110
c6e78994-e462-4905-a95d-379ab5e3370b,rag-rank,1719986868,1719987145,finished,1719986893,1719987145,A100-SXM4-80GB,8,1,64,448,25,252
deefa3c8-c93e-4168-b2f5-e454834dfc05,mixtral-test-901f3-auto,1719987283,1719987712,finished,1719987308,1719987712,A100-SXM4-80GB,8,1,64,448,25,404
8918824d-76df-4159-b4c2-3b625295315e,geogpt-tableqa-sft-qwen2-72b-0703-datav09,1719987428,1719997054,finished,1719996900,1719997054,A100-SXM4-80GB,8,4,64,896,9472,154
1f48eb8d-ff64-4bc0-9c9f-1a1a2a0fde92,mixtral-test-901f3-auto,1719987762,1719989358,finished,1719987790,1719989358,A100-SXM4-80GB,8,1,64,448,28,1568
30955deb-c824-48f0-8bb1-f730b7de267f,q72b-ties-mlp-w5050-dcc7f-auto,1719987764,1719999394,finished,1719989178,1719999394,A100-SXM4-80GB,8,1,64,448,1414,10216
758f1d42-4a7d-429a-aca0-aeda3e84e7ea,q72b-ties-mlp-w1000-3a405-auto,1719988052,1719991579,finished,1719990213,1719991579,A100-SXM4-80GB,8,1,64,448,2161,1366
d2a0d004-f230-42a3-a025-0171cd07ad50,q72b-ties-mlp-w7525-2e6af-auto,1719988080,1719994770,finished,1719993532,1719994770,A100-SXM4-80GB,8,1,64,448,5452,1238
b0dc2deb-557f-4857-8624-f42fa23089b3,q72b-ties-other-w7525-25e79-auto,1719988081,1719991808,finished,1719990539,1719991808,A100-SXM4-80GB,8,1,64,448,2458,1269
bae37c8d-8424-4440-a9e6-9d8acc94185f,q72b-ties-other-w2575-74045-auto,1719988083,1719993171,finished,1719991958,1719993171,A100-SXM4-80GB,8,1,64,448,3875,1213
f010dd23-2434-4eab-9131-522755974b9e,q72b-ties-self-attn-w2575-a7956-auto,1719988085,1719995614,finished,1719994619,1719995614,A100-SXM4-80GB,8,1,64,448,6534,995
bbd45fde-a1e1-42ba-835d-604cf2b27204,q72b-ties-self-attn-w7525-00a56-auto,1719988088,1719993172,finished,1719992008,1719993172,A100-SXM4-80GB,8,1,64,448,3920,1164
04bc4961-4fcd-4037-896d-542615fc019d,q72b-ties-self-attn-w5050-dccab-auto,1719988090,1719990185,finished,1719989179,1719990185,A100-SXM4-80GB,8,1,64,448,1089,1006
49512d8d-8dda-4ae2-a0ee-0365fd0769c3,q72b-ties-mlp-w2575-9ae9e-auto,1719988118,1719990513,finished,1719989681,1719990513,A100-SXM4-80GB,8,1,64,448,1563,832
4828b6ce-337e-436e-b188-964db17e66d1,q72b-ties-mlp-w5050-8699d-auto,1719988119,1719990485,finished,1719989358,1719990485,A100-SXM4-80GB,8,1,64,448,1239,1127
61277dc4-b832-4fd6-8210-9d37fb19feb9,q72b-ties-self-attn-w1000-ed854-auto,1719988122,1719990830,finished,1719989735,1719990830,A100-SXM4-80GB,8,1,64,448,1613,1095
f40d8377-9303-4af8-bf01-073a1313dabb,ls2,1719988421,1719994919,finished,1719994813,1719994919,A100-SXM4-80GB,8,1,64,896,6392,106
6ef5762c-2c46-447e-b8c3-8716a38be9d6,geogpt-72b-lp84-s2-10b-1-2ep-eval,1719988819,1719989924,finished,1719989843,1719989924,A100-SXM4-80GB,8,1,64,448,1024,81
b322cf7a-1825-48f3-a0cd-aa8889361ca4,geogpt-gate-chat-eval-2,1719989125,1720119161,finished,1719990911,1720119161,A100-SXM4-80GB,8,1,64,448,1786,128250
81cd2c46-efe0-4080-b171-a2bb1b8512bd,geogpt-moe-0-5B-tag-0-fire-attn-lr5e-5,1719989380,1720023437,finished,1719990902,1720023437,A100-SXM4-80GB,8,2,64,896,1522,32535
7521119c-a81a-40f0-b52c-7054aaca3aca,mixtral-test-901f3-auto,1719989470,1719996372,finished,1719989895,1719996372,A100-SXM4-80GB,8,1,64,448,425,6477
377dc9eb-e25e-4df6-8cf0-8b08f0a0ca8c,reranker2-inference,1719989512,1719990819,finished,1719989537,1719990819,A100-SXM4-80GB,8,1,64,448,25,1282
ff1d2572-e6cd-46f1-b771-6fd7f41dcb8d,geogpt-72b-lp84-s2-10b-1-2ep-eval,1719990058,1720151487,finished,1719996117,1720151487,A100-SXM4-80GB,8,1,64,448,6059,155370
64be9be6-d09b-4203-9b44-602c2ce24f81,sfr-embedding,1719990229,1720075282,finished,1719990529,1720075282,A100-SXM4-80GB,8,1,64,448,300,84753
ff99369a-0944-4b71-8932-8f4280f08ad7,geo-qwen0-5-cpt-freezeEmbed,1719990401,1720053741,finished,1719996625,1720053741,A100-SXM4-80GB,8,1,64,896,6224,57116
d27e601b-dd08-4265-baab-131b9f3c0ad7,q72b-ties-other-w1000-bd859-auto,1719990617,1719994594,finished,1719993197,1719994594,A100-SXM4-80GB,8,1,64,448,2580,1397
ee452dba-4485-4f10-9207-b3d1a1a80488,qwen2-72b-chat-2,1719990733,1719992440,finished,1719990762,1719992440,A100-SXM4-40GB,8,5,32,320,29,1678
46a4edc3-6d66-4ef6-8aa7-b3c69d48157f,reranker2-inference,1719990819,1719990979,finished,1719990846,1719990979,A100-SXM4-80GB,8,1,64,448,27,133
b176d593-1d6c-4e0a-a4f3-285c9a9e0f19,q72b-ties-other-w5050-d8d5e-auto,1719990936,1719993173,finished,1719991934,1719993173,A100-SXM4-80GB,8,1,64,448,998,1239
a67d642c-0728-4a96-88a9-d0c95992973f,test-zz,1719991057,1719991996,finished,1719991621,1719991996,A100-SXM4-80GB,8,1,64,896,564,375
08c06838-3006-439a-a22d-b8c067b4ef9a,reranker2-inference,1719991138,1720144696,finished,1719991163,1720144696,A100-SXM4-80GB,8,1,64,448,25,153533
db8a986e-3d51-4392-885f-d73609a5a79c,tq-geo-extractor-cpu,1719991434,1719991484,finished,1719991458,1719991484,A100-SXM4-40GB,1,1,16,256,24,26
07c4a4bb-e99b-4ebb-9fed-cb77682ffb1b,qwen-72b-test,1719991574,1719991879,finished,1719991601,1719991879,A100-SXM4-40GB,1,1,8,32,27,278
99118dea-d7fc-4fcc-aa84-a787339d1801,tq-geo-extractor-cpu,1719991588,1720491043,finished,1719991615,1720491043,A100-SXM4-40GB,1,1,16,256,27,499428
86df1885-d259-45ef-aa87-ba7024463006,geogpt-dairui-model-merge-exp-1,1719991628,1719992222,finished,1719991828,1719992222,A100-SXM4-80GB,8,1,64,896,200,394
911193f2-39f4-4c68-b98b-e3a52f5a1c4b,marker-xiaodian,1719991671,1719991947,finished,1719991873,1719991947,A100-SXM4-80GB,8,1,64,448,202,74
7d62ec67-adf0-47ea-b7c6-5cfde913f1f3,reranker-base,1719991799,1720144719,finished,1719991824,1720144719,A100-SXM4-80GB,8,1,64,896,25,152895
863646db-5677-41bd-940f-87f5ef4a166b,geo-qwen1-5-cpt-freezeEmbed-lr5e-5,1719991855,1720054858,finished,1719992248,1720054858,A100-SXM4-80GB,8,2,64,896,393,62610
f8b641a1-e1e0-4d76-b9bc-a4dbb27a60d6,reranker-inference11,1719991999,1720168178,finished,1719995093,1720168178,A100-SXM4-80GB,8,1,64,448,3094,173085
fe41a06e-56fa-4cf0-bb6c-173c4530cf25,marker-xiaodian,1719992093,1719996128,finished,1719996053,1719996128,A100-SXM4-80GB,8,1,64,448,3960,75
76038ac2-2743-495f-87c1-dcff93fcb30d,txchen-lm-eval2,1719992210,1719993540,finished,1719992261,1719993540,A100-SXM4-80GB,8,1,64,448,51,1279
89bd8a9a-580f-4ce3-a5b9-49298c8d9103,train-0703,1719992343,1719994076,finished,1719993089,1719994076,A100-SXM4-80GB,8,1,64,896,746,987
ade227be-9450-4782-b9bf-c54fc19396dd,geo-table-datav041,1719992478,1719997886,finished,1719993192,1719997886,A100-SXM4-80GB,8,1,64,448,714,4694
d1039981-9475-4993-9753-a425f1b1ca57,qwen1-5-7b-chat-12461-auto,1719992620,1720005964,finished,1719993199,1720005964,A100-SXM4-80GB,8,1,64,448,579,12765
77d17a74-d7fe-4162-b013-58608269dde6,qwen2-72b-chat-2,1719992630,1719993541,finished,1719992657,1719993541,A100-SXM4-40GB,8,5,32,320,27,884
c74935ff-9755-450e-a06e-76f679750b28,qwen-72b-test,1719993358,1720078035,finished,1719993383,1720078035,A100-SXM4-40GB,1,1,8,32,25,84652
f00edc20-b6f0-420e-acea-73df2cdeb768,qwen2-72b-chat-2,1719993641,1719993941,finished,1719993664,1719993941,A100-SXM4-40GB,8,5,32,320,23,277
3169e602-d014-4dff-9e5f-32166f891daa,geogpt-dairui-model-merge-exp-1,1719993828,1719994441,finished,1719994057,1719994441,A100-SXM4-80GB,8,1,64,896,229,384
62857171-a755-45d0-b5d8-6f9e0d1412d5,qwen2-72b-chat-2,1719993995,1719996989,finished,1719994020,1719996989,A100-SXM4-40GB,8,5,32,320,25,2969
2a1ff770-238b-47f4-a845-e4a8435ac618,opencompass-eval-0703,1719994127,1720000093,finished,1719994280,1720000093,A100-SXM4-80GB,8,1,64,896,153,5813
f395c87f-e032-485e-af8d-791a879fe740,train-0703,1719994381,1719995067,finished,1719994684,1719995067,A100-SXM4-80GB,8,1,64,896,303,383
7164710d-ec30-49c9-9e33-5efb1b72f0c5,llama3-8b-pt32k,1719994384,1719997203,finished,1719996933,1719997203,A100-SXM4-80GB,8,4,64,448,2549,270
03080d3c-430f-4c8c-ae27-40335f8bdef9,geogpt-ultrafuser-direct-eval,1719994394,1720057074,finished,1719994420,1720057074,A100-SXM4-80GB,8,1,64,448,26,62654
2242374a-6885-444a-9d71-f07243086ade,easycontext-zj-8b,1719994892,1719995374,finished,1719994944,1719995374,A100-SXM4-80GB,8,1,64,896,52,430
790c332f-0ad7-4eb0-bc99-5669c901614b,train-0703,1719995141,1719995807,finished,1719995248,1719995807,A100-SXM4-80GB,8,1,64,896,107,559
23f5c0b3-b0fc-428a-bfb3-7f9aa421163f,easycontext-zj-8b,1719995374,1719996256,finished,1719995400,1719996256,A100-SXM4-80GB,8,1,64,896,26,856
4096a7be-76c9-4c93-8b4e-a6663d369d17,geogpt-dairui-model-merge-exp-1,1719995405,1719996061,finished,1719995636,1719996061,A100-SXM4-80GB,8,1,64,896,231,425
4aad7d5d-9af7-480d-8bb4-0b10c6ff780d,intent-train-llm-gpt,1719995454,1719996395,finished,1719995810,1719996395,A100-SXM4-80GB,8,1,64,448,356,585
f1b0f46e-91c3-4013-90ac-788e5608aad1,geo-72B-test,1719995534,1719997236,finished,1719996903,1719997236,A100-SXM4-80GB,8,4,64,896,1369,333
2474c8f1-2a89-47f6-a6ae-dd4e3068e0a3,qwen1-14B,1719995734,1719996471,finished,1719996393,1719996471,A100-SXM4-80GB,8,2,64,896,659,78
d2d65ca1-16e4-4855-9848-43bc70e39791,easycontext-zj-8b,1719996256,1719996420,finished,1719996283,1719996420,A100-SXM4-80GB,8,1,64,896,27,137
df6d7a25-c4ff-40e9-87d2-90b570fcc0c2,geogpt-dairui-model-merge-exp-1,1719996288,1719996776,finished,1719996369,1719996776,A100-SXM4-80GB,8,1,64,896,81,407
a888cee3-85fc-4d87-92a2-7488da7dfdbb,llama-multi,1719996395,1719997542,finished,1719996829,1719997542,A100-SXM4-80GB,8,2,64,448,434,713
e38e0f81-368f-4c27-a760-66d282d65b72,intent-train-llm-gpt,1719996395,1719996721,finished,1719996497,1719996721,A100-SXM4-80GB,8,1,64,448,102,224
24f33693-3d2d-4d54-b399-d9400e62e583,easycontext-zj-8b,1719996420,1719996645,finished,1719996470,1719996645,A100-SXM4-80GB,8,1,64,896,50,175
02fef595-5156-47bb-8fe4-55afa81929a0,mixtral-test-901f3-auto,1719996753,1719997110,finished,1719996780,1719997110,A100-SXM4-80GB,8,1,64,448,27,330
b22b2ed9-1928-4d2a-b603-aee40f96dc1a,q72b-ties-mlp-w7525-4188c-auto,1719996810,1719998236,finished,1719996838,1719998236,A100-SXM4-80GB,8,1,64,448,28,1398
6f2a902a-d2bc-4171-9359-5ec7f60c04e4,q72b-ties-other-w1000-ee973-auto,1719996840,1719998291,finished,1719996879,1719998291,A100-SXM4-80GB,8,1,64,448,39,1412
a6c8041c-0fb1-4ce5-9440-3fc9d8f6e19d,q72b-ties-other-w5050-a62cc-auto,1719996842,1719998237,finished,1719996909,1719998237,A100-SXM4-80GB,8,1,64,448,67,1328
49c659d1-1841-4952-9c59-fcd5b8f6a50c,q72b-ties-self-attn-w7525-a9dd3-auto,1719996844,1719997891,finished,1719996879,1719997891,A100-SXM4-80GB,8,1,64,448,35,1012
c2ed3948-7b69-49cc-87d9-11634c686a2c,q72b-ties-other-w2575-fa804-auto,1719996847,1719998153,finished,1719996909,1719998153,A100-SXM4-80GB,8,1,64,448,62,1244
2ac15631-67e7-4403-afd3-d028fce1c3b8,q72b-ties-self-attn-w2575-8fb45-auto,1719996848,1719997837,finished,1719996879,1719997837,A100-SXM4-80GB,8,1,64,448,31,958
cb8679a6-ce8a-4ff6-aab3-cb5b530e1962,geogpt-dairui-model-merge-exp-1,1719996944,1719997491,finished,1719997029,1719997491,A100-SXM4-80GB,8,1,64,896,85,462
6a6b8374-5de0-4aac-b14a-c327a29953cf,train-0703,1719997021,1719998005,finished,1719997048,1719998005,A100-SXM4-80GB,8,1,64,896,27,957
19e2d006-9f70-480f-9d88-6a3c341300d3,qwen2-72b-chat-2,1719997042,1719998273,finished,1719997068,1719998273,A100-SXM4-40GB,8,5,32,320,26,1205
74c045c0-ee5f-4768-ab76-13593d828275,easycontext-zj-8b,1719997126,1719997567,finished,1719997152,1719997567,A100-SXM4-80GB,8,1,64,896,26,415
16f61d23-2a23-44c3-99d9-1c9d90dd79f0,marker-xiaodian,1719997149,1719997304,finished,1719997200,1719997304,A100-SXM4-80GB,8,1,64,448,51,104
4d4444d4-031c-4a2b-9783-a479f328ee9b,intent-train-llm-gpt,1719997232,1719997802,finished,1719997258,1719997802,A100-SXM4-80GB,8,1,64,448,26,544
9083f919-b28b-4715-9f76-d815f5d5cd9d,test-zz,1719997304,1719997406,finished,1719997329,1719997406,A100-SXM4-80GB,8,1,64,896,25,77
ff406ba8-5086-4dc2-aa20-182cebb08b1c,geogpt-tableqa-sft-qwen2-72b-0703-datav09,1719997544,1720039009,finished,1719997626,1720039009,A100-SXM4-80GB,8,4,64,896,82,41383
4fa364e3-8668-4038-9376-3c9985fe0df4,easycontext-zj-8b,1719997567,1719998084,finished,1719997593,1719998084,A100-SXM4-80GB,8,1,64,896,26,491
0b801b62-eb57-46b5-b6c0-483897a0f933,easycontext-zj-8b-cg,1719997826,1719998084,finished,1719997854,1719998084,A100-SXM4-80GB,8,1,64,896,28,230
2a04d16a-bb41-4ab8-9fec-d1c930839251,llama-multi,1719997857,1719998175,finished,1719997934,1719998175,A100-SXM4-80GB,8,2,64,448,77,241
e2c84c07-1a09-40cd-af4a-49bee37dc04e,easycontext-zj-8b,1719998084,1719998280,finished,1719998113,1719998280,A100-SXM4-80GB,8,1,64,896,29,167
4bd8d508-13c0-475e-a90c-9880b0c79a1d,easycontext-zj-8b-cg,1719998085,1719998281,finished,1719998113,1719998281,A100-SXM4-80GB,8,1,64,896,28,168
5c8feb57-2bce-4f9b-b69b-9bcc028b763a,intent-train-llm-gpt,1719998115,1719999263,finished,1719998144,1719999263,A100-SXM4-80GB,8,1,64,448,29,1119
f2ba121a-8777-40ba-b379-ccbcf5652b75,mixtral-test-901f3-auto,1719998155,1719998449,finished,1719998183,1719998449,A100-SXM4-80GB,8,1,64,448,28,266
2e7c24c3-ca83-4285-a6b4-130ec738090c,easycontext-zj-8b,1719998281,1719998490,finished,1719998308,1719998490,A100-SXM4-80GB,8,1,64,896,27,182
310e095b-b964-45fc-b84a-817d63a05c5d,easycontext-zj-8b-cg,1719998281,1719998518,finished,1719998309,1719998518,A100-SXM4-80GB,8,1,64,896,28,209
a27540d3-7815-4b81-80d4-168000a2cba1,llama-multi,1719998336,1719999132,finished,1719998416,1719999132,A100-SXM4-80GB,8,2,64,448,80,716
f0be790a-d1f5-4a35-aaf8-af6ad082d31c,qwen2-72b-chat-2,1719998355,1720765490,finished,1719998380,1720765490,A100-SXM4-40GB,8,5,32,320,25,767110
0445f34d-ed66-40ce-9f26-f3135e843cda,GeoGPT-0630-28802-auto,1719998361,1720021480,finished,1719998386,1720021480,A100-SXM4-80GB,8,1,64,896,25,23094
f7d7abd6-b6ef-4422-90fc-516b6e2542c3,easycontext-zj-8b-cg,1719998518,1720008546,finished,1719998542,1720008546,A100-SXM4-80GB,8,1,64,896,24,10004
27c4bff1-22ed-4b39-ac93-3c0c39fc0bfc,easycontext-zj-8b,1719998542,1720008546,finished,1719998567,1720008546,A100-SXM4-80GB,8,1,64,896,25,9979
1798bda4-fd14-4da9-b742-7d0615ab55a8,test-zz,1719998611,1719998733,finished,1719998634,1719998733,A100-SXM4-80GB,8,1,64,896,23,99
ec88de20-a59a-4e8c-93b6-f86d54ab6c5f,mixtral-test-901f3-auto,1719998719,1719999345,finished,1719998743,1719999345,A100-SXM4-80GB,8,1,64,448,24,602
1bda1694-1a73-44d1-834b-9487babe22d4,marker-xiaodian,1719998855,1719998970,finished,1719998881,1719998970,A100-SXM4-80GB,8,1,64,448,26,89
c540d6cf-2b2f-4bdb-81ad-41f53acb2eba,test-zz,1719998881,1719999000,finished,1719998909,1719999000,A100-SXM4-80GB,8,1,64,896,28,91
1cd6231a-32f2-4632-a5b9-58168601252a,geogpt-dairui-model-merge-exp-1,1719998892,1719999318,finished,1719998923,1719999318,A100-SXM4-80GB,8,1,64,896,31,395
1fb5088e-e3f2-4fb0-bd7f-67f4de0a620b,GeoGPT-0612-88017-auto,1719999002,1720022792,finished,1719999027,1720022792,A100-SXM4-80GB,8,1,64,896,25,23765
e527353b-bbea-4f36-80bf-02658d5730cf,llama3-8b-pt32k,1719999182,1720364406,finished,1719999234,1720364406,A100-SXM4-80GB,8,4,64,448,52,365172
e74fdadb-8ed3-4ec3-9453-ba4f2d164910,llama-multi,1719999185,1720003589,finished,1719999210,1720003589,A100-SXM4-80GB,8,1,64,448,25,4379
f5b97054-6260-4a06-acd4-25028f18370b,test,1719999230,1720014781,finished,1719999256,1720014781,A100-SXM4-80GB,8,1,64,448,26,15525
11e49cb4-6e19-4811-947c-5ee3a734e847,marker-xiaodian,1719999284,1719999383,finished,1719999311,1719999383,A100-SXM4-80GB,8,1,64,448,27,72
685711b7-1d8c-4a78-832c-fb903268ffc3,llama3-8b-base-extra-128k-c3692-auto,1719999287,1720016261,finished,1719999312,1720016261,A100-SXM4-80GB,8,1,64,896,25,16949
48891804-50db-4072-a006-09959d20414b,test-zz,1719999311,1720147616,finished,1719999334,1720147616,A100-SXM4-80GB,8,1,64,896,23,148282
a716e732-469a-4c3d-9359-086164bc5633,geogpt-dairui-model-merge-exp-1,1719999464,1719999976,finished,1719999487,1719999976,A100-SXM4-80GB,8,1,64,896,23,489
a81bea2d-0a5a-4cfa-8ed3-967814a054be,llama3-extra-infer,1719999873,1719999972,finished,1719999898,1719999972,A100-SXM4-80GB,8,1,64,448,25,74
e2a38f8a-506e-478e-891d-ae42cdb16721,geogpt-dairui-model-merge-exp-1,1719999976,1720001458,finished,1720000000,1720001458,A100-SXM4-80GB,8,1,64,896,24,1458
0d88180d-bfc5-4572-a322-5542d0e4d820,llama3-extra-infer,1720000192,1720100173,finished,1720000216,1720100173,A100-SXM4-80GB,8,1,64,448,24,99957
ca809acc-4327-417c-9810-129bf704528b,mixtral-test-901f3-auto,1720000415,1720001031,finished,1720000439,1720001031,A100-SXM4-80GB,8,1,64,448,24,592
52d5ed0e-21a2-47fd-ad83-f4ef1f773964,geogpt-dairui-model-merge-exp-1,1720001694,1720003471,finished,1720001719,1720003471,A100-SXM4-80GB,8,1,64,896,25,1752
420c4f57-5e0c-4230-8e64-7e669b599887,geogpt-moe-0-5B-tag-0-1-freeze-attn,1720001933,1720002176,finished,1720001957,1720002176,A100-SXM4-80GB,8,1,64,896,24,219
38fb0e89-4491-4be6-87d1-ba274b6054c2,geogpt-moe-0-5B-tag-1-freeze-attn,1720001959,1720002202,finished,1720001983,1720002202,A100-SXM4-80GB,8,1,64,896,24,219
82562208-ab8d-46a3-91e5-493277636ee5,train-0703,1720002220,1720002981,finished,1720002244,1720002981,A100-SXM4-80GB,8,1,64,896,24,737
a9c83449-640e-458a-b43d-b9a9590bd03a,geogpt-moe-0-5B-tag-0-1,1720002323,1720002476,finished,1720002349,1720002476,A100-SXM4-80GB,8,1,64,896,26,127
8ae051b7-29e0-41dd-9621-6650abad7063,geogpt-moe-0-5B-tag-1,1720002350,1720002501,finished,1720002374,1720002501,A100-SXM4-80GB,8,1,64,896,24,127
d86924b3-e228-4de1-8cda-3e998da958bc,llama3-instruct-70b,1720002455,1720002676,finished,1720002478,1720002676,A100-SXM4-80GB,8,1,64,448,23,198
ed3cda81-39d8-4d2d-a8d6-298d5148c48d,Qwen2-72B-271ef-auto,1720002512,1720036822,finished,1720002537,1720036822,A100-SXM4-80GB,8,1,64,448,25,34285
f744a229-908a-43a1-a3bb-fcab6a5bdbb4,Llama-3-70B-75944-auto,1720002563,1720035442,finished,1720002587,1720035442,A100-SXM4-80GB,8,1,64,448,24,32855
f62fe972-679b-4c40-a569-ef8422e474b7,llamafactory-sft-8b-32k,1720003928,1720004076,finished,1720004001,1720004076,A100-SXM4-80GB,8,4,64,448,73,75
b15bf1b1-7a84-402a-b7cf-169224ca118e,geogpt-dairui-model-merge-exp-1,1720004253,1720005639,finished,1720004278,1720005639,A100-SXM4-80GB,8,1,64,896,25,1361
5d6cd7a2-3a6c-4fd8-8ba8-1ba50df83fed,llama3-instruct-70b,1720004671,1720005255,finished,1720004696,1720005255,A100-SXM4-80GB,8,1,64,448,25,559
68222ced-c02e-4587-b801-3ac7be5a77ac,train-0703,1720005149,1720005806,finished,1720005174,1720005806,A100-SXM4-80GB,8,1,64,896,25,632
39659b2a-c90b-4472-a88e-80532e5ac06e,geogpt-moe-0-5B-tag-0-1,1720005309,1720060207,finished,1720005335,1720060207,A100-SXM4-80GB,8,1,64,896,26,54872
f66ebe28-4fee-4863-bdb7-8483d2fa648b,geogpt-moe-0-5B-tag-1,1720005310,1720060232,finished,1720005335,1720060232,A100-SXM4-80GB,8,1,64,896,25,54897
8f155a98-3c34-41a9-82a3-6cb5c2592ac4,geogpt-moe-0-5B-tag-1-freeze-attn,1720005362,1720062499,finished,1720005387,1720062499,A100-SXM4-80GB,8,1,64,896,25,57112
63088c0e-0af8-4dd7-baae-fd32848085bd,geogpt-moe-0-5B-tag-0-1-freeze-attn,1720005387,1720005489,finished,1720005413,1720005489,A100-SXM4-80GB,8,1,64,896,26,76
e1f44e57-571c-4e70-8c09-fb2055141f43,llama3-70b-instruct,1720005547,1720179073,finished,1720005573,1720179073,A100-SXM4-80GB,8,1,64,448,26,173500
73f46b5e-ab51-4c3e-bb10-d6ce18abc7f7,geogpt-dairui-model-merge-exp-1,1720005639,1720006668,finished,1720005664,1720006668,A100-SXM4-80GB,8,1,64,896,25,1004
d1cf4ddf-8f4c-4429-8318-732077ff41d8,train-0703,1720006301,1720006977,finished,1720006325,1720006977,A100-SXM4-80GB,8,1,64,896,24,652
62f20283-7bd8-4019-90a9-1abbe3913698,qwen-72b-test,1720006426,1720006859,finished,1720006452,1720006859,A100-SXM4-80GB,8,1,64,448,26,407
4baa2780-81f4-4243-abfb-6e3584b753f4,geogpt-dairui-model-merge-exp-1,1720006668,1720008865,finished,1720006693,1720008865,A100-SXM4-80GB,8,1,64,896,25,2172
1cbc34a3-f0c6-4cbd-b847-33f6104cba7c,slimorca-geo-mtm1-mt-wild-14b,1720006696,1720061805,finished,1720006720,1720061805,A100-SXM4-80GB,8,1,64,448,24,55085
03583fc4-e6f1-48c0-a956-fdbe33c238aa,qwen-72b-test,1720006956,1720007442,finished,1720006981,1720007442,A100-SXM4-80GB,8,1,64,448,25,461
8e15f3aa-15ef-4be9-81e2-b9b8604b32bc,train-0703,1720007217,1720007850,finished,1720007242,1720007850,A100-SXM4-80GB,8,1,64,896,25,608
53c66f50-3a66-4902-85ed-30d3ca8ae85d,qwen-72b-test,1720007514,1720074771,finished,1720007539,1720074771,A100-SXM4-80GB,8,1,64,448,25,67232
c20abc63-c7a6-4532-a717-639d7eeb33b7,qwen1-14B,1720008185,1720008282,finished,1720008210,1720008282,A100-SXM4-80GB,8,1,64,896,25,72
c8ba9a7b-81e4-4bc8-96c1-e7ee63140a89,mixtral-test-2-0e84b-auto,1720008314,1720009568,finished,1720008339,1720009568,A100-SXM4-80GB,8,1,64,448,25,1229
ad1ede76-282a-4a22-907b-92e28f720efd,q15-72b-0421dpo-linear-w37-757ee-auto,1720008464,1720010533,finished,1720008492,1720010533,A100-SXM4-80GB,8,1,64,448,28,2041
772445d6-cc5b-475e-9e76-676eff815677,q15-72b-0421dpo-linear-w73-cc61e-auto,1720008466,1720010479,finished,1720008492,1720010479,A100-SXM4-80GB,8,1,64,448,26,1987
1851fc46-2234-4a33-819c-bbf0311fc2f9,q15-72b-0421dpo-linear-w55-51678-auto,1720008520,1720010533,finished,1720008557,1720010533,A100-SXM4-80GB,8,1,64,448,37,1976
0536af14-0934-4a67-9de8-b1b0bfd1901c,q15-72b-0421dpo-linear-w46-10148-auto,1720008522,1720010562,finished,1720008557,1720010562,A100-SXM4-80GB,8,1,64,448,35,2005
39df84b2-6929-4dfd-baac-04d9b47391e8,q15-72b-0421dpo-linear-w46-1b198-auto,1720008524,1720021014,finished,1720008557,1720021014,A100-SXM4-80GB,8,1,64,448,33,12457
d284f207-9548-4030-8996-a40bc1c87351,q15-72b-0421dpo-linear-w64-7a98e-auto,1720008526,1720010534,finished,1720008557,1720010534,A100-SXM4-80GB,8,1,64,448,31,1977
cb9e928c-b431-4799-a040-6f3594adfcd3,q15-72b-0421dpo-linear-w37-2296b-auto,1720008527,1720020921,finished,1720008557,1720020921,A100-SXM4-80GB,8,1,64,448,30,12364
207fc7b0-d159-4c8a-b52d-444bf7c36629,easycontext-zj-8b,1720008546,1720009366,finished,1720008577,1720009366,A100-SXM4-80GB,8,1,64,896,31,789
29fec3b7-f97f-4330-a3d0-06c339017af4,easycontext-zj-8b-cg,1720008547,1720009366,finished,1720008577,1720009366,A100-SXM4-80GB,8,1,64,896,30,789
4cd7129c-2ef4-4955-bda7-e12fefd54e6d,q15-72b-0421dpo-linear-w73-5ccbb-auto,1720008558,1720021286,finished,1720008585,1720021286,A100-SXM4-80GB,8,1,64,448,27,12701
5fc34648-a1b2-4b05-9113-c25b53f5d6e0,q15-72b-0421dpo-linear-w55-5496b-auto,1720008560,1720021129,finished,1720008585,1720021129,A100-SXM4-80GB,8,1,64,448,25,12544
6dcea5e6-156b-4323-aaa5-7cd3f31c8aa6,geogpt-dairui-model-merge-exp-1,1720008865,1720011046,finished,1720008891,1720011046,A100-SXM4-80GB,8,1,64,896,26,2155
66d3c043-2e7a-4e1a-b3a8-997b36e3ebf5,geoget-llama3-70b-lp84-33bcpt,1720009295,1720009519,finished,1720009436,1720009519,A100-SXM4-80GB,8,2,64,448,141,83
320bb06d-657d-4a95-91f7-97945dd0b387,easycontext-zj-8b,1720009366,1720009588,finished,1720009395,1720009588,A100-SXM4-80GB,8,1,64,896,29,193
5a2fe8a0-9296-4c92-8d1d-a57090c00094,easycontext-zj-8b-cg,1720009367,1720009534,finished,1720009395,1720009534,A100-SXM4-80GB,8,1,64,896,28,139
dff4572e-d2ea-4d88-968e-87f7b705720f,mixtral-test-3-4b988-auto,1720009489,1720046134,finished,1720009516,1720046134,A100-SXM4-80GB,8,1,64,448,27,36618
49007769-2d2a-4450-83e9-e2f4d629e34a,train-0703,1720009669,1720024287,finished,1720009696,1720024287,A100-SXM4-80GB,8,1,64,896,27,14591
d37b5f0f-6da0-4497-ad97-54b373b329c4,geoget-llama3-70b-lp84-33bcpt,1720009683,1720009927,finished,1720009765,1720009927,A100-SXM4-80GB,8,2,64,448,82,162
edb9cc64-0ef1-4bec-88bf-6f0f9858f5f6,geogpt-72b-test-cw,1720009837,1720012851,finished,1720010118,1720012851,A100-SXM4-80GB,8,4,64,896,281,2733
dcae9940-5aa2-4248-9834-5995bd2ced47,qwen1-14B,1720009942,1720010053,finished,1720009970,1720010053,A100-SXM4-80GB,8,1,64,896,28,83
62a5fa1c-00f2-4a99-a074-a25dc6c1980f,geoget-llama3-70b-lp84-33bcpt,1720009983,1720010823,finished,1720010065,1720010823,A100-SXM4-80GB,8,2,64,448,82,758
702b8e29-eaf1-4013-b448-e56529ea3c8a,llamafactory-sft-8b-32k,1720010052,1720011268,finished,1720010141,1720011268,A100-SXM4-80GB,8,4,64,448,89,1127
7595fdd9-9fe7-4e56-b367-f5a7369e2863,syh-subspace-moe-mathmed-router,1720010071,1720012732,finished,1720010103,1720012732,A100-SXM4-80GB,8,1,64,448,32,2629
2f47a75a-6900-4e96-86f9-055d76331573,easycontext-zj-8b,1720010112,1720010553,finished,1720010141,1720010553,A100-SXM4-80GB,8,1,64,896,29,412
5301077a-f66c-4eed-a077-9f9e7219a979,easycontext-zj-8b-cg,1720010112,1720014630,finished,1720010554,1720014630,A100-SXM4-80GB,8,1,64,896,442,4076
617eb055-c543-47c1-a879-ee03536dc460,easycontext-zj-8b,1720010554,1720017124,finished,1720010581,1720017124,A100-SXM4-80GB,8,1,64,896,27,6543
acf25035-57ed-41de-abed-983ca45ae73b,geoget-llama3-70b-lp84-33bcpt,1720010925,1720011433,finished,1720011001,1720011433,A100-SXM4-80GB,8,2,64,448,76,432
ddf77f3b-362c-4633-92aa-e5e30bed8610,llamafactory-sft-8b-32k,1720011474,1720011699,finished,1720011549,1720011699,A100-SXM4-80GB,8,2,64,448,75,150
05f31aed-4370-4801-8c44-166ab96798ce,geogpt-mixtral-test,1720011810,1720075745,finished,1720016295,1720075745,A100-SXM4-80GB,8,16,64,896,4485,59450
e38a5a9f-3098-4633-ab31-e5105a78e84e,llamafactory-sft-8b-32k,1720012437,1720012741,finished,1720012513,1720012741,A100-SXM4-80GB,8,2,64,448,76,228
98013996-b797-4d92-b67c-535d0cd0c602,q15-72b-0421dpo-linear-w64-92438-auto,1720012625,1720024832,finished,1720012650,1720024832,A100-SXM4-80GB,8,1,64,448,25,12182
5e0c05bd-f370-43f4-87bd-4c1a057813af,geogpt-72b-test-cw,1720012851,1720012956,finished,1720012878,1720012956,A100-SXM4-80GB,8,4,64,896,27,78
60cebfcb-9e72-49e8-a72c-6d6cd3c557c7,geogpt-72b-test-cw,1720013085,1720015048,finished,1720013162,1720015048,A100-SXM4-80GB,8,4,64,896,77,1886
5f1a7b2a-1313-4790-8bf2-b3c177fd4372,llamafactory-sft-8b-32k,1720014020,1720014328,finished,1720014099,1720014328,A100-SXM4-80GB,8,2,64,448,79,229
739d98d4-34ab-4ec7-9ae3-cc767f3546bd,geogpt-prompt-tuning-tg-train-all,1720014091,1720020669,finished,1720014116,1720020669,A100-SXM4-80GB,8,1,64,448,25,6553
d4926664-59e9-47f3-a83f-b22aaece6dcb,easycontext-zj-8b-cg,1720014630,1720014785,finished,1720014656,1720014785,A100-SXM4-80GB,8,1,64,896,26,129
7c427ebb-5545-4f29-a98c-df7ba95a4d9d,test,1720014781,1720068425,finished,1720014809,1720068425,A100-SXM4-80GB,8,1,64,448,28,53616
24578df2-9b35-460e-9102-aba298d97ada,geo-72B,1720014791,1720040560,finished,1720035160,1720040560,A100-SXM4-80GB,8,16,64,896,20369,5400
ffc25f84-a086-4f1f-bb6e-9ff7d3e36796,easycontext-zj-8b-cg,1720015835,1720016112,finished,1720015862,1720016112,A100-SXM4-80GB,8,1,64,896,27,250
76c4efc7-3ace-4a8a-acc5-6533a4e8cc1e,easycontext-zj-8b,1720017124,1720017530,finished,1720017149,1720017530,A100-SXM4-80GB,8,1,64,896,25,381
05ef495b-b472-45c9-a615-50a7e724438d,geogpt-sft-1-8m-wo-geo-gbs256-llama3-8b,1720017360,1720101672,finished,1720020468,1720101672,A100-SXM4-80GB,8,8,64,448,3108,81204
2ee058f2-2660-456f-a422-db584fc73116,easycontext-zj-8b,1720017929,1720018060,finished,1720017957,1720018060,A100-SXM4-80GB,8,1,64,896,28,103
0d927142-3c45-409b-bcae-9ecdc34caf74,easycontext-zj-8b,1720018185,1720019043,finished,1720018211,1720019043,A100-SXM4-80GB,8,1,64,896,26,832
333fe1a4-f4d6-48e8-935d-8c587aab213a,easycontext-zj-8b-cg,1720018589,1720019219,finished,1720019043,1720019219,A100-SXM4-80GB,8,1,64,896,454,176
e2573428-50b2-4810-8d7e-cc6b7dcf7619,qwen2-72b-instruct-judge,1720019007,1720021360,finished,1720019032,1720021360,A100-SXM4-40GB,8,1,32,320,25,2328
2b7cc57b-a64b-4860-bc18-3016c6fa5806,llamafactory-sft-8b-32k,1720019249,1720020461,finished,1720020189,1720020461,A100-SXM4-80GB,8,4,64,448,940,272
7bd56fd4-c6df-415e-a918-a8a8e54abefb,easycontext-zj-8b,1720019274,1720024425,finished,1720019299,1720024425,A100-SXM4-80GB,8,1,64,896,25,5126
e4839778-bd4b-4a82-a9e7-ca966242938b,easycontext-zj-8b-cg,1720019274,1720019524,finished,1720019299,1720019524,A100-SXM4-80GB,8,1,64,896,25,225
0d908663-f238-41f0-bb6c-b2cd6ab50a9b,geogpt-0521-llama3,1720019833,1720151446,finished,1720019859,1720151446,A100-SXM4-80GB,8,1,64,448,26,131587
21cddbd1-29ef-43fa-bac5-99166e8625e6,citysora-modelv4plus-512,1720020169,1720020492,finished,1720020322,1720020492,A100-SXM4-80GB,8,5,64,896,153,170
c265b6a3-fa10-4ccc-a27e-26be43eb6848,sql-spider-qy-0703,1720020320,1720020464,finished,1720020348,1720020464,A100-SXM4-80GB,8,1,64,448,28,116
75e52e6d-aa46-4551-9bd3-10f50b93136b,citysora-modelv4plus-512,1720020564,1720753501,finished,1720020634,1720753501,A100-SXM4-80GB,8,5,64,896,70,732867
9e6b646a-daba-4f1f-8dbb-633ba2355dd9,sql-spider-qy-0703,1720020799,1720020941,finished,1720020824,1720020941,A100-SXM4-80GB,8,1,64,448,25,117
cdaa7001-4655-402d-8b51-bf1cf5144774,qwen2-72b-instruct-judge,1720021496,1720151401,finished,1720021519,1720151401,A100-SXM4-40GB,8,1,32,320,23,129882
9631f3c7-6d68-467c-8ded-846b496a5b9d,sql-spider-qy-0703,1720021778,1720022002,finished,1720021800,1720022002,A100-SXM4-80GB,8,1,64,448,22,202
e1308399-df0d-4498-8828-f77bb42c7371,txchen-train-task,1720022328,1720022992,finished,1720022351,1720022992,A100-SXM4-80GB,8,1,64,448,23,641
f4611e1f-0ad6-48e5-a547-b5b86384699c,llamafactory-sft-8b-32k,1720022656,1720023757,finished,1720023478,1720023757,A100-SXM4-80GB,8,8,64,448,822,279
cdbba018-b117-48e9-94a2-87e3cd504e0e,sql-spider-qy-0703,1720022684,1720022889,finished,1720022707,1720022889,A100-SXM4-80GB,8,1,64,448,23,182
3b35dc11-638c-4b79-83c2-357f81651a82,txchen-train-task,1720022993,1720026389,finished,1720023015,1720026389,A100-SXM4-80GB,8,1,64,448,22,3374
c46fe08d-e97b-48c6-b76c-467a1e3b756d,sql-spider-qy-0703,1720023436,1720023877,finished,1720023483,1720023877,A100-SXM4-80GB,8,1,64,448,47,394
704cdcca-deba-4bcb-912b-aad1dc51a841,llamafactory-sft-8b-32k,1720023873,1720024193,finished,1720023941,1720024193,A100-SXM4-80GB,8,8,64,448,68,252
463638b7-228d-4658-9f43-d1316a827cb4,sql-spider-qy-0703,1720024150,1720024361,finished,1720024173,1720024361,A100-SXM4-80GB,8,1,64,448,23,188
b027709a-759d-4c28-a63c-e64e570cf1c6,train-0703,1720024287,1720024891,finished,1720024311,1720024891,A100-SXM4-80GB,8,1,64,448,24,580
77110ee9-bc3b-4a6d-b61f-8a1e65fb7ed7,sql-spider-qy-0703,1720024827,1720024986,finished,1720024850,1720024986,A100-SXM4-80GB,8,1,64,448,23,136
aa3693e7-f177-4555-9dfe-eb8bbc0fc1df,sql-spider-qy-0703,1720025146,1720025283,finished,1720025167,1720025283,A100-SXM4-80GB,8,1,64,448,21,116
25c3d417-a7c2-4be3-9f1b-242024e7078d,geogpt-dairui-model-merge-exp-1,1720025216,1720026516,finished,1720025239,1720026516,A100-SXM4-80GB,8,1,64,896,23,1277
35839543-bbbc-49da-8b4e-eaee2e8573cf,sql-spider-qy-0703,1720025329,1720026584,finished,1720025352,1720026584,A100-SXM4-80GB,8,1,64,448,23,1232
2e2fd40d-12e4-4487-bd00-79145e91439c,train-0703,1720025438,1720200123,finished,1720025462,1720200123,A100-SXM4-80GB,8,1,64,448,24,174661
dd32fa04-fd6c-4799-b989-bfa090cf71c2,geogpt-dairui-model-merge-exp-1,1720026517,1720029305,finished,1720026539,1720029305,A100-SXM4-80GB,8,1,64,896,22,2766
f150a083-08d4-4825-a0b7-13bb6a94710f,sql-spider-qy-0703,1720026584,1720030562,finished,1720026606,1720030562,A100-SXM4-80GB,8,1,64,448,22,3956
bd878ae9-0162-4a71-b69e-a68549fea0cf,geogpt-lxz-sft-magpie-llama3-pro-2ep-72b,1720040947,1720041455,finished,1720041013,1720041455,A100-SXM4-80GB,8,16,64,448,66,442
9c93f61a-3b35-4b6e-a3dd-a4f04a21a143,geogpt-lxz-sft-magpie-llama3-pro-2ep-72b,1720041525,1720041837,finished,1720041568,1720041837,A100-SXM4-80GB,8,16,64,448,43,269
4f5ab78f-2a35-427a-a12d-76076611f878,geogpt-lxz-sft-magpie-llama3-pro-2ep-72b,1720041907,1720042237,finished,1720041972,1720042237,A100-SXM4-80GB,8,16,64,448,65,265
fbb812f5-b2bd-4220-b3be-f0cf1729c2cc,geogpt-lxz-sft-magpie-llama3-pro-2ep-72b,1720042308,1720042641,finished,1720042351,1720042641,A100-SXM4-80GB,8,16,64,448,43,290
f4dc376c-ecd1-495c-936c-70cc6f076ee8,geogpt-lxz-sft-magpie-llama3-pro-2ep-72b,1720042711,1720043065,finished,1720042777,1720043065,A100-SXM4-80GB,8,16,64,448,66,288
57375e97-057e-4775-b289-50c2eb12b363,geogpt-lxz-sft-magpie-llama3-pro-2ep-72b,1720043135,1720043485,finished,1720043200,1720043485,A100-SXM4-80GB,8,16,64,448,65,285
3cf3f399-27d8-4187-bcd6-d95294708923,geogpt-lxz-sft-magpie-llama3-pro-2ep-72b,1720043553,1720043908,finished,1720043620,1720043908,A100-SXM4-80GB,8,16,64,448,67,288
c87dce48-581c-4ba2-a545-491aacf8cc46,geogpt-lxz-sft-magpie-llama3-pro-2ep-72b,1720043977,1720044329,finished,1720044042,1720044329,A100-SXM4-80GB,8,16,64,448,65,287
8c29e809-9afe-4689-a7b0-eabcd0a90f3d,geogpt-lxz-sft-magpie-llama3-pro-2ep-72b,1720044400,1720044730,finished,1720044462,1720044730,A100-SXM4-80GB,8,16,64,448,62,268
9b44066b-0561-4ad9-ad23-af134ab8a0b2,geogpt-lxz-sft-magpie-llama3-pro-2ep-72b,1720044798,1720045128,finished,1720044842,1720045128,A100-SXM4-80GB,8,16,64,448,44,286
7cd43f1e-2a4a-4317-a58d-90c5325ec0b1,geogpt-lxz-sft-magpie-llama3-pro-2ep-72b,1720045197,1720045529,finished,1720045243,1720045529,A100-SXM4-80GB,8,16,64,448,46,286
a6686b22-aa1f-4d98-9c2b-02d46e67ba01,geogpt-lxz-sft-magpie-llama3-pro-2ep-72b,1720045598,1720045929,finished,1720045643,1720045929,A100-SXM4-80GB,8,16,64,448,45,286
1c495ef7-4821-4c2e-85bb-91c16a7a691a,geogpt-lxz-sft-magpie-llama3-pro-2ep-72b,1720045999,1720046329,finished,1720046062,1720046329,A100-SXM4-80GB,8,16,64,448,63,267
a675db91-7d15-4adb-a9e8-e22ee0a51b11,geogpt-lxz-sft-magpie-llama3-pro-2ep-72b,1720046399,1720046708,finished,1720046443,1720046708,A100-SXM4-80GB,8,16,64,448,44,265
9130e821-4ba1-4abf-9cd3-e98fa2cb0532,geogpt-lxz-sft-magpie-llama3-pro-2ep-72b,1720046774,1720047081,finished,1720046818,1720047081,A100-SXM4-80GB,8,16,64,448,44,263
4f77a9e1-10b5-499f-94c9-ecc5a80b5bc6,geogpt-lxz-sft-magpie-llama3-pro-2ep-72b,1720047150,1720047500,finished,1720047216,1720047500,A100-SXM4-80GB,8,16,64,448,66,284
9b7045fe-35bc-4bc8-a8aa-bda13a38cd4d,geogpt-lxz-sft-magpie-llama3-pro-2ep-72b,1720047569,1720047915,finished,1720047633,1720047915,A100-SXM4-80GB,8,16,64,448,64,282
afb373db-07b4-4f25-909b-150e334d9c6f,geogpt-lxz-sft-magpie-llama3-pro-2ep-72b,1720047985,1720048309,finished,1720048026,1720048309,A100-SXM4-80GB,8,16,64,448,41,283
eba5bb48-0f62-4349-8dc4-e5f040498e92,geogpt-lxz-sft-magpie-llama3-pro-2ep-72b,1720048379,1720048704,finished,1720048422,1720048704,A100-SXM4-80GB,8,16,64,448,43,282
73b8ea1f-50e4-49c6-9f8a-d9877027bb81,geogpt-lxz-sft-magpie-llama3-pro-2ep-72b,1720048775,1720049125,finished,1720048839,1720049125,A100-SXM4-80GB,8,16,64,448,64,286
64910a98-5445-4c50-a131-f9c08d813a9b,geogpt-lxz-sft-magpie-llama3-pro-2ep-72b,1720049192,1720049521,finished,1720049237,1720049521,A100-SXM4-80GB,8,16,64,448,45,284
681fc6d6-acdd-43d7-bdf5-c6ad1dff6df2,geogpt-lxz-sft-magpie-llama3-pro-2ep-72b,1720049590,1720049919,finished,1720049632,1720049919,A100-SXM4-80GB,8,16,64,448,42,287
1e3c6600-d8f1-4704-a348-9bc276878bdc,geogpt-lxz-sft-magpie-llama3-pro-2ep-72b,1720049986,1720050310,finished,1720050030,1720050310,A100-SXM4-80GB,8,16,64,448,44,280
0c41e88a-dac4-40e8-b1c8-012bec91c329,geogpt-lxz-sft-magpie-llama3-pro-2ep-72b,1720050379,1720050705,finished,1720050424,1720050705,A100-SXM4-80GB,8,16,64,448,45,281
7e9cc14d-370d-47d0-820c-d8180ee01111,geogpt-lxz-sft-magpie-llama3-pro-2ep-72b,1720050775,1720051124,finished,1720050840,1720051124,A100-SXM4-80GB,8,16,64,448,65,284
172c3d84-c495-4688-9988-da78ff70ff14,geogpt-lxz-sft-magpie-llama3-pro-2ep-72b,1720051193,1720051525,finished,1720051261,1720051525,A100-SXM4-80GB,8,16,64,448,68,264
7241b447-fb49-48b7-bb8c-71bd2c70347d,geogpt-lxz-sft-magpie-llama3-pro-2ep-72b,1720051593,1720051917,finished,1720051657,1720051917,A100-SXM4-80GB,8,16,64,448,64,260
a04f4d4d-52c6-43f4-871b-3b6bc1bf0d43,geogpt-lxz-sft-magpie-llama3-pro-2ep-72b,1720051987,1720052306,finished,1720052031,1720052306,A100-SXM4-80GB,8,16,64,448,44,275
7e687b68-89c9-4ca0-9603-3941d1020f4d,geogpt-lxz-sft-magpie-llama3-pro-2ep-72b,1720052374,1720052699,finished,1720052419,1720052699,A100-SXM4-80GB,8,16,64,448,45,280
3b090f1f-c7b4-4a72-86b6-33ad4fec6c24,geogpt-lxz-sft-magpie-llama3-pro-2ep-72b,1720052768,1720053095,finished,1720052812,1720053095,A100-SXM4-80GB,8,16,64,448,44,283
c1d03cde-30f9-4ed1-b72d-0f3694ac7d8a,geogpt-lxz-sft-magpie-llama3-pro-2ep-72b,1720053165,1720053494,finished,1720053208,1720053494,A100-SXM4-80GB,8,16,64,448,43,286
e7c63b42-7e04-4405-b375-bd9ab32eeaa6,geogpt-lxz-sft-magpie-llama3-pro-2ep-72b,1720053565,1720053913,finished,1720053629,1720053913,A100-SXM4-80GB,8,16,64,448,64,284
3d533511-8db1-4f22-846d-8b5025bfdec1,geogpt-lxz-sft-magpie-llama3-pro-2ep-72b,1720053980,1720054329,finished,1720054045,1720054329,A100-SXM4-80GB,8,16,64,448,65,284
f305f6e9-f5ea-4df3-8262-3b15ca73cb04,geogpt-lxz-sft-magpie-llama3-pro-2ep-72b,1720054396,1720054748,finished,1720054462,1720054748,A100-SXM4-80GB,8,16,64,448,66,286
a400b7a3-fc26-4481-a203-97a863b03500,geogpt-lxz-sft-magpie-llama3-pro-2ep-72b,1720054817,1720055316,finished,1720054861,1720055316,A100-SXM4-80GB,8,16,64,448,44,455
d3752353-310d-4280-b622-b553cb9b0f5c,geo-base-offline-eval,1720055185,1720065634,finished,1720055207,1720065634,A100-SXM4-80GB,8,1,64,448,22,10427
35be967d-6ba3-48a1-ad1c-52f321f62131,geogpt-lxz-sft-magpie-llama3-pro-2ep-72b,1720055386,1720055690,finished,1720055429,1720055690,A100-SXM4-80GB,8,16,64,448,43,261
9635290f-58be-4dfd-a904-98f523581d65,opencompass-eval-0703,1720055399,1720142720,finished,1720055422,1720142720,A100-SXM4-80GB,8,1,64,896,23,87298
5cd20f9c-3095-4205-8b82-5c15063dcb19,geogpt-lxz-sft-magpie-llama3-pro-2ep-72b,1720055758,1720056111,finished,1720055822,1720056111,A100-SXM4-80GB,8,16,64,448,64,289
d708fffb-28a8-450c-8d82-847a1d02b4f2,geogpt-lxz-sft-magpie-llama3-pro-2ep-72b,1720056181,1720056531,finished,1720056255,1720056531,A100-SXM4-80GB,8,16,64,448,74,276
370ba6e5-6477-48e1-b501-2b315de48ad5,sql-spider-qy-0703,1720056200,1720056606,finished,1720056228,1720056606,A100-SXM4-80GB,8,1,64,448,28,378
c0933924-4548-4266-baf0-4cbd165b55bb,geo-72B,1720056230,1720061977,finished,1720056550,1720061977,A100-SXM4-80GB,8,16,64,896,320,5427
26e41b26-d02b-49bb-adc6-321bf091fa22,qwen1-14B,1720056249,1720056390,finished,1720056277,1720056390,A100-SXM4-80GB,8,1,64,896,28,113
bd58e8d5-d541-4fca-b581-d6ed3d36c364,llama-multi,1720056412,1720056604,finished,1720056434,1720056604,A100-SXM4-80GB,8,1,64,448,22,170
b1a571b3-289d-4622-96b9-ab3198f989d9,geoget-llama3-70b-lp84-33bcpt,1720056512,1720057031,finished,1720056591,1720057031,A100-SXM4-80GB,8,2,64,448,79,440
f12f6e32-49df-4221-adf2-a0a219988a7e,sql-spider-qy-0703,1720056606,1720056804,finished,1720056629,1720056804,A100-SXM4-80GB,8,1,64,448,23,175
d2b6081f-c214-42fa-8f85-5dacba0670ce,geogpt-lxz-sft-magpie-llama3-pro-2ep-72b,1720056609,1720058320,finished,1720058031,1720058320,A100-SXM4-80GB,8,16,64,448,1422,289
ca385b25-89e8-4a48-96f8-5c317660aab9,llama-multi,1720056738,1720057286,finished,1720056760,1720057286,A100-SXM4-80GB,8,1,64,448,22,526
77ea0f12-6f6f-4951-8fde-87c1627c5dc7,sql-spider-qy-0703,1720056848,1720057592,finished,1720056869,1720057592,A100-SXM4-80GB,8,1,64,448,21,723
8d3d25e5-6702-4ec4-83a4-6b706d138732,llama3-8b-sft32k,1720056953,1720057197,finished,1720056998,1720057197,A100-SXM4-80GB,8,4,64,448,45,199
2f89c510-4ea9-4b4b-bdf1-30a74085fdc7,zjllm-sci-llama-3-7b,1720057061,1720057734,finished,1720057086,1720057734,A100-SXM4-80GB,8,1,64,448,25,648
5114e340-af11-43bd-bd70-1f47746d17ce,zjllm-sci-llama-3-7b-infer,1720057062,1720057800,finished,1720057086,1720057800,A100-SXM4-80GB,8,1,64,448,24,714
e48855fc-1e80-4d46-8a34-1c3671b31cfe,qwen1-14B,1720057177,1720057264,finished,1720057198,1720057264,A100-SXM4-80GB,8,1,64,896,21,66
daf55d41-b989-4833-ab19-e61395f5e980,llama-multi,1720057328,1720057504,finished,1720057351,1720057504,A100-SXM4-80GB,8,1,64,448,23,153
d00baf1a-a978-45fc-9fb0-f5f4b46b2923,llama3-8b-sft32k,1720057479,1720058612,finished,1720057545,1720058612,A100-SXM4-80GB,8,2,64,448,66,1067
c7e23c49-cfa7-4ad1-80b7-efc9c82f811f,cft-mt-lr1e-5-14b,1720057487,1720059988,finished,1720057509,1720059988,A100-SXM4-80GB,8,1,64,448,22,2479
534e2b9f-b7d6-489b-9886-39a032317e6c,sql-spider-qy-0703,1720057593,1720057895,finished,1720057613,1720057895,A100-SXM4-80GB,8,1,64,448,20,282
08141ad2-511a-45c4-9ebd-5f3481df8972,llama-multi,1720057674,1720057826,finished,1720057696,1720057826,A100-SXM4-80GB,8,1,64,448,22,130
0e090b21-e1f0-4149-b1f9-cb37d6aff472,slimorca-geo-mtm1-geotable-nt-14b,1720057722,1720060149,finished,1720057745,1720060149,A100-SXM4-80GB,8,1,64,448,23,2404
b4c24ac9-6bac-41bc-b552-81d15b951fb6,zjllm-sci-llama-3-7b,1720057734,1720058155,finished,1720057757,1720058155,A100-SXM4-80GB,8,1,64,448,23,398
3ee4fd3e-f30d-4e10-b524-584333b7f93a,zjllm-sci-llama-3-7b-infer,1720057800,1720059765,finished,1720057822,1720059765,A100-SXM4-80GB,8,1,64,448,22,1943
062f44fe-8957-4af3-b59b-9ef2cc20a531,sql-spider-qy-0703,1720057896,1720058119,finished,1720057916,1720058119,A100-SXM4-80GB,8,1,64,448,20,203
059bbf70-8e51-473c-9429-f71baa6b5ae2,megatron-gpt-16nodes,1720057979,1720059161,finished,1720058051,1720059161,A100-SXM4-80GB,8,4,64,448,72,1110
1507bb59-b20d-431c-85c6-d577811c513c,slimorca-geo-mtm1-mt-ultra-14b,1720058230,1720144681,finished,1720058254,1720144681,A100-SXM4-80GB,8,1,64,448,24,86427
bf210a07-f1ae-4da0-a747-3920bdb5e20f,Qwen2-72B-Instruct-128K-2-3607f-auto,1720058239,1720081967,finished,1720058260,1720081967,A100-SXM4-80GB,8,1,64,448,21,23707
baf4b61b-789c-48d8-a390-a5ca4a3ca1c1,llama-multi,1720058293,1720058568,finished,1720058315,1720058568,A100-SXM4-80GB,8,1,64,448,22,253
38670c63-3a5f-4031-abaa-5ef7799145ea,zjllm-sci-llama-3-7b,1720058310,1720059350,finished,1720058333,1720059350,A100-SXM4-80GB,8,1,64,448,23,1017
d3a3197c-eba4-4215-a5df-4d78387822ce,geogpt-lxz-sft-magpie-llama3-pro-2ep-72b,1720058392,1720058731,finished,1720058458,1720058731,A100-SXM4-80GB,8,16,64,448,66,273
f8f35081-1ca1-403f-ae0b-7a15b0c4ce04,llama3-8b-sft32k,1720058612,1720058979,finished,1720058681,1720058979,A100-SXM4-80GB,8,2,64,448,69,298
01444a92-74fc-4825-9f69-a6986621dcf2,geogpt-dairui-model-merge-exp-1,1720058640,1720064416,finished,1720058664,1720064416,A100-SXM4-80GB,8,1,64,896,24,5752
e9a1eaf8-1c1e-433b-88a1-650a8a1ad72c,llama-multi,1720058659,1720059002,finished,1720058683,1720059002,A100-SXM4-80GB,8,1,64,448,24,319
c4aedef6-52a5-4076-a90d-c17b36425730,geogpt-lxz-sft-magpie-llama3-pro-2ep-72b,1720058801,1720059147,finished,1720058867,1720059147,A100-SXM4-80GB,8,16,64,448,66,280
ae976f09-fdf3-4668-a83b-a7a5c4f0983c,geogpt-dairui-model-merge-exp-2,1720058961,1720059099,finished,1720058983,1720059099,A100-SXM4-80GB,8,1,64,896,22,116
a782c1c1-f197-47c7-a997-62310b6bee83,llama3-8b-sft32k,1720059047,1720059330,finished,1720059116,1720059330,A100-SXM4-80GB,8,4,64,448,69,214
55cdf701-8859-45ee-950e-cccd2db3b599,llama-multi,1720059050,1720059308,finished,1720059119,1720059308,A100-SXM4-80GB,8,2,64,448,69,189
9024dab9-0abd-47b4-94f4-69cdf04667b4,geogpt-lxz-sft-magpie-llama3-pro-2ep-72b,1720059217,1720059702,finished,1720059261,1720059702,A100-SXM4-80GB,8,16,64,448,44,441
da936b84-fe77-4529-b71a-ea97fa700996,geogpt-sft-qwen2-72b-datav081-ep1,1720059312,1720074109,finished,1720059334,1720074109,A100-SXM4-80GB,8,1,64,448,22,14775
26c7b640-c27e-4742-a9f4-305afe227468,cft-1-8m-sub-plus-mt-qwen2-72b,1720059448,1720082503,finished,1720059471,1720082503,A100-SXM4-80GB,8,1,64,448,23,23032
2b3a4b3c-1ee1-45cb-841d-fe767ecd0fe6,megatron-gpt-16nodes,1720059462,1720060959,finished,1720059528,1720060959,A100-SXM4-80GB,8,8,64,448,66,1431
9e5a5c7d-a2b6-41da-8b1e-08d315934fbb,zjllm-sci-llama-3-7b,1720059550,1720059979,finished,1720059573,1720059979,A100-SXM4-80GB,8,1,64,448,23,406
35a84b96-65c7-49be-8fec-9dfda1e2992c,slimorca-mtm1-func-14b,1720059560,1720082610,finished,1720059584,1720082610,A100-SXM4-80GB,8,1,64,448,24,23026
d20aed42-7b11-4039-8d0c-4f913f05e4d3,geoget-llama3-70b-lp84-33bcpt,1720059638,1720059830,finished,1720059727,1720059830,A100-SXM4-80GB,8,2,64,448,89,103
2c5b8e0d-763a-4e8e-93e5-4f98aad08376,llama-multi,1720059652,1720062237,finished,1720059719,1720062237,A100-SXM4-80GB,8,2,64,448,67,2518
4ddcda46-340b-420b-9fc5-ec45499074d4,geogpt-lxz-sft-magpie-llama3-pro-2ep-72b,1720059775,1720060100,finished,1720059820,1720060100,A100-SXM4-80GB,8,16,64,448,45,280
6813befb-67b8-46de-9575-186692a7a316,marker-xiaodian,1720059840,1720059933,finished,1720059863,1720059933,A100-SXM4-80GB,8,1,64,448,23,70
14e098de-102b-49ad-8b56-8370d5bd5357,slimorca-geo-mtm1-fcv2-14b,1720059850,1720060432,finished,1720059873,1720060432,A100-SXM4-80GB,8,1,64,448,23,559
5021cdb0-83f1-4fd7-80cd-d67cfa763c42,test-xiaodianq,1720059885,1720664735,finished,1720059906,1720664735,A100-SXM4-80GB,8,1,64,896,21,604829
1c296245-9e99-4b13-a3e0-0c451e13604e,llama3-8b-sft32k,1720059910,1720125674,finished,1720060140,1720125674,A100-SXM4-80GB,8,4,64,448,230,65534
48cb334e-5888-43fc-9b71-f947b8149d06,geogpt-dairui-model-merge-exp-2,1720059941,1720060146,finished,1720059965,1720060146,A100-SXM4-80GB,8,1,64,896,24,181
18c3122c-b2bc-4ef1-bd05-b59ee1fa0a6a,geoget-llama3-70b-lp84-33bcpt,1720059948,1720060722,finished,1720060036,1720060722,A100-SXM4-80GB,8,2,64,448,88,686
9cdab642-e75b-49a9-a945-7fbef5bba87e,cft-mt-lr1e-5-14b,1720060033,1720082557,finished,1720060078,1720082557,A100-SXM4-80GB,8,1,64,448,45,22479
0ee0f808-6deb-43f7-8181-95f2fa11d208,llama3-8b-cpt-32k-058c8-auto,1720060115,1720087503,finished,1720060138,1720087503,A100-SXM4-80GB,8,1,64,896,23,27365
0c85f2ab-1de3-43d3-826c-89405dff52e2,zjllm-sci-llama-3-7b,1720060168,1720061405,finished,1720060198,1720061405,A100-SXM4-80GB,8,1,64,448,30,1207
02ab2e0e-742b-4c80-a87c-30625d90d8d6,llama-actsave,1720060173,1720062961,finished,1720062261,1720062961,A100-SXM4-80GB,8,1,64,448,2088,700
45c015a5-732a-49a4-b358-db14120c37fc,slimorca-geo-mtm1-geotable-nt-14b,1720060182,1720082531,finished,1720060211,1720082531,A100-SXM4-80GB,8,1,64,448,29,22320
624fd136-d267-415a-b43d-2b23fc737f88,geogpt-lxz-sft-magpie-llama3-pro-2ep-72b,1720060183,1720062294,finished,1720062006,1720062294,A100-SXM4-80GB,8,16,64,448,1823,288
220ed372-61fd-44a3-99e5-c98b7922d840,qwen1-5-7b-50bcpt-2ep-986ab-auto,1720060186,1720147714,finished,1720060214,1720147714,A100-SXM4-80GB,8,1,64,448,28,87500
fc01a635-e9a8-4c8a-813f-c235725b9bc8,easycontext-zj-8b,1720060226,1720063949,finished,1720060254,1720063949,A100-SXM4-80GB,8,1,64,896,28,3695
b237a4d7-12ca-4b45-becf-b3dccd0a6697,qwen1-5-7b-50bcpt-2ep-6a25b-auto,1720060238,1720062122,finished,1720060266,1720062122,A100-SXM4-80GB,8,1,64,448,28,1856
0bc3fdb4-8d8d-4423-97b7-1f8d7188bf28,GeoGPT-0612-17627-auto,1720060250,1720077426,finished,1720060277,1720077426,A100-SXM4-80GB,8,1,64,896,27,17149
90272fe5-7f1a-4cbe-98f7-1b63ac41c793,GeoGPT-0630-3c37b-auto,1720060252,1720077426,finished,1720060277,1720077426,A100-SXM4-80GB,8,1,64,896,25,17149
400c1339-f7b2-4056-b264-df95bb69a62d,q15-72b-0421dpo-linear-w46-b5c22-auto,1720060381,1720073467,finished,1720060405,1720073467,A100-SXM4-80GB,8,1,64,448,24,13062
bea599f6-1108-4c96-9b28-5a61cbb6b4c4,q15-72b-0421dpo-linear-w55-62955-auto,1720060383,1720073640,finished,1720060405,1720073640,A100-SXM4-80GB,8,1,64,448,22,13235
51f683bc-42ab-43e8-9842-9813e81ac5a2,q15-72b-0421dpo-linear-w64-0a109-auto,1720060406,1720073591,finished,1720060433,1720073591,A100-SXM4-80GB,8,1,64,448,27,13158
976badf8-7b8b-4fe9-aec3-8e42fb9ca10b,q15-72b-0421dpo-linear-w73-4b169-auto,1720060408,1720073664,finished,1720060433,1720073664,A100-SXM4-80GB,8,1,64,448,25,13231
f290c035-84a0-46ab-bec5-11c4df449df1,q15-72b-0421dpo-linear-w37-89c7b-auto,1720060410,1720073922,finished,1720060433,1720073922,A100-SXM4-80GB,8,1,64,448,23,13489
fe724c52-6f05-4ff9-b732-7a3b1071e757,geogpt-prompt-tuning-tg-infer1,1720060440,1720061154,finished,1720060465,1720061154,A100-SXM4-80GB,8,1,64,448,25,689
9eed96c2-1656-4780-9d15-a1cf0d5aad18,slimorca-geo-mtm1-fcv2-14b,1720060482,1720082585,finished,1720060508,1720082585,A100-SXM4-80GB,8,1,64,448,26,22077
fefd0d70-178d-4c1d-a838-236565b171e5,easycontext-zj-8b-cg,1720060523,1720062187,finished,1720060547,1720062187,A100-SXM4-80GB,8,1,64,896,24,1640
a6cfb274-2cfe-4f3f-bf89-dc6040f26445,mixtral-8x22b-v01-ae591-auto,1720060580,1720107832,finished,1720060719,1720107832,A100-SXM4-80GB,8,1,64,448,139,47113
16b8cfae-bd71-4adc-ad84-d8fa8c5be4dc,citysora-modelv4plus-128,1720060886,1720065362,finished,1720060989,1720065362,A100-SXM4-80GB,8,4,64,896,103,4373
da5429cc-5d85-4dee-be16-b4cb3d9a6ddb,citysora-modelv4plus-256,1720060914,1720065386,finished,1720060987,1720065386,A100-SXM4-80GB,8,4,64,896,73,4399
0a9ac005-c28b-4aff-999d-c2c157e51509,Llama-3-70B-75944-auto,1720061102,1720076974,finished,1720061127,1720076974,A100-SXM4-80GB,8,1,64,448,25,15847
913ad04f-3146-40ab-ba02-0340a2173996,Qwen2-72B-271ef-auto,1720061153,1720077082,finished,1720061178,1720077082,A100-SXM4-80GB,8,1,64,448,25,15904
e4de20a5-24b1-433c-bafb-be2e081641f6,megatron-gpt-16nodes,1720061234,1720066174,finished,1720064250,1720066174,A100-SXM4-80GB,8,16,64,448,3016,1924
6b2c9a33-1c05-4a57-bb4f-322a62aae962,llama-factory-long,1720061383,1720061531,finished,1720061410,1720061531,A100-SXM4-80GB,8,1,64,448,27,121
b6608c87-679c-4963-9942-f4bcca8eeae9,zjllm-sci-llama-3-7b,1720061405,1720069486,finished,1720061432,1720069486,A100-SXM4-80GB,8,1,64,448,27,8054
e1e0a93a-1feb-4087-ad22-b13ac303f7d8,zjllm-sci-llama-3-7b-infer,1720061406,1720061770,finished,1720061432,1720061770,A100-SXM4-80GB,8,1,64,448,26,338
1718ab72-3bba-417a-ac61-fe81bf5a0130,slimorca-geo-mtm1-mt-wild-14b,1720061855,1720077939,finished,1720061880,1720077939,A100-SXM4-80GB,8,1,64,448,25,16059
675f5159-7844-49e6-9c88-2d07cf42dc42,geogpt-dairui-model-merge-exp-2,1720061903,1720178623,finished,1720061927,1720178623,A100-SXM4-80GB,8,1,64,896,24,116696
ba878be5-c3d0-4ed6-a2c2-95ede2495057,zjllm-sci-llama-3-7b-infer,1720062052,1720063053,finished,1720062077,1720063053,A100-SXM4-80GB,8,1,64,448,25,976
e708270f-9ed4-439e-8c83-30f890626532,llama-factory-long,1720062056,1720062593,finished,1720062081,1720062593,A100-SXM4-80GB,8,1,64,448,25,512
3fabf1ab-8294-4964-ad74-4e00bd5b5857,geo-72B,1720062115,1720064231,finished,1720062313,1720064231,A100-SXM4-80GB,8,16,64,896,198,1918
804439d8-0f88-4aa3-9306-137d76cb6263,geogpt-prompt-tuning-tg-infer1,1720062177,1720063474,finished,1720062202,1720063474,A100-SXM4-80GB,8,1,64,448,25,1272
f58be345-0c6e-4c53-99bc-0be0801a900d,geogpt-lxz-sft-magpie-llama3-pro-2ep-72b,1720062378,1720066100,finished,1720065639,1720066100,A100-SXM4-80GB,8,16,64,448,3261,461
1fbe6109-bcf8-4c25-9363-9c630c5da760,llama-factory-long-wosp,1720062395,1720062911,finished,1720062420,1720062911,A100-SXM4-80GB,8,1,64,448,25,491
bdea7952-d4e5-4243-9de6-ab2e34aa22ac,geogpt-prompt-tuning-tg-train-all,1720062608,1720073695,finished,1720063496,1720073695,A100-SXM4-80GB,8,1,64,448,888,10199
2954e768-0593-45e0-bb64-a1c091007569,zjllm-sci-llama-3-7b-infer,1720063102,1720071029,finished,1720063128,1720071029,A100-SXM4-80GB,8,1,64,448,26,7901
ddfe09d0-f81a-4f3a-a7c9-1239a7b803dd,llama-actsave,1720063359,1720067739,finished,1720063385,1720067739,A100-SXM4-80GB,8,1,64,448,26,4354
43562fb9-61b6-4cb6-bf17-db382e320c3f,easycontext-zj-8b,1720063949,1720065328,finished,1720063974,1720065328,A100-SXM4-80GB,8,1,64,896,25,1354
9710113b-4551-4c0a-976a-31318af05837,easycontext-zj-8b-cg,1720063950,1720078696,finished,1720063974,1720078696,A100-SXM4-80GB,8,1,64,896,24,14722
26bd1508-60ad-4324-b85e-00115e7c2fe4,geogpt-moe-0-5B-tag-0-fire-attn-lr1e-4,1720064154,1720066151,finished,1720064231,1720066151,A100-SXM4-80GB,8,2,64,896,77,1920
e4d8479e-7d57-4a88-abda-a5ccbad9d579,llama-factory-long,1720064411,1720064490,finished,1720064438,1720064490,A100-SXM4-80GB,8,1,64,448,27,52
f15485da-5e42-4479-82f8-1254476f152e,Mixtral-8x7B-Instruct-shumo,1720064422,1720065638,finished,1720064447,1720065638,A100-SXM4-80GB,8,1,64,448,25,1191
94175da7-0244-4ba7-99a2-9896ad29f736,llama-factory-long-wosp,1720064490,1720065105,finished,1720064515,1720065105,A100-SXM4-80GB,8,1,64,448,25,590
5fc34557-1cd2-420f-a86b-8c3fa6ff9932,llama-factory-long,1720064590,1720065940,finished,1720064616,1720065940,A100-SXM4-80GB,8,1,64,448,26,1324
f434eb8e-5514-4045-9e9d-69b84ac8792f,easycontext-zj-8b,1720065328,1720078723,finished,1720065355,1720078723,A100-SXM4-80GB,8,1,64,896,27,13368
9e8736d0-3662-4fe7-b8fb-e4f3c4904134,Mixtral-8x7B-Instruct-shumo,1720065695,1720079757,finished,1720065720,1720079757,A100-SXM4-80GB,8,1,64,448,25,14037
1fa3f698-865b-4f0a-9951-540340358395,citysora-modelv4plus-128,1720065815,1720166379,finished,1720066094,1720166379,A100-SXM4-80GB,8,4,64,896,279,100285
993f3ff4-e3a3-4063-91a3-3932f7cf7ccc,citysora-modelv4plus-256,1720065816,1720579492,finished,1720066120,1720579492,A100-SXM4-80GB,8,4,64,896,304,513372
e1dd7a50-fb73-4c96-8278-857bbedff8cf,geo-05b-combine,1720065818,1720409505,finished,1720066068,1720409505,A100-SXM4-80GB,8,1,64,896,250,343437
d8df36f8-795e-4451-a64f-82bfc2cfa08a,llama-factory-long,1720065940,1720067860,finished,1720065965,1720067860,A100-SXM4-80GB,8,1,64,448,25,1895
ecc7b77b-bb68-403b-8646-573edfb00996,llama-factory-long-wosp,1720065940,1720066690,finished,1720066089,1720066690,A100-SXM4-80GB,8,1,64,448,149,601
229619cb-3243-4205-b08f-e364ceaccdd6,geogpt-moe-0-5B-tag-0-fire-attn-lr1e-4,1720066151,1720098575,finished,1720066230,1720098575,A100-SXM4-80GB,8,2,64,896,79,32345
74897cda-5e78-4364-88c0-548d5047ef1b,geogpt-lxz-sft-magpie-llama3-pro-2ep-72b,1720066185,1720066539,finished,1720066257,1720066539,A100-SXM4-80GB,8,16,64,448,72,282
53a4c73b-172e-4710-8070-7e4ec72b275d,opencompass-eval-0704,1720066527,1720068019,finished,1720066553,1720068019,A100-SXM4-80GB,8,1,64,896,26,1466
05ea0570-eb9c-447a-8247-19c6076daeab,geogpt-lxz-sft-magpie-llama3-pro-2ep-72b,1720066619,1720066940,finished,1720066666,1720066940,A100-SXM4-80GB,8,16,64,448,47,274
eac48822-b7bd-4c3f-8abc-ffca8ba3bb15,geogpt-lxz-sft-magpie-llama3-pro-2ep-72b,1720067020,1720067391,finished,1720067090,1720067391,A100-SXM4-80GB,8,16,64,448,70,301
2c56c67c-c1be-4c92-a737-3dbe06f3582e,geogpt-lxz-sft-magpie-llama3-pro-2ep-72b,1720067470,1720067819,finished,1720067543,1720067819,A100-SXM4-80GB,8,16,64,448,73,276
479b54b9-ee3d-45ec-a094-55bce2bd42a1,opencompass-eval-0704,1720067856,1720085838,finished,1720067887,1720085838,A100-SXM4-80GB,8,1,64,896,31,17951
bf15568b-aaad-4f62-87b7-d10a15a356c7,geogpt-lxz-sft-magpie-llama3-pro-2ep-72b,1720067896,1720068252,finished,1720067970,1720068252,A100-SXM4-80GB,8,16,64,448,74,282
602f1fa2-9dc2-424b-84c5-907b828e98af,sfr-ft-4,1720068046,1720075926,finished,1720068072,1720075926,A100-SXM4-80GB,8,1,64,448,26,7854
fa4e4119-bc52-44c9-9b1c-8a4d7bcfcee5,geogpt-lxz-sft-magpie-llama3-pro-2ep-72b,1720068328,1720068654,finished,1720068379,1720068654,A100-SXM4-80GB,8,16,64,448,51,275
bf52aaba-0946-4ece-a9a4-400aa264d193,test,1720068425,1720078745,finished,1720068449,1720078745,A100-SXM4-80GB,8,1,64,448,24,10296
da422fd2-6554-4d07-8aa1-4d770509faaa,geogpt-lxz-sft-magpie-llama3-pro-2ep-72b,1720068729,1720069081,finished,1720068802,1720069081,A100-SXM4-80GB,8,16,64,448,73,279
19c51ca3-0546-4751-a054-4c4c95343b2e,geogpt-lxz-sft-magpie-llama3-pro-2ep-72b,1720069151,1720069474,finished,1720069200,1720069474,A100-SXM4-80GB,8,16,64,448,49,274
4f290cf3-e209-4dd6-ae3a-ce65665a5f36,zjllm-sci-llama-3-7b,1720069486,1720070611,finished,1720069511,1720070611,A100-SXM4-80GB,8,1,64,448,25,1100
c0df93b4-a33b-491f-bf76-d15bd416a736,geogpt-lxz-sft-magpie-llama3-pro-2ep-72b,1720069549,1720069881,finished,1720069602,1720069881,A100-SXM4-80GB,8,16,64,448,53,279
db794e65-274b-4f8c-91c0-18ed4f26bc9f,geogpt-lxz-sft-magpie-llama3-pro-2ep-72b,1720069952,1720070274,finished,1720070001,1720070274,A100-SXM4-80GB,8,16,64,448,49,273
e6d44d81-b31d-46a0-9880-1334a8e8d250,geogpt-lxz-sft-magpie-llama3-pro-2ep-72b,1720070347,1720070669,finished,1720070400,1720070669,A100-SXM4-80GB,8,16,64,448,53,269
238f2b4c-7757-49da-8a12-07234ed7b790,zjllm-sci-llama-3-7b,1720070708,1720243705,finished,1720070738,1720243705,A100-SXM4-80GB,8,1,64,448,30,172967
deb519fd-0dc5-460a-8096-5d513c79321e,geogpt-lxz-sft-magpie-llama3-pro-2ep-72b,1720070747,1720071063,finished,1720070799,1720071063,A100-SXM4-80GB,8,16,64,448,52,264
acae2b2c-cf23-4f18-bc82-bc0af89f2002,q72b-ties-other-w2575-8efe5-auto,1720070858,1720072023,finished,1720070884,1720072023,A100-SXM4-80GB,8,1,64,448,26,1139
e6add174-bb1a-4e0e-b1be-e1c2dc608f9f,q72b-ties-other-w1000-eff3c-auto,1720070861,1720072362,finished,1720070884,1720072362,A100-SXM4-80GB,8,1,64,448,23,1478
d2e64373-bb3b-4653-a243-192230927822,q72b-ties-other-w5050-bb839-auto,1720070886,1720072182,finished,1720070916,1720072182,A100-SXM4-80GB,8,1,64,448,30,1266
aff9839c-1d19-4be7-abb3-c8b21c429975,q72b-ties-mlp-w7525-0a05e-auto,1720070888,1720072285,finished,1720070916,1720072285,A100-SXM4-80GB,8,1,64,448,28,1369
3e6ecfc4-1523-4502-94ee-f1e8e9385d56,q72b-ties-self-attn-w7525-2560a-auto,1720070890,1720071969,finished,1720070916,1720071969,A100-SXM4-80GB,8,1,64,448,26,1053
8ff8a04a-57ce-497f-8530-ad6450e5a2b7,q72b-ties-self-attn-w2575-500f6-auto,1720070892,1720072105,finished,1720070916,1720072105,A100-SXM4-80GB,8,1,64,448,24,1189
e3333867-b165-44ea-8b92-2a47386d9972,zjllm-sci-llama-3-7b-infer,1720071029,1720244049,finished,1720071053,1720244049,A100-SXM4-80GB,8,1,64,448,24,172996
19372b47-3569-489c-a3c6-3a7a9b57e3f2,geogpt-lxz-sft-magpie-llama3-pro-2ep-72b,1720071143,1720071484,finished,1720071194,1720071484,A100-SXM4-80GB,8,16,64,448,51,290
d0aaad60-9c06-499e-80fa-4dd720390a56,opencompass-eval-0704,1720071529,1720072779,finished,1720071559,1720072779,A100-SXM4-80GB,8,1,64,896,30,1220
fb2c7ed6-a396-449f-b712-4676b7153ece,geogpt-lxz-sft-magpie-llama3-pro-2ep-72b,1720071568,1720071913,finished,1720071645,1720071913,A100-SXM4-80GB,8,16,64,448,77,268
6f4df9aa-38d5-45fe-88e1-8ee4ea82ebb7,llama-multi,1720071674,1720073989,finished,1720071960,1720073989,A100-SXM4-80GB,8,2,64,448,286,2029
5c291935-b19c-4b6a-adaf-3a0ecc31a409,geogpt-lxz-sft-magpie-llama3-pro-2ep-72b,1720071998,1720072338,finished,1720072070,1720072338,A100-SXM4-80GB,8,16,64,448,72,268
9f18b8eb-890f-470e-bd85-cf731b8d4135,geo-72B,1720072332,1720077149,finished,1720072382,1720077149,A100-SXM4-80GB,8,16,64,896,50,4767
aebeda6b-8458-4a93-999c-0b9d3ff59ab7,geogpt-lxz-sft-magpie-llama3-pro-2ep-72b,1720072420,1720076073,finished,1720075767,1720076073,A100-SXM4-80GB,8,16,64,448,3347,306
01ef75f8-055f-41bd-837e-e31b6253d806,GeoGPT-Llama3-0628,1720072593,1720159674,finished,1720072620,1720159674,A100-SXM4-80GB,8,1,64,448,27,87054
38c4c8c5-76f9-475b-a9a6-ed670b8ea028,geogpt-sft-construct-data-llama3-8b,1720072762,1720142442,finished,1720072837,1720142442,A100-SXM4-80GB,8,4,64,448,75,69605
65030fe5-e544-427e-90d9-6eccb3866dcf,geogpt-dairui-eval-code,1720072910,1720073056,finished,1720072935,1720073056,A100-SXM4-80GB,8,1,64,896,25,121
acacab62-0842-431a-a1de-1a0ffa4118b9,geogpt-dairui-model-merge-exp-1,1720073081,1720073239,finished,1720073106,1720073239,A100-SXM4-80GB,8,1,64,896,25,133
7785d781-70ef-46be-8fab-7628e3153309,geogpt-dairui-eval-code,1720073239,1720100412,finished,1720073263,1720100412,A100-SXM4-80GB,8,1,64,896,24,27149
b9876605-a17f-436b-9e8f-8698860ad4b2,opencompass-eval-0704,1720073282,1720075072,finished,1720073507,1720075072,A100-SXM4-80GB,8,1,64,896,225,1565
d99c1450-6537-46b0-954d-207899d8359a,llama-multi,1720074060,1720085689,finished,1720074107,1720085689,A100-SXM4-80GB,8,2,64,448,47,11582
8e6f7918-a533-480b-89bc-de56ce7ad2aa,geogpt-sft-qwen2-72b-datav081-ep1,1720074225,1720079122,finished,1720074250,1720079122,A100-SXM4-80GB,8,1,64,448,25,4872
1535d02d-a2fc-4e8a-bb91-03801a7a5b6a,llama-factory-long-wosp,1720074864,1720075491,finished,1720074888,1720075491,A100-SXM4-80GB,8,1,64,448,24,603
80a52812-8754-4973-a1a5-f0d62ebfb11b,llama-factory-long,1720074864,1720076792,finished,1720074888,1720076792,A100-SXM4-80GB,8,1,64,448,24,1904
9c3c308c-e595-46a2-ab70-954275d2e539,qwen-72b-test,1720075006,1720075977,finished,1720075031,1720075977,A100-SXM4-80GB,8,1,64,448,25,946
94b04759-4659-4eee-b3a4-a4b25c38ee18,opencompass-eval-0704,1720075256,1720085562,finished,1720075281,1720085562,A100-SXM4-80GB,8,1,64,896,25,10281
6be4faa1-fa2f-44f6-afc8-356725164712,sfr-embedding,1720075283,1720085314,finished,1720075306,1720085314,A100-SXM4-80GB,8,1,64,448,23,10008
9bd475de-54df-4bac-bfd7-8074603fffa1,qwen1-14B,1720075285,1720075674,finished,1720075331,1720075674,A100-SXM4-80GB,8,2,64,896,46,343
a703a1fe-1952-42cc-8456-9f70732757a0,syh-subspace-eval,1720075436,1720096074,finished,1720075482,1720096074,A100-SXM4-80GB,8,1,64,448,46,20592
5b5b9a88-3eaa-4332-a058-dae59a51f7df,sfr-ft-4,1720075926,1720076679,finished,1720075950,1720076679,A100-SXM4-80GB,8,1,64,448,24,729
ed6d21c4-55d9-45ed-8da1-7542eeb385b4,qwen-72b-test,1720076046,1720076841,finished,1720076070,1720076841,A100-SXM4-80GB,8,1,64,448,24,771
0978c869-9ee3-4b19-a18d-c2efcff2c7bd,geogpt-lxz-sft-magpie-llama3-pro-2ep-72b,1720076146,1720076493,finished,1720076216,1720076493,A100-SXM4-80GB,8,16,64,448,70,277
aa222156-1a88-46b1-8d82-3458936c864b,qwen1-14B,1720076240,1720076399,finished,1720076308,1720076399,A100-SXM4-80GB,8,2,64,896,68,91
ce3281ca-52a5-4c11-a832-60e1a711e98c,geogpt-lxz-sft-magpie-llama3-pro-2ep-72b,1720076567,1720076913,finished,1720076611,1720076913,A100-SXM4-80GB,8,16,64,448,44,302
f704144a-b1ba-4321-bcd4-38da225b9878,qwen-72b-test,1720076910,1720078812,finished,1720076936,1720078812,A100-SXM4-80GB,8,1,64,448,26,1876
88627457-85ef-4974-8f13-cbe38d79d351,sfr-ft-4,1720076932,1720077318,finished,1720076955,1720077318,A100-SXM4-80GB,8,1,64,448,23,363
0c4edd18-af95-48b8-b2a3-eb176f9b75b9,geogpt-lxz-sft-magpie-llama3-pro-2ep-72b,1720076994,1720077326,finished,1720077046,1720077326,A100-SXM4-80GB,8,16,64,448,52,280
53539c49-60b1-4875-9d0e-4dc13867cc2d,llama-factory-long,1720077010,1720077168,finished,1720077035,1720077168,A100-SXM4-80GB,8,1,64,448,25,133
2e9ee890-fad0-405f-9cda-fbbf090b0eb6,llama-factory-long-wosp,1720077011,1720077168,finished,1720077036,1720077168,A100-SXM4-80GB,8,1,64,448,25,132
01427d34-620a-43cf-a222-1e8021699830,qwen1-14B,1720077069,1720077588,finished,1720077123,1720077588,A100-SXM4-80GB,8,2,64,896,54,465
51c30ac3-497c-49ee-91cd-a5070c1114d3,Llama-3-70B-75944-auto,1720077085,1720117030,finished,1720077113,1720117030,A100-SXM4-80GB,8,1,64,448,28,39917
65bf7335-83d1-4995-933d-6cf4de8df9bc,geogpt-sft-qwen2-72b-datav08-ep1,1720077147,1720092760,finished,1720077172,1720092760,A100-SXM4-80GB,8,1,64,448,25,15588
e2133f6f-daa1-4eba-b9f4-b32cdf9e322a,q72b-ties-other-w5050-6bc36-auto,1720077202,1720078414,finished,1720077233,1720078414,A100-SXM4-80GB,8,1,64,448,31,1181
443aeff7-27a2-4521-8563-f38deef49b11,q72b-ties-other-w1000-aa883-auto,1720077205,1720078757,finished,1720077233,1720078757,A100-SXM4-80GB,8,1,64,448,28,1524
95e7cf40-4e7a-4d38-81c9-709c649d5c26,q72b-ties-self-attn-w2575-94c36-auto,1720077206,1720078186,finished,1720077233,1720078186,A100-SXM4-80GB,8,1,64,448,27,953
ec3fc475-6cd4-4b9a-a45c-a0bb735576df,q72b-ties-other-w2575-2176d-auto,1720077208,1720078390,finished,1720077233,1720078390,A100-SXM4-80GB,8,1,64,448,25,1157
b954eb56-24bf-4075-88ae-1645fdb74763,Qwen2-72B-271ef-auto,1720077216,1720147777,finished,1720077238,1720147777,A100-SXM4-80GB,8,1,64,448,22,70539
a28eb09b-ce10-47d2-bce2-aa4c926ea761,q72b-ties-self-attn-w7525-3bd3a-auto,1720077256,1720078140,finished,1720077281,1720078140,A100-SXM4-80GB,8,1,64,448,25,859
ab374ce4-1801-4aea-93ba-e41a41e38dd4,q72b-ties-mlp-w7525-e9403-auto,1720077258,1720078537,finished,1720077281,1720078537,A100-SXM4-80GB,8,1,64,448,23,1256
13694387-a3db-4f27-9d2d-2595b938e6b0,geogpt-lxz-sft-magpie-llama3-pro-2ep-72b,1720077410,1720077758,finished,1720077490,1720077758,A100-SXM4-80GB,8,16,64,448,80,268
918b4eeb-5e7e-473a-b538-487eeb8ad9fa,sfr-ft-4,1720077481,1720178191,finished,1720077513,1720178191,A100-SXM4-80GB,8,1,64,448,32,100678
79a27022-16f1-488c-b4f3-647d404f02a5,llama-factory-long,1720077482,1720078458,finished,1720077513,1720078458,A100-SXM4-80GB,8,1,64,448,31,945
c7cd5d15-050f-4298-b769-778fe8cf8437,llama-factory-long-wosp,1720077482,1720078081,finished,1720077514,1720078081,A100-SXM4-80GB,8,1,64,448,32,567
5d02953f-dbba-4c57-811a-dd3974de7570,geogpt-lxz-sft-magpie-llama3-pro-2ep-72b,1720077838,1720078185,finished,1720077908,1720078185,A100-SXM4-80GB,8,16,64,448,70,277
f6515ddd-c69b-4855-b9a8-1f92419193ac,slimorca-geo-mtm1-mt-wild-14b,1720077990,1720144610,finished,1720078014,1720144610,A100-SXM4-80GB,8,1,64,448,24,66596
e0379959-2d35-426d-adb8-4ada80ab6dfd,qwen1-14B,1720078107,1720078256,finished,1720078132,1720078256,A100-SXM4-80GB,8,1,64,896,25,124
cdb0bfbd-f318-4ea1-9fa5-7c97c22fa1d6,qwen-72b-test,1720078109,1720078360,finished,1720078134,1720078360,A100-SXM4-40GB,8,1,32,320,25,226
32d64416-6609-4747-962a-f4a2045b82d7,geogpt-lxz-sft-magpie-llama3-pro-2ep-72b,1720078262,1720078627,finished,1720078332,1720078627,A100-SXM4-80GB,8,16,64,448,70,295
d797b909-450b-43b0-93e7-2164b26229e6,txchen-train-task,1720078398,1720095845,finished,1720078422,1720095845,A100-SXM4-80GB,8,1,64,448,24,17423
dd8e97a2-7c42-4233-a1dc-0a9515a51c77,llama-factory-long,1720078458,1720079263,finished,1720078482,1720079263,A100-SXM4-80GB,8,1,64,448,24,781
fa81aa23-0cf7-4318-9414-dec16a8c8ee1,llama-factory-long-wosp,1720078458,1720079166,finished,1720078482,1720079166,A100-SXM4-80GB,8,1,64,448,24,684
062179c6-0fee-4de5-9563-e27b536363f5,easycontext-zj-8b-cg,1720078697,1720078997,finished,1720078723,1720078997,A100-SXM4-80GB,8,1,64,896,26,274
7364030e-2982-498f-9c15-9ef2a7c8ea48,geo-72B,1720078704,1720083917,finished,1720078778,1720083917,A100-SXM4-80GB,8,16,64,896,74,5139
d80142d2-568b-4eb0-a43d-da64a904dcbd,geogpt-lxz-sft-magpie-llama3-pro-2ep-72b,1720078705,1720079151,finished,1720078788,1720079151,A100-SXM4-80GB,8,16,64,448,83,363
0200a9eb-af71-4ce8-a0c7-575fd8483698,easycontext-zj-8b,1720078723,1720079143,finished,1720078748,1720079143,A100-SXM4-80GB,8,1,64,896,25,395
ad117c7e-dfb6-45cd-9294-2868062d2c44,test,1720078745,1720082327,finished,1720078770,1720082327,A100-SXM4-80GB,8,1,64,448,25,3557
74c52fdc-eaf1-42bf-81d1-55cf8fd78c81,qwen-72b-test,1720078882,1720150881,finished,1720078905,1720150881,A100-SXM4-80GB,8,1,64,448,23,71976
2e18a476-0ba5-428a-bf78-e3ec2a317595,qwen1-14B,1720078903,1720079168,finished,1720078928,1720079168,A100-SXM4-80GB,8,1,64,896,25,240
9d78a46d-8e26-47a4-a904-137e554af3af,easycontext-zj-8b-cg,1720078997,1720079862,finished,1720079143,1720079862,A100-SXM4-80GB,8,1,64,896,146,719
01b48b95-dfca-4383-846d-da7e9978aa0c,qwen-72b-test,1720079122,1720147648,finished,1720079147,1720147648,A100-SXM4-40GB,8,1,32,320,25,68501
dff88c04-19ed-4e8a-97ee-33e38b47f282,geogpt-moe-alpaca-sft,1720079140,1720081411,finished,1720079213,1720081411,A100-SXM4-80GB,8,2,64,448,73,2198
2041c824-1e66-417a-a0bc-9f3301487853,easycontext-zj-8b,1720079143,1720080042,finished,1720079166,1720080042,A100-SXM4-80GB,8,1,64,896,23,876
36088c96-4e49-4028-9647-757408c0b435,geogpt-lxz-sft-magpie-llama3-pro-2ep-72b,1720079222,1720079543,finished,1720079269,1720079543,A100-SXM4-80GB,8,16,64,448,47,274
674855ad-ad38-4d34-bca2-ffd4b7c01247,llama-factory-long-wosp,1720079241,1720079839,finished,1720079264,1720079839,A100-SXM4-80GB,8,1,64,448,23,575
c95bd847-ca9b-4358-8bf0-49779c0357d5,llama-factory-long,1720079264,1720080899,finished,1720079294,1720080899,A100-SXM4-80GB,8,1,64,448,30,1605
8ad3c7e4-5f01-4aff-aa8a-08f8262650d5,geogpt-lxz-sft-magpie-llama3-pro-2ep-72b,1720079614,1720079933,finished,1720079660,1720079933,A100-SXM4-80GB,8,16,64,448,46,273
c9adf652-2a9c-40d3-9522-2633f4ef38c3,txchen-train-task2,1720079675,1720094688,finished,1720079698,1720094688,A100-SXM4-80GB,8,1,64,448,23,14990
02d5f792-c009-49fb-8717-b18615a039c3,Mixtral-8x7B-Instruct-shumo,1720079802,1720081659,finished,1720079824,1720081659,A100-SXM4-80GB,8,1,64,448,22,1835
0c3df88b-1272-4c9b-bd5e-0800cdbad051,geogpt-lxz-sft-magpie-llama3-pro-2ep-72b,1720080003,1720080365,finished,1720080071,1720080365,A100-SXM4-80GB,8,16,64,448,68,294
df75af70-9162-44c6-9bb2-5d378bf3fedd,q72b-ties-w46-d7575-b3a94-auto,1720080135,1720082202,finished,1720080157,1720082202,A100-SXM4-80GB,8,1,64,448,22,2045
0ece22a0-00af-4ff2-8f6f-0336b9661dca,q72b-ties-w46-d75100-acb7a-auto,1720080159,1720082283,finished,1720080185,1720082283,A100-SXM4-80GB,8,1,64,448,26,2098
30686051-6731-432c-81e5-8357ca4a7421,q72b-ties-w46-d50100-8e41b-auto,1720080161,1720082531,finished,1720080185,1720082531,A100-SXM4-80GB,8,1,64,448,24,2346
c9d97af0-7aaa-44b2-9065-aba31c3b841c,q72b-ties-w46-d75100-57da9-auto,1720080163,1720090286,finished,1720080331,1720090286,A100-SXM4-80GB,8,1,64,448,168,9955
6b1374b2-bc8d-4ca5-9796-cabaccb9cc7f,q72b-ties-w46-d100100-a5a4b-auto,1720080187,1720082446,finished,1720080331,1720082446,A100-SXM4-80GB,8,1,64,448,144,2115
f2b194dd-5610-4a28-a6cd-d9ccad8e2719,q72b-ties-w64-d75100-4fdf8-auto,1720080188,1720093042,finished,1720080331,1720093042,A100-SXM4-80GB,8,1,64,448,143,12711
9ae0d3d5-36eb-47c0-ba5a-9a8708147fd7,q72b-ties-w46-d10075-608aa-auto,1720080191,1720082476,finished,1720080331,1720082476,A100-SXM4-80GB,8,1,64,448,140,2145
2354a261-6f20-4fb8-b757-42791795c642,q72b-ties-w46-d7575-6671d-auto,1720080194,1720090374,finished,1720080331,1720090374,A100-SXM4-80GB,8,1,64,448,137,10043
32ce26c3-a1c6-45a6-bc54-fc9328264226,q72b-ties-w46-d10075-680ba-auto,1720080195,1720090534,finished,1720080331,1720090534,A100-SXM4-80GB,8,1,64,448,136,10203
0dafecef-8450-42a1-b88b-61df9b039e30,llama-factory-long-wosp,1720080237,1720080953,finished,1720080359,1720080953,A100-SXM4-80GB,8,1,64,448,122,594
617ae1f0-0d6e-4676-ab53-17530c952944,q72b-ties-w46-d100100-87ee4-auto,1720080302,1720090375,finished,1720080331,1720090375,A100-SXM4-80GB,8,1,64,448,29,10044
009eaefe-1664-4679-b25b-3731682d571f,q72b-ties-w64-d100100-e45ea-auto,1720080305,1720082447,finished,1720080332,1720082447,A100-SXM4-80GB,8,1,64,448,27,2115
7e66389a-ead7-4e7a-8fb1-d49e5735c9bf,q72b-ties-w46-d50100-a7c1b-auto,1720080306,1720090288,finished,1720080332,1720090288,A100-SXM4-80GB,8,1,64,448,26,9956
c932afa2-b390-4472-9eda-3b6fcb221133,q72b-ties-w64-d10075-70551-auto,1720080308,1720093414,finished,1720080332,1720093414,A100-SXM4-80GB,8,1,64,448,24,13082
a1c84b9e-c153-42a0-83c9-b27368e94877,q72b-ties-w64-d10075-0de13-auto,1720080334,1720082746,finished,1720080366,1720082746,A100-SXM4-80GB,8,1,64,448,32,2380
81a95553-95d6-4fd1-b819-aa29a891613e,q72b-ties-w64-d50100-58983-auto,1720080335,1720082587,finished,1720080366,1720082587,A100-SXM4-80GB,8,1,64,448,31,2221
7a912e87-de79-449d-92ad-a21674a937f6,q72b-ties-w64-d7575-c4f94-auto,1720080336,1720093566,finished,1720080366,1720093566,A100-SXM4-80GB,8,1,64,448,30,13200
03c10c1f-cf85-46ce-ad04-899e4c605177,q72b-ties-w64-d50100-c6e10-auto,1720080339,1720092841,finished,1720080367,1720092841,A100-SXM4-80GB,8,1,64,448,28,12474
e20164b7-287d-4cc2-9545-1a6bd6c2e16e,q72b-ties-w64-d75100-32e7f-auto,1720080341,1720083397,finished,1720081369,1720083397,A100-SXM4-80GB,8,1,64,448,1028,2028
4b0e3f54-ba54-4fe1-b2ff-e0e3c148d481,q72b-ties-w64-d7575-305ed-auto,1720080343,1720082588,finished,1720080367,1720082588,A100-SXM4-80GB,8,1,64,448,24,2221
f353cc5a-d354-40cd-8b9a-5d5b6f448b17,geogpt-lxz-sft-magpie-llama3-pro-2ep-72b,1720080440,1720084421,finished,1720083998,1720084421,A100-SXM4-80GB,8,16,64,448,3558,423
7339cc31-e812-4b11-ba90-2339ee6204e5,sql-spider-qy-0703,1720080485,1720085134,finished,1720080929,1720085134,A100-SXM4-80GB,8,1,64,448,444,4205
90d4631f-db19-4d33-b9f3-7731ae0cee11,syh-subspace-moe-mathmed-router-loss,1720080699,1720083783,finished,1720081155,1720083783,A100-SXM4-80GB,8,1,64,448,456,2628
9fc0c8d1-aa33-410f-b1e2-749eea417c0d,easycontext-zj-8b-cg,1720080786,1720081924,finished,1720081164,1720081924,A100-SXM4-80GB,8,1,64,896,378,760
1ed870eb-70d6-4aa3-b459-f07089faf783,llama-factory-long,1720080899,1720081414,finished,1720080926,1720081414,A100-SXM4-80GB,8,1,64,448,27,488
71263b73-caaa-4e5e-ba0a-b4ec9eb5e680,easycontext-zj-8b,1720081246,1720081447,finished,1720081274,1720081447,A100-SXM4-80GB,8,1,64,896,28,173
1761e0c0-f7b3-4d11-a39c-ee4382d956ca,llama-factory-long-wosp,1720081386,1720082003,finished,1720081414,1720082003,A100-SXM4-80GB,8,1,64,448,28,589
27c0545f-8d0c-48d0-823f-749ab66a7331,llama-factory-long,1720081414,1720083337,finished,1720081447,1720083337,A100-SXM4-80GB,8,1,64,448,33,1890
d28cabc7-81d7-4dea-b096-58ac28b5c3c2,debug,1720081448,1720088761,finished,1720081476,1720088761,A100-SXM4-80GB,8,1,64,896,28,7285
12dc36c5-7d22-45a0-983d-ebf4a31dd6cf,q72b-ties-self-attn-w7525-87306-auto,1720081570,1720082666,finished,1720081665,1720082666,A100-SXM4-80GB,8,1,64,448,95,1001
1a2a5893-57cf-433a-b62a-ee586ec0f9ef,q72b-ties-self-attn-w2575-8961a-auto,1720081572,1720082849,finished,1720081880,1720082849,A100-SXM4-80GB,8,1,64,448,308,969
e61a58b1-ba36-4da2-89a4-7f66aac51b9a,q72b-ties-mlp-w7525-00f68-auto,1720081574,1720083575,finished,1720082341,1720083575,A100-SXM4-80GB,8,1,64,448,767,1234
f80582fc-879b-484d-9018-a622fbdb1d53,q72b-ties-other-w1000-1a0c4-auto,1720081575,1720083897,finished,1720082479,1720083897,A100-SXM4-80GB,8,1,64,448,904,1418
8dd7e588-2119-484c-87bd-964f7cf41d2e,q72b-ties-other-w2575-e8968-auto,1720081578,1720083223,finished,1720081987,1720083223,A100-SXM4-80GB,8,1,64,448,409,1236
e8f141d6-df85-446a-841c-8887dd8c9041,q72b-ties-other-w5050-3535f-auto,1720081580,1720083653,finished,1720082422,1720083653,A100-SXM4-80GB,8,1,64,448,842,1231
3b4e1c16-3cee-46e4-9a7e-31cd4ad7b489,easycontext-zj-8b,1720081681,1720082657,finished,1720081924,1720082657,A100-SXM4-80GB,8,1,64,896,243,733
9a042a3e-cc4e-4ac3-ad2c-9b0d5b624bbc,Mixtral-8x7B-Instruct-shumo,1720081715,1720088128,finished,1720081983,1720088128,A100-SXM4-80GB,8,1,64,448,268,6145
0543d3db-3be1-4872-bdb2-44e25f47aeee,sql-spider-qy-0704-qwen,1720082007,1720082440,finished,1720082225,1720082440,A100-SXM4-80GB,8,1,64,448,218,215
6f98fc74-d778-4771-ae7e-8e40691bee7a,easycontext-zj-8b-cg,1720082087,1720083062,finished,1720082303,1720083062,A100-SXM4-80GB,8,1,64,896,216,759
f437430d-923a-44a6-822f-f46d47d42b1e,opencompass-eval-0704,1720082166,1720100018,finished,1720082493,1720100018,A100-SXM4-80GB,8,1,64,896,327,17525
8868d304-ee14-4d65-8344-9c91dfc9b180,sql-spider-qy-0704-qwen,1720082498,1720086811,finished,1720082527,1720086811,A100-SXM4-80GB,8,1,64,448,29,4284
e1555b38-8df4-4156-ac5f-9d6bd185fe09,cft-1-8m-sub-plus-mt-qwen2-72b,1720082559,1720144563,finished,1720082585,1720144563,A100-SXM4-80GB,8,1,64,448,26,61978
cd50bb13-68c5-4391-8c98-56a82942b3d3,cft-mt-lr1e-5-14b,1720082611,1720144632,finished,1720083424,1720144632,A100-SXM4-80GB,8,1,64,448,813,61208
87466f3c-47d6-4d83-a2b8-2110b877bd82,slimorca-geo-mtm1-geotable-nt-14b,1720082611,1720144633,finished,1720082721,1720144633,A100-SXM4-80GB,8,1,64,448,110,61912
7107c9d8-9155-4629-a7bd-a557d68d9b6a,megatron-gpt-16nodes,1720082631,1720084209,finished,1720082711,1720084209,A100-SXM4-80GB,8,8,64,448,80,1498
cfef0955-6b5a-4bbc-87cb-d85ac7913c15,slimorca-geo-mtm1-fcv2-14b,1720082663,1720144659,finished,1720083748,1720144659,A100-SXM4-80GB,8,1,64,448,1085,60911
74336fb4-9a56-425f-a65b-c8e3ba6178fd,q72b-ties-w64-d100100-ca052-auto,1720082669,1720095335,finished,1720082697,1720095335,A100-SXM4-80GB,8,1,64,448,28,12638
dd5e3eb0-bcd9-44f2-854c-299ef4a428d5,slimorca-mtm1-func-14b,1720082692,1720144703,finished,1720083869,1720144703,A100-SXM4-80GB,8,1,64,448,1177,60834
5afc011b-983d-417c-82a4-a945ebc68043,mixtral-8x7b-10bcpt-1ep-s42-1c6d9-auto,1720082750,1720124129,finished,1720083046,1720124129,A100-SXM4-80GB,8,1,64,448,296,41083
2dd4571b-8347-4d9a-a218-adfdf6775199,rag-rank,1720082816,1720099581,finished,1720082889,1720099581,A100-SXM4-80GB,8,1,64,448,73,16692
8714449d-8d03-4d66-86f9-c56e70596647,llama-factory-long-wosp,1720083088,1720083887,finished,1720083337,1720083887,A100-SXM4-80GB,8,1,64,448,249,550
5c3dd567-ca1a-44b5-a4bb-8044ece184da,geo-base-diff-check,1720083166,1720083391,finished,1720083242,1720083391,A100-SXM4-80GB,8,1,64,448,76,149
69070d49-dd73-41c0-abb9-7c27d477392c,test,1720083384,1720145034,finished,1720083412,1720145034,A100-SXM4-80GB,8,1,64,448,28,61622
635a02cc-46a5-4b05-8fdf-ac6fbdd84192,easycontext-zj-8b,1720083565,1720084415,finished,1720083694,1720084415,A100-SXM4-80GB,8,1,64,896,129,721
63466793-3d84-4848-9f65-53be3d7c6383,easycontext-zj-8b-cg,1720083592,1720084156,finished,1720083620,1720084156,A100-SXM4-80GB,8,1,64,896,28,536
e7b3082e-cde1-464d-9f14-9fb7c807ef51,geo-base-diff-check,1720083623,1720084842,finished,1720083940,1720084842,A100-SXM4-80GB,8,2,64,448,317,902
e9e62e56-7369-446e-a16f-538170f9668a,geo-72B,1720084080,1720090336,finished,1720084919,1720090336,A100-SXM4-80GB,8,16,64,896,839,5417
1aa556bb-23ed-412e-a454-9816455e202a,geogpt-llama3-70b-lp84-22bcpt,1720084089,1720085277,finished,1720084278,1720085277,A100-SXM4-80GB,8,2,64,448,189,999
0de95b4a-bfd1-422d-9c1e-99a6c7802187,easycontext-zj-8b-cg,1720084156,1720084415,finished,1720084241,1720084415,A100-SXM4-80GB,8,1,64,896,85,174
5fee4dd0-59b6-4576-844d-8c00ef03af9b,megatron-gpt-16nodes,1720084209,1720084640,finished,1720084440,1720084640,A100-SXM4-80GB,8,16,64,448,231,200
90f7f599-f7e3-4d6f-9902-451518f50d3c,geogpt-lxz-sft-magpie-llama3-pro-2ep-72b,1720084510,1720084875,finished,1720084590,1720084875,A100-SXM4-80GB,8,16,64,448,80,285
78b79f7c-f1b5-4301-a735-c57d684884b8,easycontext-zj-8b,1720084530,1720085893,finished,1720084558,1720085893,A100-SXM4-80GB,8,1,64,896,28,1335
0f12dc89-d964-46d0-a776-25077629b122,easycontext-zj-8b-cg,1720084531,1720085080,finished,1720084558,1720085080,A100-SXM4-80GB,8,1,64,896,27,522
0601f943-32c1-4673-a49e-8148dfb01a1d,geo-base-diff-check,1720084842,1720085029,finished,1720084868,1720085029,A100-SXM4-80GB,8,1,64,448,26,161
2f53a904-1fcb-4949-94dc-d450f2aec23c,geogpt-lxz-sft-magpie-llama3-pro-2ep-72b,1720084956,1720090635,finished,1720090341,1720090635,A100-SXM4-80GB,8,16,64,448,5385,294
a124849d-e3f6-442b-af55-aaf23b314deb,easycontext-zj-8b-cg,1720085080,1720085893,finished,1720085106,1720085893,A100-SXM4-80GB,8,1,64,896,26,787
7220c0dd-4cef-494d-9d00-ada98592f2b1,megatron-gpt-16nodes,1720085105,1720142259,finished,1720093839,1720142259,A100-SXM4-80GB,8,16,64,448,8734,48420
552b548f-13dd-4a22-a70f-e2a130503680,geogpt-prompt-tuning-tg-train-all,1720085176,1720089717,finished,1720085202,1720089717,A100-SXM4-80GB,8,1,64,448,26,4515
5ac29c6c-02a8-468a-acb7-d24673b85e16,geo-base-diff-check,1720085188,1720085490,finished,1720085267,1720085490,A100-SXM4-80GB,8,2,64,448,79,223
aa9a4f19-c2e5-4dea-b46f-b7c07681127f,sfr-embedding-test,1720085210,1720258553,finished,1720085238,1720258553,A100-SXM4-80GB,8,1,64,448,28,173315
8fed3e20-ef33-469c-90cc-817abeb989a0,sfr-embedding,1720085314,1720425725,finished,1720085338,1720425725,A100-SXM4-80GB,8,1,64,448,24,340387
cef3c2a5-d4df-4dc2-9922-e92287828e84,llama-nodist,1720085690,1720086254,finished,1720085716,1720086254,A100-SXM4-80GB,8,1,64,448,26,538
fc37949c-69a8-4edd-8c2f-cf5393d6f3a5,easycontext-zj-8b,1720085893,1720086101,finished,1720085919,1720086101,A100-SXM4-80GB,8,1,64,896,26,182
362c99d5-6bd1-43e9-9f70-e03da778beca,easycontext-zj-8b-cg,1720085894,1720086076,finished,1720085919,1720086076,A100-SXM4-80GB,8,1,64,896,25,157
b9d96fbb-9e70-4152-89bb-7cc15f43e90d,txchen-cpu-task,1720085989,1720086142,finished,1720086015,1720086142,A100-SXM4-80GB,8,1,64,448,26,127
98681e36-43cd-4dc7-bed9-c230cafc8272,txchen-cpu-task,1720086244,1720087596,finished,1720086272,1720087596,A100-SXM4-80GB,8,1,64,448,28,1324
e3375ce0-8fe6-4c3a-8c7b-f5fdfb784a6e,llama-factory-long,1720086253,1720088233,finished,1720086305,1720088233,A100-SXM4-80GB,8,2,64,448,52,1928
4b3885e2-f785-4702-95cf-bd738aa99e82,llama-nodist,1720086254,1720086705,finished,1720086282,1720086705,A100-SXM4-80GB,8,1,64,448,28,423
91646795-35fc-459e-8bc5-99bc3a6a6de7,llama-actsave,1720086809,1720087237,finished,1720086835,1720087237,A100-SXM4-80GB,8,1,64,448,26,402
419fcad1-65ca-4bc7-868d-c5cf0473e661,geogpt-mixtral-test,1720086818,1720091071,finished,1720090630,1720091071,A100-SXM4-80GB,8,16,64,896,3812,441
baa4fa35-e55d-41a2-a33c-f7efe3c4a3c5,m8x7b-10bcpt-1ep-auxloss-24936-auto,1720086995,1720089396,finished,1720087020,1720089396,A100-SXM4-80GB,8,1,64,448,25,2376
62811b77-edaf-4185-9f7e-efe84e5e0a1b,llama-nodist,1720087086,1720141312,finished,1720087112,1720141312,A100-SXM4-80GB,8,1,64,448,26,54200
4a208ccc-e723-451c-adbb-32375ced95e5,q72b-ties-w55-d10075-1051e-auto,1720088042,1720090184,finished,1720088069,1720090184,A100-SXM4-80GB,8,1,64,448,27,2115
d6b00210-5e2a-42ee-a4d1-a0b424b49819,q72b-ties-w55-d7575-27fc4-auto,1720088071,1720090209,finished,1720088101,1720090209,A100-SXM4-80GB,8,1,64,448,30,2108
3138e272-3f31-4ee1-9ef3-1f76a37265e6,llama3-70b-10bcpt-sft-1-7ep,1720088075,1720088618,finished,1720088104,1720088618,A100-SXM4-80GB,8,1,64,448,29,514
b8755d95-b3de-42fd-9dc9-47b87626d82e,geogpt-sft-qwen2-72b-datav081-ep1,1720088122,1720094406,finished,1720088152,1720094406,A100-SXM4-80GB,8,1,64,448,30,6254
a1c98132-e613-4f66-9161-ac1f7877021b,txchen-cpu-task,1720088168,1720088362,finished,1720088198,1720088362,A100-SXM4-80GB,8,1,64,448,30,164
5e09882e-0a18-4d1b-bef4-68cd7b43e66b,q72b-ties-w55-d75100-677f6-auto,1720088190,1720090340,finished,1720088217,1720090340,A100-SXM4-80GB,8,1,64,448,27,2123
5eb42721-a028-442d-bea6-d55ce41223c2,q72b-ties-w55-d50100-8efdb-auto,1720088354,1720090430,finished,1720088381,1720090430,A100-SXM4-80GB,8,1,64,448,27,2049
b40b2c19-ae83-4d60-a1b4-a30bd6894b1f,sql-spider-qy-0703,1720088399,1720088868,finished,1720088424,1720088868,A100-SXM4-80GB,8,1,64,448,25,444
b7c8c6a6-9dc2-44e1-bb09-b1069c003c37,sql-spider-qy-0704-qwen,1720088555,1720089050,finished,1720088582,1720089050,A100-SXM4-80GB,8,1,64,448,27,468
45183f14-92f0-418c-8738-22ecd2758917,q72b-ties-w55-d100100-ba077-auto,1720088564,1720090584,finished,1720088590,1720090584,A100-SXM4-80GB,8,1,64,448,26,1994
a2cb66ed-3030-4142-96e4-2700d7fa3c94,geogpt-prompt-tuning-tg-infer1,1720089222,1720092306,finished,1720089743,1720092306,A100-SXM4-80GB,8,1,64,448,521,2563
62663311-41de-46ea-b52f-f25459e10f39,tq-2pod-4l,1720089441,1720096083,finished,1720089520,1720096083,A100-SXM4-80GB,8,2,64,448,79,6563
c00aa743-1dfc-4175-9f5f-20867fe08b19,easycontext-zj-8b,1720089779,1720090393,finished,1720089808,1720090393,A100-SXM4-80GB,8,1,64,896,29,585
647b7919-99b8-40ac-9b03-685ba67208c3,txchen-cpu-task,1720089827,1720090012,finished,1720089853,1720090012,A100-SXM4-80GB,8,1,64,448,26,159
e56301e6-2fba-4262-b70e-a78cb5b0fcb3,geo-base-diff-check,1720090281,1720090604,finished,1720090370,1720090604,A100-SXM4-80GB,8,2,64,448,89,234
f2d58291-5537-4955-9765-b3ffa219e09d,txchen-lm-eval2,1720090384,1720090567,finished,1720090411,1720090567,A100-SXM4-80GB,8,1,64,448,27,156
5ff8fd6c-c92d-4c7c-8baa-075733d6dc60,easycontext-zj-8b,1720090393,1720090893,finished,1720090420,1720090893,A100-SXM4-80GB,8,1,64,896,27,473
587f5764-e9ce-421d-ad23-e00195f99e5a,geo-72B,1720090506,1720096168,finished,1720090658,1720096168,A100-SXM4-80GB,8,16,64,896,152,5510
b9701da3-8bd8-406e-99ea-d742aaabbb16,geogpt-lxz-sft-magpie-llama3-pro-2ep-72b,1720090719,1720096402,finished,1720096111,1720096402,A100-SXM4-80GB,8,16,64,448,5392,291
dcfe0f1a-be85-4507-b108-69a5cd4f1408,q72b-0701v1-ties-w55-d50100-7d1c5-auto,1720090724,1720093043,finished,1720090747,1720093043,A100-SXM4-80GB,8,1,64,448,23,2296
1e0e9293-2953-45e8-b649-5405b3ff6921,q72b-0701v1-ties-w55-d100100-a01bf-auto,1720090749,1720093044,finished,1720090902,1720093044,A100-SXM4-80GB,8,1,64,448,153,2142
454445a7-b584-462b-bcff-ca281bca6940,q72b-0701v1-ties-w55-d75100-125a4-auto,1720090751,1720093219,finished,1720091045,1720093219,A100-SXM4-80GB,8,1,64,448,294,2174
f6df5f0a-f536-4f7a-ba9f-88c5bb5180c1,txchen-lm-eval2,1720090831,1720091202,finished,1720091053,1720091202,A100-SXM4-80GB,8,1,64,448,222,149
7bec7ef6-fcd7-4a15-8212-5ea180568fdd,q72b-ties-other-w5050-239b9-auto,1720090849,1720093220,finished,1720091045,1720093220,A100-SXM4-80GB,8,1,64,448,196,2175
bd94ec9d-ebfc-449f-8e61-c1d4510cbd71,q72b-ties-mlp-w2575-0452b-auto,1720090852,1720093045,finished,1720091045,1720093045,A100-SXM4-80GB,8,1,64,448,193,2000
257d32af-a717-4ae2-b511-fd1d0887e3e0,easycontext-zj-8b-cg,1720090893,1720091825,finished,1720091061,1720091825,A100-SXM4-80GB,8,1,64,896,168,764
da031f4e-5078-4c3a-af3c-6657107586e8,easycontext-zj-8b,1720090893,1720091385,finished,1720091061,1720091385,A100-SXM4-80GB,8,1,64,896,168,324
25d8b15d-8159-4a03-8213-732b09f0a9d3,geo-base-diff-check,1720091040,1720091336,finished,1720091113,1720091336,A100-SXM4-80GB,8,2,64,448,73,223
3c647640-b48e-4cbe-9184-9623dea2f2d7,geogpt-mixtral-test,1720091143,1720093824,finished,1720093510,1720093824,A100-SXM4-80GB,8,16,64,896,2367,314
d7beab3e-0d4a-4e39-9435-2a14943cf169,txchen-cpu-task,1720091349,1720091561,finished,1720091376,1720091561,A100-SXM4-80GB,8,1,64,448,27,185
55ef2d44-59ec-4be2-a698-470743714e36,easycontext-zj-8b,1720091385,1720091878,finished,1720091410,1720091878,A100-SXM4-80GB,8,1,64,896,25,468
9d6f821e-3cbb-4a5e-b99b-29da414f824f,sql-spider-qy-0704-qwen,1720091414,1720091856,finished,1720091439,1720091856,A100-SXM4-80GB,8,1,64,448,25,417
aebe1ebf-2348-4a19-82b2-f5e246952c3d,sql-spider-qy-0703,1720091465,1720091964,finished,1720091492,1720091964,A100-SXM4-80GB,8,1,64,448,27,472
920dee22-3d9b-4a8e-ac73-ef6c06043c4c,geo-base-diff-check,1720091493,1720091749,finished,1720091573,1720091749,A100-SXM4-80GB,8,2,64,448,80,176
7d37b1fd-4844-48c8-b737-4341714a6895,txchen-lm-eval2,1720091561,1720091737,finished,1720091586,1720091737,A100-SXM4-80GB,8,1,64,448,25,151
b33e632f-c187-467f-abd2-4be2494c81ee,easycontext-zj-8b,1720091878,1720092834,finished,1720091904,1720092834,A100-SXM4-80GB,8,1,64,896,26,930
c99a9ca5-258d-4bd7-85b6-7050adb1fafd,easycontext-zj-8b-cg,1720091879,1720092653,finished,1720091904,1720092653,A100-SXM4-80GB,8,1,64,896,25,749
b64f12b7-fdf6-4315-a487-55412c95a7b1,geo-base-diff-check,1720091936,1720092241,finished,1720092019,1720092241,A100-SXM4-80GB,8,2,64,448,83,222
22d86d17-c26b-4ab3-a0f9-31151577cf6f,txchen-lm-eval2,1720091951,1720093003,finished,1720091981,1720093003,A100-SXM4-80GB,8,1,64,448,30,1022
6097a611-cac2-4e62-89e9-e73ce7c0e605,q72b-ties-w55-d50100-22a7b-auto,1720091974,1720102815,finished,1720092000,1720102815,A100-SXM4-80GB,8,1,64,448,26,10815
dfb1a134-9777-4725-a784-74161296e543,sql-spider-qy-0704-qwen,1720091993,1720092504,finished,1720092019,1720092504,A100-SXM4-80GB,8,1,64,448,26,485
f1ddaa9f-0160-436f-bb78-1f4a7ed1ffea,q72b-ties-w55-d75100-7a020-auto,1720092377,1720103341,finished,1720092403,1720103341,A100-SXM4-80GB,8,1,64,448,26,10938
2e46a692-6864-4b21-952a-8b096c21b58d,q72b-ties-w55-d10075-47880-auto,1720092431,1720103874,finished,1720092457,1720103874,A100-SXM4-80GB,8,1,64,448,26,11417
e2d8d5e9-ba0d-4f85-b99f-b39e7a7274e6,q72b-ties-w55-d100100-a68c5-auto,1720092432,1720103390,finished,1720092457,1720103390,A100-SXM4-80GB,8,1,64,448,25,10933
fd75b968-b99f-4733-89ea-c406c0660828,geogpt-llama3-70b-lp84-22bcpt,1720092487,1720216699,finished,1720107062,1720216699,A100-SXM4-80GB,8,64,64,448,14575,109637
550286d5-b4b2-4ed2-99ec-7f483c20336f,geo-base-diff-check,1720092504,1720092760,finished,1720092554,1720092760,A100-SXM4-80GB,8,2,64,448,50,206
10fbab32-b5b7-4184-be2c-4e9c9d25e78b,q72b-ties-w55-d7575-b5c26-auto,1720092563,1720104066,finished,1720092589,1720104066,A100-SXM4-80GB,8,1,64,448,26,11477
e660684b-3795-4aac-b694-658c9a5b1d87,txchen-cpu-task,1720092571,1720093714,finished,1720092596,1720093714,A100-SXM4-80GB,8,1,64,448,25,1118
7a979805-7acb-458b-8dbb-c0a198f3911f,txchen-lm-eval2,1720093003,1720095624,finished,1720093027,1720095624,A100-SXM4-80GB,8,1,64,448,24,2597
08afd21c-c2ef-4837-89da-2f428557c5f6,geo-base-diff-check,1720093214,1720093508,finished,1720093289,1720093508,A100-SXM4-80GB,8,2,64,448,75,219
8f8f0b33-35d5-4942-a697-71c126ab8bad,tq-4pod-4l,1720093286,1720141599,finished,1720141442,1720141599,A100-SXM4-80GB,8,4,64,448,48156,157
3e28fb7f-410b-4116-b4b5-0cf25bc239a0,geogpt-mixtral-test,1720093910,1720096088,finished,1720095640,1720096088,A100-SXM4-80GB,8,16,64,896,1730,448
4003d36b-eead-4850-ae7f-1c5381c629bc,llama3-70b-10bcpt-sft-1-7ep,1720094008,1720094463,finished,1720094032,1720094463,A100-SXM4-80GB,8,1,64,448,24,431
76a9a0f0-91c8-41b3-95ad-7404ea3ebf68,data-gen-magpie,1720094339,1720118765,finished,1720094363,1720118765,A100-SXM4-80GB,8,1,64,448,24,24402
1c1a9e48-2c20-4e11-9899-26f5ab619e27,sql-spider-qy-0704-qwen,1720094357,1720095588,finished,1720094381,1720095588,A100-SXM4-80GB,8,1,64,448,24,1207
136bf57f-b90d-4791-a598-d8a413f9a8f6,sql-spider-qy-0703,1720094573,1720094954,finished,1720094600,1720094954,A100-SXM4-80GB,8,1,64,448,27,354
a9fb64a3-43c6-4817-9a37-e77736f94399,geogpt-sft-qwen2-72b-datav081-ep1,1720094602,1720105109,finished,1720095281,1720105109,A100-SXM4-80GB,8,1,64,448,679,9828
49307aa1-b69a-46e6-82ce-60bbb00d1741,easycontext-zj-8b,1720094625,1720095959,finished,1720094950,1720095959,A100-SXM4-80GB,8,1,64,896,325,1009
1c94d6c6-328d-454d-ab7e-3ef4794d9d3a,easycontext-zj-8b-cg,1720094625,1720095665,finished,1720094696,1720095665,A100-SXM4-80GB,8,1,64,896,71,969
8e2da9d8-e9d6-47d9-9e72-36e9b37fdde9,geo-base-offline-eval2,1720095116,1720095691,finished,1720095282,1720095691,A100-SXM4-80GB,8,1,64,448,166,409
b9c1051b-7a48-4249-ba6a-044f1d054882,data-gen-magpie-2,1720095310,1720114993,finished,1720095333,1720114993,A100-SXM4-80GB,8,1,64,448,23,19660
45696e6b-dca0-4e35-8005-b3b7045ad490,sql-spider-qy-0704-qwen,1720095857,1720096509,finished,1720095887,1720096509,A100-SXM4-80GB,8,1,64,448,30,622
4eafba3f-d429-4f43-9b31-1e55e13d1543,moe-e8-l8-2pod,1720095883,1720343805,finished,1720095937,1720343805,A100-SXM4-80GB,8,2,64,448,54,247868
f8daaee6-27d7-4045-a34c-78b126c4fb37,geo-base-offline-eval2,1720095888,1720096457,finished,1720096085,1720096457,A100-SXM4-80GB,8,1,64,448,197,372
2fb15422-0216-47a6-b809-9a52ff54cddb,geogpt-mixtral-test,1720096169,1720096640,finished,1720096246,1720096640,A100-SXM4-80GB,8,16,64,896,77,394
3b4fdc51-d830-4543-85c3-39d708b202f9,q72b-ties-other-w2575-26c6d-auto,1720096223,1720098325,finished,1720096255,1720098325,A100-SXM4-80GB,8,1,64,448,32,2070
de16494d-d4d2-4056-b26b-fa390aafd9a4,sql-spider-qy-0703,1720096242,1720096634,finished,1720096273,1720096634,A100-SXM4-80GB,8,1,64,448,31,361
c1c4b297-59dc-496b-9e36-a0aff2be4358,geo-72B,1720096302,1720101595,finished,1720096427,1720101595,A100-SXM4-80GB,8,16,64,896,125,5168
feb42922-663c-447e-a625-06e7df63b9bd,q72b-ties-mlp-w5050-4a907-auto,1720096382,1720098579,finished,1720096406,1720098579,A100-SXM4-80GB,8,1,64,448,24,2173
3c56f938-8e9b-4713-a8f6-8842d9adbad3,qwen7b-tcpt-lr-8e-5-e2-bsz1024-f0e1d-auto,1720096413,1720098062,finished,1720096445,1720098062,A100-SXM4-80GB,8,1,64,448,32,1617
6f189b2e-bfd1-47fb-b876-0acb4bf1f59b,geogpt-lxz-sft-magpie-llama3-pro-2ep-72b,1720096490,1720096902,finished,1720096640,1720096902,A100-SXM4-80GB,8,16,64,448,150,262
1b8cd947-cb90-41a6-a2fe-fd012af57e3c,q72b-ties-self-attn-w5050-8b0c1-auto,1720096542,1720098762,finished,1720096567,1720098762,A100-SXM4-80GB,8,1,64,448,25,2195
462dd411-bdc7-4879-a7d2-c467a6338f6a,geo-base-offline-eval2,1720096561,1720097000,finished,1720096610,1720097000,A100-SXM4-80GB,8,1,64,448,49,390
519d1c7b-05b0-44c9-9439-20612a091a7f,q72b-ties-self-attn-w2575-f1728-auto,1720096703,1720099017,finished,1720096906,1720099017,A100-SXM4-80GB,8,1,64,448,203,2111
94e32b79-24fd-4e4a-a821-843f616e8988,geogpt-mixtral-test,1720096728,1720098959,finished,1720098651,1720098959,A100-SXM4-80GB,8,16,64,896,1923,308
b2417dc8-8ef6-4f08-b1b8-39b281082ed4,sql-spider-qy-0703,1720096827,1720097247,finished,1720096898,1720097247,A100-SXM4-80GB,8,1,64,448,71,349
0c5406ef-e2d6-4a96-9dce-12b96fe2c407,sql-spider-qy-0704-qwen,1720096899,1720097539,finished,1720096924,1720097539,A100-SXM4-80GB,8,1,64,448,25,615
6c7ccf45-32e1-453a-ad9f-d71a11c4bce9,geogpt-lxz-sft-magpie-llama3-pro-2ep-72b,1720096982,1720097825,finished,1720097545,1720097825,A100-SXM4-80GB,8,16,64,448,563,280
f8a62125-3e09-49ed-a9b3-a258a464e0b8,llama3-70b-10bcpt-sft,1720097035,1720166002,finished,1720097059,1720166002,A100-SXM4-80GB,8,1,64,448,24,68943
1c8be9c4-35a0-4478-8a65-3f423c17ccb0,geo-base-offline-eval2,1720097100,1720097248,finished,1720097126,1720097248,A100-SXM4-80GB,8,1,64,448,26,122
0ae0fab5-598c-457b-b31b-74e0a96c2d9e,qwen1-5-7b-slp40-25bgeo-2ep-45202-auto,1720097779,1720099774,finished,1720097805,1720099774,A100-SXM4-80GB,8,1,64,448,26,1969
1ae62f1f-7890-4741-8c49-b5e9fdb7c581,qwen1-5-7b-slp40-25bgeo-2ep-59442-auto,1720097806,1720147687,finished,1720097831,1720147687,A100-SXM4-80GB,8,1,64,448,25,49856
84f6df98-af89-4dcb-a904-89b04c047f7d,geogpt-lxz-sft-magpie-llama3-pro-2ep-72b,1720097907,1720098657,finished,1720098373,1720098657,A100-SXM4-80GB,8,16,64,448,466,284
1f95e1bb-4f98-43ee-b522-994e4d939d1c,txchen-lm-eval2,1720098587,1720098869,finished,1720098611,1720098869,A100-SXM4-80GB,8,1,64,448,24,258
bddc55e8-bd46-41c3-8f84-e28f3d797968,geogpt-lxz-sft-magpie-llama3-pro-2ep-72b,1720098738,1720099263,finished,1720098985,1720099263,A100-SXM4-80GB,8,16,64,448,247,278
c0b5bf36-cced-4501-84aa-6567044a7845,qwen7b-scpt-lr-8e-5-bsz1024-3-d6349-auto,1720098942,1720101052,finished,1720098967,1720101052,A100-SXM4-80GB,8,1,64,448,25,2085
c709d5fb-a447-4688-b4cb-541d52ed52a3,geogpt-mixtral-test,1720099043,1720099587,finished,1720099288,1720099587,A100-SXM4-80GB,8,16,64,896,245,299
3fec21ca-aa55-45ed-8684-58c15c8cf66d,syh-subspace-moe-mathmed-router-loss,1720099127,1720099477,finished,1720099153,1720099477,A100-SXM4-80GB,8,1,64,448,26,324
c24b4bcb-5530-4a96-83cc-e6a59418cf04,geogpt-lxz-sft-magpie-llama3-pro-2ep-72b,1720099346,1720099889,finished,1720099609,1720099889,A100-SXM4-80GB,8,16,64,448,263,280
fab504a7-5f73-42a2-b048-078c511ff8a3,geo-base-offline-eval2,1720099669,1720100076,finished,1720099695,1720100076,A100-SXM4-80GB,8,1,64,448,26,381
a0864755-0106-4c97-ab83-f1f0e66c44bf,geogpt-mixtral-test,1720099672,1720100232,finished,1720099913,1720100232,A100-SXM4-80GB,8,16,64,896,241,319
2412c6a4-c08a-4270-be2d-9e480bc944be,geogpt-lxz-sft-magpie-llama3-pro-2ep-72b,1720099976,1720100532,finished,1720100260,1720100532,A100-SXM4-80GB,8,16,64,448,284,272
fa090a0f-3766-463f-8d9f-fbdf95d82b01,txchen-train-task,1720100036,1720101536,finished,1720100063,1720101536,A100-SXM4-80GB,8,1,64,448,27,1473
bac72381-74cf-4dbf-abea-da74a631f110,llama-factory-long,1720100072,1720103003,finished,1720100147,1720103003,A100-SXM4-80GB,8,2,64,448,75,2856
dc4be67f-209d-48ed-a904-20fc945d03f1,easycontext-zj-8b-cg,1720100226,1720101258,finished,1720100251,1720101258,A100-SXM4-80GB,8,1,64,896,25,1007
1c627439-81c6-48b3-bd9e-67c4ee237364,easycontext-zj-8b,1720100226,1720101258,finished,1720100251,1720101258,A100-SXM4-80GB,8,1,64,896,25,1007
091013b3-dc6b-454f-a34b-398e2bdaddc0,geogpt-mixtral-test,1720100316,1720100884,finished,1720100583,1720100884,A100-SXM4-80GB,8,16,64,896,267,301
c7a8d7bd-f9ed-44ce-87c4-ed298db059a8,geogpt-lxz-sft-magpie-llama3-pro-2ep-72b,1720100618,1720101313,finished,1720100834,1720101313,A100-SXM4-80GB,8,16,64,448,216,479
711707ad-b5d8-41ab-bdc1-6a28f7bbbc14,geogpt-mixtral-test,1720100963,1720101312,finished,1720101014,1720101312,A100-SXM4-80GB,8,16,64,896,51,298
46d9bd41-f0cb-43ff-81f5-b96513af39b4,geo-base-offline-eval2,1720101161,1720101310,finished,1720101185,1720101310,A100-SXM4-80GB,8,1,64,448,24,125
730a531f-bfec-4252-91b1-b825dc3dc024,geogpt-lxz-sft-magpie-llama3-pro-2ep-72b,1720101395,1720101751,finished,1720101444,1720101751,A100-SXM4-80GB,8,16,64,448,49,307
2380c677-7d3d-4714-8c06-aea038f98a1b,geogpt-mixtral-test,1720101395,1720101865,finished,1720101471,1720101865,A100-SXM4-80GB,8,16,64,896,76,394
a2f5c0c2-81c7-41c1-a87a-901d91fe8a51,txchen-train-task,1720101536,1720102364,finished,1720101560,1720102364,A100-SXM4-80GB,8,1,64,448,24,804
7fd86e48-12b7-4cc4-bf40-23ab9bc8aad7,geo-72B,1720101722,1720107030,finished,1720101776,1720107030,A100-SXM4-80GB,8,16,64,896,54,5254
5281feed-000b-4b49-8018-8bca46557e1c,sql-spider-qy-0704-qwen,1720101748,1720101915,finished,1720101774,1720101915,A100-SXM4-80GB,8,1,64,448,26,141
659149cc-4155-4a77-ba3a-ad483ab32ef0,geo-base-offline-eval2,1720101748,1720102197,finished,1720101774,1720102197,A100-SXM4-80GB,8,1,64,448,26,423
1ef73ac6-d46f-40ef-91f4-ec65ccebe29c,sql-spider-qy-0703,1720101774,1720101915,finished,1720101805,1720101915,A100-SXM4-80GB,8,1,64,448,31,110
e4d4760a-feb1-46ae-9166-3a867ae7260b,geogpt-lxz-sft-magpie-llama3-pro-2ep-72b,1720101840,1720102153,finished,1720101887,1720102153,A100-SXM4-80GB,8,16,64,448,47,266
638ff9e5-fc96-455f-bca3-8f4d587796a8,geogpt-mixtral-test,1720101946,1720102427,finished,1720102023,1720102427,A100-SXM4-80GB,8,16,64,896,77,404
36e0a1f0-e498-48f9-a0b6-299b7948cea0,sql-spider-qy-0704-qwen,1720102049,1720102608,finished,1720102075,1720102608,A100-SXM4-80GB,8,1,64,448,26,533
86733546-ae9d-4c1f-91b5-6b25380fbd10,sql-spider-qy-0703,1720102075,1720102376,finished,1720102099,1720102376,A100-SXM4-80GB,8,1,64,448,24,277
038f1e6b-59b8-48c7-8f2b-bd52c500ca52,geogpt-lxz-sft-magpie-llama3-pro-2ep-72b,1720102228,1720102556,finished,1720102275,1720102556,A100-SXM4-80GB,8,16,64,448,47,281
0f06d7be-053e-4e34-92f0-bde72a5ee49a,txchen-train-task,1720102365,1720116895,finished,1720102390,1720116895,A100-SXM4-80GB,8,1,64,448,25,14505
e58ca704-658b-45b5-b9bb-48c0143c3111,data-gen-magpie-3,1720102480,1720127103,finished,1720102509,1720127103,A100-SXM4-80GB,8,1,64,448,29,24594
74ba8ff6-abde-41b4-b7d1-d4c9a19ce0e6,geogpt-mixtral-test,1720102508,1720102963,finished,1720102583,1720102963,A100-SXM4-80GB,8,16,64,896,75,380
f3466d5c-dc87-4718-b968-cf6900067db9,data-gen-magpie-4,1720102511,1720135716,finished,1720102532,1720135716,A100-SXM4-80GB,8,1,64,448,21,33184
a30b4e28-32f5-4d4c-9d4a-475374487047,geogpt-lxz-sft-magpie-llama3-pro-2ep-72b,1720102638,1720102963,finished,1720102687,1720102963,A100-SXM4-80GB,8,16,64,448,49,276
a440a837-4d28-4d10-8729-175d82dbc874,sql-spider-qy-0704-qwen,1720102884,1720103409,finished,1720102908,1720103409,A100-SXM4-80GB,8,1,64,448,24,501
6fc4eb0c-34a0-4dc6-a865-811a40112c68,geogpt-prompt-tuning-tg-infer1,1720102945,1720105074,finished,1720102970,1720105074,A100-SXM4-80GB,8,1,64,448,25,2104
d295724a-c88e-444d-a823-ebda673f263e,geogpt-mixtral-test,1720103045,1720103388,finished,1720103091,1720103388,A100-SXM4-80GB,8,16,64,896,46,297
81bd4281-ddd0-4651-a33e-23f021f46d67,geogpt-lxz-sft-magpie-llama3-pro-2ep-72b,1720103046,1720103388,finished,1720103097,1720103388,A100-SXM4-80GB,8,16,64,448,51,291
69664449-ae48-4c55-9582-3eb525f4b57b,geogpt-mixtral-test,1720103467,1720103851,finished,1720103539,1720103851,A100-SXM4-80GB,8,16,64,896,72,312
9143ef2d-84a6-4ea6-a665-2a150d57e58a,geogpt-lxz-sft-magpie-llama3-pro-2ep-72b,1720103467,1720103875,finished,1720103545,1720103875,A100-SXM4-80GB,8,16,64,448,78,330
318e7eec-e973-46dd-a181-d4d6dda72159,geogpt-mixtral-test,1720103925,1720104173,finished,1720104003,1720104173,A100-SXM4-80GB,8,16,64,896,78,170
22d8d600-0d75-4948-982b-2bdac7b4b185,geogpt-lxz-sft-magpie-llama3-pro-2ep-72b,1720103953,1720104469,finished,1720104036,1720104469,A100-SXM4-80GB,8,16,64,448,83,433
6ba644d6-91e9-40d0-9375-634e62df28c2,sql-spider-qy-0704-qwen,1720104137,1720106380,finished,1720104167,1720106380,A100-SXM4-80GB,8,1,64,448,30,2213
26f06128-c341-4765-b627-acc41f98d1ba,sql-spider-qy-0703,1720104137,1720105156,finished,1720104167,1720105156,A100-SXM4-80GB,8,1,64,448,30,989
d4a41e2f-de67-4053-a99e-00c96406ae96,q72b-0701v1-ties-w55-d50100-65f4e-auto,1720104197,1720116494,finished,1720104220,1720116494,A100-SXM4-80GB,8,1,64,448,23,12274
43d14cf6-fb06-476d-a078-c80ae4fe1e04,geogpt-lxz-sft-magpie-llama3-pro-2ep-72b,1720104541,1720104872,finished,1720104588,1720104872,A100-SXM4-80GB,8,16,64,448,47,284
fe4811d4-8374-4d1f-a691-a3a7b7d17886,q72b-0701v1-ties-w55-d75100-8b7fb-auto,1720104710,1720117001,finished,1720104732,1720117001,A100-SXM4-80GB,8,1,64,448,22,12269
a2a1aeff-9e79-4241-a0e5-48beb1249171,q72b-0701v1-ties-w55-d100100-93343-auto,1720104803,1720117002,finished,1720104826,1720117002,A100-SXM4-80GB,8,1,64,448,23,12176
e7c3f687-dacd-4122-9c97-b3f865fc906d,geogpt-lxz-sft-magpie-llama3-pro-2ep-72b,1720104946,1720105300,finished,1720105014,1720105300,A100-SXM4-80GB,8,16,64,448,68,286
4499685a-3d70-408e-8ce4-1a362f81049a,q72b-ties-self-attn-w2575-0412b-auto,1720105352,1720114388,finished,1720105376,1720114388,A100-SXM4-80GB,8,1,64,448,24,9012
d06d7988-f69a-499b-a513-96bb76ab22c2,geogpt-lxz-sft-magpie-llama3-pro-2ep-72b,1720105373,1720105682,finished,1720105419,1720105682,A100-SXM4-80GB,8,16,64,448,46,263
e0a9caf9-ae77-44c5-96bd-52d9d675d337,q72b-ties-self-attn-w5050-04d81-auto,1720105498,1720114741,finished,1720105523,1720114741,A100-SXM4-80GB,8,1,64,448,25,9218
ed7ed8a7-a16b-4b13-ab83-a05c51d647fb,geogpt-lxz-sft-magpie-llama3-pro-2ep-72b,1720105758,1720106114,finished,1720105827,1720106114,A100-SXM4-80GB,8,16,64,448,69,287
ba61ee61-624e-4c72-84c2-3e72b6a2f1ef,geogpt-lxz-sft-magpie-llama3-pro-2ep-72b,1720106191,1720106547,finished,1720106264,1720106547,A100-SXM4-80GB,8,16,64,448,73,283
26eee607-e777-4f85-b642-ebcecf649aca,geogpt-lxz-sft-magpie-llama3-pro-2ep-72b,1720106620,1720106958,finished,1720106670,1720106958,A100-SXM4-80GB,8,16,64,448,50,288
30d04315-3991-4c1c-969f-1d63d8e6a8f7,qwen7b-scpt-lr-8e-5-bsz1024-2-f9ca1-auto,1720106779,1720108608,finished,1720106803,1720108608,A100-SXM4-80GB,8,1,64,448,24,1805
0cbded7e-85c8-401f-a10b-5a3a3a8d86a3,geogpt-lxz-sft-magpie-llama3-pro-2ep-72b,1720107030,1720124460,finished,1720124174,1720124460,A100-SXM4-80GB,8,16,64,448,17144,286
481783c1-1dc3-4e52-93fb-a90c85a94e6b,txchen-cpu-task,1720107095,1720107817,finished,1720107120,1720107817,A100-SXM4-80GB,8,1,64,448,25,697
3e7c828d-1aa2-49b3-996f-e4c42f3c07e9,geo-72B,1720107207,1720129909,finished,1720124479,1720129909,A100-SXM4-80GB,8,16,64,896,17272,5430
ed330da6-021b-4aa6-84df-01067f63a6d1,q72b-ties-other-w5050-6467b-auto,1720107310,1720116703,finished,1720107334,1720116703,A100-SXM4-80GB,8,1,64,448,24,9369
6708ef44-bcb4-41e4-aa76-14b752af4a70,q72b-ties-other-w2575-818cb-auto,1720107738,1720116773,finished,1720107762,1720116773,A100-SXM4-80GB,8,1,64,448,24,9011
db13b14e-d32d-47c9-9691-4399306f1078,lzk-scihub-abstract-text-embedding,1720109222,1720129689,finished,1720109246,1720129689,A100-SXM4-80GB,8,1,64,448,24,20443
2ad4341d-7217-4fe0-9f80-de9b67eb951e,sql-spider-qy-0704-qwen,1720109306,1720109995,finished,1720109330,1720109995,A100-SXM4-80GB,8,1,64,448,24,665
18ef5718-fc83-4ce8-a8b5-5660eb07f5dc,llama2-mosaic-CS-9c4a6-auto,1720109814,1720111378,finished,1720109837,1720111378,A100-SXM4-80GB,8,1,64,448,23,1541
cec054c1-afd2-40da-9b5a-1b1dbefc35b9,llama2-longtext-CS-ml1wtoken-d411a-auto,1720109911,1720123185,finished,1720109935,1720123185,A100-SXM4-80GB,8,1,64,448,24,13250
f8416d21-36e8-4d82-ae25-d0b2ef974366,llama2-base-sft3epo-f0468-auto,1720110008,1720111525,finished,1720110034,1720111525,A100-SXM4-80GB,8,1,64,448,26,1491
764489c5-ccde-4cd9-9471-9d257e5a272d,sql-spider-qy-0704-qwen,1720110302,1720115805,finished,1720111391,1720115805,A100-SXM4-80GB,8,1,64,448,1089,4414
76d75e5c-062e-48c1-9b79-23ef9ef27a48,sql-spider-qy-0703,1720110568,1720112724,finished,1720111536,1720112724,A100-SXM4-80GB,8,1,64,448,968,1188
5646680e-ccb2-444a-a825-03297f927031,sql-spider-qy-0703,1720113934,1720115223,finished,1720113958,1720115223,A100-SXM4-80GB,8,1,64,448,24,1265
5868d37a-e67b-428b-ba22-8b055d1f0602,geogpt-lxz-sft-magpie-llama3-pro-2ep-72b,1720124536,1720130357,finished,1720129932,1720130357,A100-SXM4-80GB,8,16,64,448,5396,425
77bd0b13-c334-4412-bad3-578a73a1307c,geo-72B,1720130048,1720135642,finished,1720130348,1720135642,A100-SXM4-80GB,8,16,64,896,300,5294
c2f44c77-b23a-4fbb-8551-a77b743462b4,geogpt-lxz-sft-magpie-llama3-pro-2ep-72b,1720130427,1720135913,finished,1720135643,1720135913,A100-SXM4-80GB,8,16,64,448,5216,270
5aa782d8-c2d7-485d-b79f-29786e5f8028,geo-72B,1720135782,1720141022,finished,1720135933,1720141022,A100-SXM4-80GB,8,16,64,896,151,5089
2440722c-7b08-4bb8-b324-680c5bf94ddc,geogpt-lxz-sft-magpie-llama3-pro-2ep-72b,1720135989,1720141322,finished,1720141045,1720141322,A100-SXM4-80GB,8,16,64,448,5056,277
8f7dfa7c-ecc8-4f89-b47a-6c5f7c9d5381,geo-72B,1720141161,1720146501,finished,1720141314,1720146501,A100-SXM4-80GB,8,16,64,896,153,5187
aa5d1e62-a229-418c-9cbd-eeeea0ff0b06,llama-nodist,1720141387,1720142172,finished,1720141419,1720142172,A100-SXM4-80GB,8,1,64,448,32,753
d15763c2-8eb1-443d-87d0-65ac0fa6c8e2,geogpt-lxz-sft-magpie-llama3-pro-2ep-72b,1720141402,1720141912,finished,1720141449,1720141912,A100-SXM4-80GB,8,16,64,448,47,463
a76ce30c-d95e-4694-865d-af991f4638c4,geo-base-e16,1720141421,1720847876,finished,1720141897,1720847876,A100-SXM4-80GB,8,32,64,448,476,705979
8d3f6774-c4c6-4556-85e0-982ddadb803e,debug,1720141952,1720151136,finished,1720142022,1720151136,A100-SXM4-80GB,8,2,64,896,70,9114
2b1ca063-9413-4d14-8293-d56338b78758,geogpt-lxz-sft-magpie-llama3-pro-2ep-72b,1720141985,1720142595,finished,1720142310,1720142595,A100-SXM4-80GB,8,16,64,448,325,285
8afaaae8-0d7b-4845-8ea4-2261c4175fe5,opencompass-eval-0704,1720142125,1720159734,finished,1720142146,1720159734,A100-SXM4-80GB,8,1,64,896,21,17588
3207fa2b-a8ed-461a-9665-418ce8a64cca,llama-nodist,1720142504,1720143156,finished,1720142526,1720143156,A100-SXM4-80GB,8,1,64,448,22,630
8811ac49-5c18-498a-afb8-9f2919fd232b,geogpt-lxz-sft-magpie-llama3-pro-2ep-72b,1720142662,1720143013,finished,1720142728,1720143013,A100-SXM4-80GB,8,16,64,448,66,285
501eb6ee-f8f0-4df1-83c4-18ccdb72e9f3,geo-base-offline-eval,1720142797,1720153867,finished,1720142819,1720153867,A100-SXM4-80GB,8,1,64,448,22,11048
f502d0d8-ee32-4c98-b9d4-1e2548be8e7d,ruler-eval-0705,1720143078,1720162065,finished,1720143102,1720162065,A100-SXM4-80GB,8,1,64,896,24,18963
c42f6cde-c6a5-41cd-b045-2bc1f1aedf72,geogpt-lxz-sft-magpie-llama3-pro-2ep-72b,1720143087,1720143420,finished,1720143132,1720143420,A100-SXM4-80GB,8,16,64,448,45,288
1cd34e7f-8634-4027-a23a-89ef8a305dbb,sql-spider-qy-0703,1720143225,1720146795,finished,1720143248,1720146795,A100-SXM4-80GB,8,1,64,448,23,3547
300cf6e5-e5f7-4105-830c-53b9d3b1f457,geogpt-lxz-sft-magpie-llama3-pro-2ep-72b,1720143489,1720143813,finished,1720143532,1720143813,A100-SXM4-80GB,8,16,64,448,43,281
b066964c-b5f5-49a8-b998-8659813bc455,sql-spider-qy-0704-qwen,1720143854,1720144335,finished,1720143883,1720144335,A100-SXM4-80GB,8,1,64,448,29,452
f6650881-e647-44bf-a228-c23a6d7ef22d,geogpt-72b-lp84-gate-10bcpt-2ep-eval,1720143867,1720151537,finished,1720143890,1720151537,A100-SXM4-80GB,8,1,64,448,23,7647
b339488e-7733-416a-b373-e3ffd0a41cc3,geogpt-lxz-sft-magpie-llama3-pro-2ep-72b,1720143887,1720144199,finished,1720143932,1720144199,A100-SXM4-80GB,8,16,64,448,45,267
45179d59-0c79-4d14-a364-9391c43783a7,llama-nodist,1720143904,1720144063,finished,1720143927,1720144063,A100-SXM4-80GB,8,1,64,448,23,136
1cb1d05c-6d7a-4c62-a92c-b68d62157d0f,llama3-8b-sft32k,1720144194,1720144331,finished,1720144237,1720144331,A100-SXM4-80GB,8,4,64,448,43,94
42de7006-5185-4d4b-8c6c-de991e03b602,geogpt-lxz-sft-magpie-llama3-pro-2ep-72b,1720144271,1720144609,finished,1720144337,1720144609,A100-SXM4-80GB,8,16,64,448,66,272
f4f9901d-37d1-4b7d-9ddb-3b01abf6661e,llama-nodist,1720144426,1720144605,finished,1720144447,1720144605,A100-SXM4-80GB,8,1,64,448,21,158
bbc0a67f-6f10-4468-bc23-9a95afcbd549,cft-1-8m-sub-plus-mt-qwen2-72b,1720144611,1720239227,finished,1720144634,1720239227,A100-SXM4-80GB,8,1,64,448,23,94593
1ece6189-e74c-4e9b-ba9d-a8e7f78ee1f1,geogpt-lxz-sft-magpie-llama3-pro-2ep-72b,1720144680,1720145022,finished,1720144744,1720145022,A100-SXM4-80GB,8,16,64,448,64,278
db28e5ec-ec43-4aa3-9f53-275a9fe24710,reranker2-inference,1720144696,1720317666,finished,1720144718,1720317666,A100-SXM4-80GB,8,1,64,448,22,172948
1031c2b4-f485-4d5a-bc75-b1af0fcafaa2,llama-nodist,1720144808,1720147621,finished,1720144829,1720147621,A100-SXM4-80GB,8,1,64,448,21,2792
7ef7d2ae-010e-475a-8943-921156391eaa,slimorca-geo-mtm1-mt-wild-14b,1720144936,1720231967,finished,1720144956,1720231967,A100-SXM4-80GB,8,1,64,448,20,87011
24e9e4b7-7335-4014-bf47-af67deb08fc8,sql-spider-qy-0704-qwen,1720144997,1720145457,finished,1720145018,1720145457,A100-SXM4-80GB,8,1,64,448,21,439
4c73bce2-aa03-49e5-a9b0-02b2f1ec57f7,test,1720145034,1720595891,finished,1720145054,1720595891,A100-SXM4-80GB,8,1,64,896,20,450837
63ae28d0-16ec-4ecc-8dce-42eb4af6faad,geogpt-lxz-sft-magpie-llama3-pro-2ep-72b,1720145087,1720145419,finished,1720145149,1720145419,A100-SXM4-80GB,8,16,64,448,62,270
c865036d-1f3b-414f-afdd-489f9e049154,geogpt-sft-qwen2-72b-datav081-ep1,1720145354,1720149723,finished,1720145375,1720149723,A100-SXM4-80GB,8,1,64,448,21,4348
d750e01c-7225-43e5-b392-7607d6bc08b8,geogpt-lxz-sft-magpie-llama3-pro-2ep-72b,1720145484,1720145902,finished,1720145545,1720145902,A100-SXM4-80GB,8,16,64,448,61,357
e37061f6-eb77-4be6-acf4-4febd28620b2,sql-spider-qy-0704-qwen,1720145611,1720146340,finished,1720145632,1720146340,A100-SXM4-80GB,8,1,64,448,21,708
34b95f55-167a-45f0-86fc-b5088f99b9b6,geogpt-lxz-sft-magpie-llama3-pro-2ep-72b,1720145969,1720146321,finished,1720146032,1720146321,A100-SXM4-80GB,8,16,64,448,63,289
9cf9284c-963e-4f7d-b513-e65392412a51,sql-spider-qy-0704-qwen,1720146340,1720147149,finished,1720146361,1720147149,A100-SXM4-80GB,8,1,64,448,21,788
643712e4-526c-4f22-bdb4-079eb9451f92,geogpt-lxz-sft-magpie-llama3-pro-2ep-72b,1720146390,1720146710,finished,1720146431,1720146710,A100-SXM4-80GB,8,16,64,448,41,279
13bd67b1-5042-45de-90f6-c5b1d714d15f,geo-base-offline-eval2,1720146666,1720147088,finished,1720146687,1720147088,A100-SXM4-80GB,8,1,64,448,21,401
1cb92c30-81a3-4f2a-9048-b6e1b9c7b4d7,geogpt-lxz-sft-magpie-llama3-pro-2ep-72b,1720146776,1720147110,finished,1720146838,1720147110,A100-SXM4-80GB,8,16,64,448,62,272
1d50a41b-d18c-4284-aa35-242014545f7a,sql-spider-qy-0704-qwen,1720147149,1720147595,finished,1720147176,1720147595,A100-SXM4-80GB,8,1,64,448,27,419
9946db5b-d6aa-4dd6-8a08-b0e84399af35,llama3-8b-sft32k,1720147173,1720148567,finished,1720147217,1720148567,A100-SXM4-80GB,8,4,64,448,44,1350
f68b75ca-437d-43f4-878a-77b42bc27281,geogpt-lxz-sft-magpie-llama3-pro-2ep-72b,1720147179,1720147603,finished,1720147223,1720147603,A100-SXM4-80GB,8,16,64,448,44,380
5f8380fe-50c1-4b9c-83e4-ab1081c1c46f,qwen7b-tcpt-lr-8e-5-e1-bsz1024-f76c6-auto,1720147238,1720147666,finished,1720147260,1720147666,A100-SXM4-80GB,8,1,64,448,22,406
20b089f5-4683-49c7-9190-36372f3e8b0c,geo-llamapro-1-5B,1720147335,1720147599,finished,1720147356,1720147599,A100-SXM4-80GB,8,4,64,448,21,243
8cde64df-5cbe-46d6-b119-1347ff7c1e62,qwen7b-tcpt-lr-1e-4-e1-bsz1024-b21b5-auto,1720147366,1720147635,finished,1720147387,1720147635,A100-SXM4-80GB,8,1,64,448,21,248
fea83a3f-6d07-418a-86db-46a7c52fcae5,geo-MoD-1-5B,1720147558,1720147846,finished,1720147651,1720147846,A100-SXM4-80GB,8,2,64,448,93,195
b4094f00-394c-4ce1-80a6-e9bd8481a6db,sql-spider-qy-0704-qwen,1720147596,1720148194,finished,1720147622,1720148194,A100-SXM4-80GB,8,1,64,448,26,572
95f5f064-a7c1-4409-bba5-8305dc69a0da,geo-llamapro-1-5B,1720147599,1720147925,finished,1720147680,1720147925,A100-SXM4-80GB,8,4,64,448,81,245
a77ad448-03dd-4f06-8f0d-ef78f4dfc0e7,test-zz,1720147616,1720147727,finished,1720147642,1720147727,A100-SXM4-80GB,8,1,64,896,26,85
a1086ce4-b8a3-4bfe-ae37-21498b199c63,geo-base-offline-eval2,1720147623,1720147796,finished,1720147650,1720147796,A100-SXM4-80GB,8,1,64,448,27,146
248459ae-ef14-4826-99d6-d31e54d1e105,qwen-72b-test,1720147648,1720285085,finished,1720147679,1720285085,A100-SXM4-40GB,8,1,32,320,31,137406
7473b7ad-076c-432e-bdc6-be90add40713,geogpt-lxz-sft-magpie-llama3-pro-2ep-72b,1720147684,1720148017,finished,1720147737,1720148017,A100-SXM4-80GB,8,16,64,448,53,280
e004e0af-fd66-4cc7-b10e-cc45da42f833,qwen7b-tcpt-lr-1e-4-e1-bsz1024-b21b5-auto,1720147696,1720149557,finished,1720147722,1720149557,A100-SXM4-80GB,8,1,64,448,26,1835
7a7af9f7-a7f0-4631-95c0-7e4c0355f673,qwen2-72b-lp84-6bgeo-589e9-auto,1720147715,1720148529,finished,1720147748,1720148529,A100-SXM4-80GB,8,1,64,448,33,781
2701d7b4-1468-4104-8e28-592409f66ada,txchen-train-task,1720147721,1720148266,finished,1720147752,1720148266,A100-SXM4-80GB,8,1,64,448,31,514
68e79764-3ba8-4cd9-be8a-8d70a4a0d30b,qwen7b-tcpt-lr-8e-5-e1-bsz1024-f76c6-auto,1720147779,1720149645,finished,1720147807,1720149645,A100-SXM4-80GB,8,1,64,448,28,1838
86d2ff1e-ea0c-42e5-aab2-c63dc1e31098,qwen1-5-7b-slp40-25bgeo-2ep-59442-auto,1720147801,1720400778,finished,1720147827,1720400778,A100-SXM4-80GB,8,1,64,448,26,252951
f98e143d-fa76-42b2-bbfc-b7519c3a8399,txchen-lm-eval2,1720147807,1720154315,finished,1720147831,1720154315,A100-SXM4-80GB,8,1,64,448,24,6484
c418da57-afad-4360-abb6-4d0873738c17,llama-nodist,1720147842,1720150450,finished,1720147869,1720150450,A100-SXM4-80GB,8,1,64,448,27,2581
809c8bc6-6ca3-4e92-8ad1-881ef92dc9b4,qwen1-5-7b-lp40-s2regate-m-50e18-auto,1720147851,1720158312,finished,1720147877,1720158312,A100-SXM4-80GB,8,1,64,448,26,10435
c9f203ed-82b3-4a98-b63b-79e96165977c,qwen1-5-7b-50bcpt-2ep-986ab-auto,1720147852,1720400778,finished,1720147877,1720400778,A100-SXM4-80GB,8,1,64,448,25,252901
47f370c7-4571-421e-82e6-960e2045d7dc,qwen1-5-7b-7a8e3-auto,1720147878,1720157951,finished,1720147905,1720157951,A100-SXM4-80GB,8,1,64,448,27,10046
419e3381-3b7d-44c5-9e3c-a3a2f448c280,mistral-longtext-ml1wt-bb97c-auto,1720147883,1720149028,finished,1720147911,1720149028,A100-SXM4-80GB,8,1,64,448,28,1117
670d4ea1-d66a-49b9-a87f-d0fb5848db88,qwen1-5-7b-lp40-25bgeo-d3b3d-auto,1720147906,1720158419,finished,1720147929,1720158419,A100-SXM4-80GB,8,1,64,448,23,10490
fb91780d-324e-445a-9069-34efa1439345,Qwen2-72B-271ef-auto,1720147935,1720292980,finished,1720147958,1720292980,A100-SXM4-80GB,8,1,64,448,23,145022
86a1196b-dae9-46bc-9d39-9c9ea679ad50,mistral-CS-mosaic-8cb7b-auto,1720147960,1720149119,finished,1720147981,1720149119,A100-SXM4-80GB,8,1,64,448,21,1138
b2b2c985-e5ed-4f7d-bb8e-fde51091b12a,geo-MoD-1-5B,1720147973,1720148215,finished,1720148040,1720148215,A100-SXM4-80GB,8,2,64,448,67,175
bcc4ccd2-c6d3-4d8a-8a13-84f840cc0e11,mistral-base-sft3epo-096e7-auto,1720148050,1720149187,finished,1720148075,1720149187,A100-SXM4-80GB,8,1,64,448,25,1112
82bf47b8-8896-4dd7-8a94-aabbdf759072,geogpt-lxz-sft-magpie-llama3-pro-2ep-72b,1720148088,1720148431,finished,1720148150,1720148431,A100-SXM4-80GB,8,16,64,448,62,281
f5a1545d-c372-4bbb-a9c6-a6bb2c53e5b3,mistral-longtext-ml1wt-96cd6-auto,1720148138,1720152681,finished,1720148164,1720152681,A100-SXM4-80GB,8,1,64,448,26,4517
cfa004a0-cf4c-4ba3-994e-7bf6feeb4a75,llama2-longtext-ml1wt-2e82d-auto,1720148245,1720173948,finished,1720148266,1720173948,A100-SXM4-80GB,8,1,64,448,21,25682
98c903b8-ada3-437b-b39f-0c04fd48c683,geo-MoD-1-5B,1720148363,1720148622,finished,1720148408,1720148622,A100-SXM4-80GB,8,2,64,448,45,214
503c042b-701e-4f70-b8f9-16a368e84c55,geogpt-lxz-sft-magpie-llama3-pro-2ep-72b,1720148502,1720148851,finished,1720148572,1720148851,A100-SXM4-80GB,8,16,64,448,70,279
ea5b2346-94b6-4dd5-a409-d0cb53ee4e6b,qwen2-72B-accda-auto,1720148553,1720148763,finished,1720148582,1720148763,A100-SXM4-80GB,8,1,64,448,29,181
feb08df0-6c8d-4a59-8b8e-da07d040ff28,geo-MoD-1-5B,1720148759,1720148992,finished,1720148825,1720148992,A100-SXM4-80GB,8,2,64,448,66,167
2abbca40-968d-4223-978c-4b2afcc50192,qwen2-72B-accda-auto,1720148830,1720195663,finished,1720148855,1720195663,A100-SXM4-80GB,8,1,64,448,25,46808
48b83cc6-92e6-4da3-9fe0-b8e93003c98b,geogpt-lxz-sft-magpie-llama3-pro-2ep-72b,1720148926,1720149267,finished,1720148993,1720149267,A100-SXM4-80GB,8,16,64,448,67,274
9ebf3e28-cd29-4624-a6f8-cde0a7a0272f,geo-MoD-1-5B,1720149132,1720149404,finished,1720149200,1720149404,A100-SXM4-80GB,8,2,64,448,68,204
f45f0de5-cde7-4068-b98d-bb0a19723392,opencompass-eval-0705,1720149172,1720149453,finished,1720149195,1720149453,A100-SXM4-80GB,8,1,64,896,23,258
7c4ec9d6-6e2f-4e06-8ed4-b8d39285504a,geogpt-lxz-sft-magpie-llama3-pro-2ep-72b,1720149338,1720149682,finished,1720149406,1720149682,A100-SXM4-80GB,8,16,64,448,68,276
7316ed92-cfa6-4bb3-8dbf-fd9275419913,geo-base-offline-eval2,1720149358,1720149770,finished,1720149380,1720149770,A100-SXM4-80GB,8,1,64,448,22,390
f9b83c03-8f4c-4623-b078-28e8c4dd360e,opencompass-eval-0705,1720149375,1720149717,finished,1720149397,1720149717,A100-SXM4-80GB,8,1,64,896,22,320
91ceae30-23c1-4017-9218-b7a4457ad6e2,opencompass-eval-0705,1720149430,1720164982,finished,1720149453,1720164982,A100-SXM4-80GB,8,1,64,896,23,15529
ded0e615-b34d-428f-9004-53fec370d4af,opencompass-eval-0705,1720149453,1720154044,finished,1720149477,1720154044,A100-SXM4-80GB,8,1,64,896,24,4567
a342e40d-3966-47bb-96a3-8a581748a1c7,geo-MoD-1-5B,1720149549,1720149812,finished,1720149615,1720149812,A100-SXM4-80GB,8,2,64,448,66,197
4e884a7b-881e-4774-bba9-9abb984b9825,opencompass-eval-0705,1720149674,1720159640,finished,1720149696,1720159640,A100-SXM4-80GB,8,1,64,896,22,9944
601ea540-a085-40dd-9106-567f50fa5679,opencompass-eval-0705,1720149717,1720164046,finished,1720149744,1720164046,A100-SXM4-80GB,8,1,64,896,27,14302
165b5105-96b2-4151-8a00-719f6e5d29de,geogpt-lxz-sft-magpie-llama3-pro-2ep-72b,1720149751,1720150101,finished,1720149813,1720150101,A100-SXM4-80GB,8,16,64,448,62,288
28eb67ac-447a-4bb1-ab97-5e8cf5fb1e95,geogpt-sft-qwen2-72b-datav081-ep1,1720149860,1720244748,finished,1720149887,1720244748,A100-SXM4-80GB,8,1,64,448,27,94861
caf756a2-5d9d-4c41-b6b1-81f55cbf4dc6,geogpt-sft-qwen2-72b-datav08-ep1,1720149887,1720150988,finished,1720149909,1720150988,A100-SXM4-80GB,8,1,64,448,22,1079
0f182016-c567-49e9-bf7b-7599af4a3cc4,geo-base-offline-eval2,1720149888,1720150301,finished,1720149909,1720150301,A100-SXM4-80GB,8,1,64,448,21,392
d62a13c6-bf8f-4c55-9ffa-fa3ebbe115b5,sql-spider-qy-0704-qwen,1720149930,1720151320,finished,1720149951,1720151320,A100-SXM4-80GB,8,1,64,448,21,1369
cee034e6-6578-4e64-9a60-039eede86c1b,geo-MoD-1-5B,1720149952,1720150189,finished,1720150013,1720150189,A100-SXM4-80GB,8,2,64,448,61,176
93e6b2d8-5a5d-4920-9f19-3c195369acc8,geogpt-ultrafuser-direct-eval,1720150037,1720170270,finished,1720150057,1720170270,A100-SXM4-80GB,8,1,64,448,20,20213
0ddbacc7-dd3b-4a9d-84eb-a39c50b913a6,mixtral-8x22b-10bcpt-1ep-13e37-auto,1720150079,1720203067,finished,1720150101,1720203067,A100-SXM4-80GB,8,1,64,448,22,52966
39d8c32a-8437-43ae-9f11-d2b487e89449,geogpt-lxz-sft-magpie-llama3-pro-2ep-72b,1720150168,1720150697,finished,1720150233,1720150697,A100-SXM4-80GB,8,16,64,448,65,464
7ffe2905-1f7f-4a03-9874-4f70b9fcaf33,geo-MoD-1-5B,1720150345,1720150585,finished,1720150388,1720150585,A100-SXM4-80GB,8,2,64,448,43,197
0884ae1a-bd37-42de-a19b-1b5926038afd,qwen2-72b-lp84-6bgeo-589e9-auto,1720150479,1720367128,finished,1720150502,1720367128,A100-SXM4-80GB,8,1,64,448,23,216626
54eecae7-2bea-4fe3-bb0a-ef3da83b530b,geo-llamapro-1-5B,1720150585,1720188537,finished,1720150628,1720188537,A100-SXM4-80GB,8,4,64,448,43,37909
43f246d8-5603-4270-a048-ed203a60afbb,geo-MoD-1-5B,1720150696,1720150946,finished,1720150766,1720150946,A100-SXM4-80GB,8,2,64,448,70,180
7e4180fc-a95b-4198-b667-29a2d1b8bd7b,geogpt-lxz-sft-magpie-llama3-pro-2ep-72b,1720150768,1720151097,finished,1720150833,1720151097,A100-SXM4-80GB,8,16,64,448,65,264
c1a1b779-335b-4d2f-81f3-cba58d9fd657,qwen-72b-test,1720150945,1720151482,finished,1720150967,1720151482,A100-SXM4-80GB,8,1,64,448,22,515
4b0e7d84-9e5d-4f46-8ad8-b70db4560e07,geo-MoD-1-5B,1720151075,1720151321,finished,1720151139,1720151321,A100-SXM4-80GB,8,2,64,448,64,182
102140d1-8d3a-427e-bf00-d21d9996346e,geogpt-sft-qwen2-72b-datav08-ep1,1720151116,1720161668,finished,1720151138,1720161668,A100-SXM4-80GB,8,1,64,448,22,10530
369386cf-e0f8-4ff6-bf4f-f25195c52a8a,geogpt-lxz-sft-magpie-llama3-pro-2ep-72b,1720151166,1720151485,finished,1720151209,1720151485,A100-SXM4-80GB,8,16,64,448,43,276
4f269ea7-176a-47a4-8c38-58facb111b07,qwen2-72b-instruct-judge,1720151446,1720403739,finished,1720151470,1720403739,A100-SXM4-40GB,8,1,32,320,24,252269
c06c4462-a5e3-470f-ae27-418502806572,geo-MoD-1-5B,1720151461,1720151697,finished,1720151504,1720151697,A100-SXM4-80GB,8,2,64,448,43,193
61481c82-a61d-4eac-9886-de45b9c04179,geogpt-72b-lp84-gate-10bcpt-2ep-eval2,1720151513,1720277916,finished,1720151537,1720277916,A100-SXM4-80GB,8,1,64,448,24,126379
cbc8f246-11e6-4c09-a26b-cb092714cfce,geogpt-72b-lp84-gate-10bcpt-2ep-eval,1720151537,1720213861,finished,1720151563,1720213861,A100-SXM4-80GB,8,1,64,448,26,62298
5be1c5f0-556b-4035-bc6d-fa546d6112a2,geogpt-72b-lp84-gate-10bcpt-2ep-eval3,1720151538,1720164430,finished,1720151563,1720164430,A100-SXM4-80GB,8,1,64,448,25,12867
468ca24e-16f9-4744-a003-92b873614458,geogpt-72b-lp84-gate-10bcpt-2ep-eval3,1720151539,1720154266,finished,1720151564,1720154266,A100-SXM4-80GB,8,1,64,448,25,2702
72720bcb-bd8b-4144-a3bb-b08a94357950,geogpt-lxz-sft-magpie-llama3-pro-2ep-72b,1720151560,1720152014,finished,1720151608,1720152014,A100-SXM4-80GB,8,16,64,448,48,406
2d7a1ace-f52e-44bf-9bc7-bec025b8dca0,geogpt-72b-lp84-gate-10bcpt-2ep-eval4,1720151566,1720287630,finished,1720151588,1720287630,A100-SXM4-80GB,8,1,64,448,22,136042
559effb8-f86a-4c41-bc58-2e140fc787a7,qwen-72b-test,1720151604,1720158836,finished,1720151633,1720158836,A100-SXM4-80GB,8,1,64,448,29,7203
68b942b1-52a2-4b1b-8bd7-a566cdcae91e,geo-seesaw-sft-code-alpaca-ultra-eval-test,1720151762,1720257153,finished,1720151783,1720257153,A100-SXM4-80GB,8,1,64,896,21,105370
91d756e9-e455-4795-ac3c-c7a97e6d75e4,geo-MoD-1-5B,1720151825,1720152108,finished,1720151886,1720152108,A100-SXM4-80GB,8,2,64,448,61,222
5a5be496-08d6-4aff-8eb2-f7249bd3e6ad,geogpt-qwen2-chat-0612dpo-linear-w55,1720152015,1720325298,finished,1720152039,1720325298,A100-SXM4-80GB,8,1,64,448,24,173259
9a7bac58-c09f-4ebb-ae0a-1772e400781b,lzk-qwen15-7b-scihub-abstract-homework-cpt,1720152024,1720152594,finished,1720152047,1720152594,A100-SXM4-80GB,8,1,64,448,23,547
66b94d1a-2cb2-43f8-8e20-3787f3ffd345,geogpt-lxz-sft-magpie-llama3-pro-2ep-72b,1720152087,1720152422,finished,1720152151,1720152422,A100-SXM4-80GB,8,16,64,448,64,271
578ea877-d205-4e3b-a653-df60b10b284d,geo-MoD-1-5B,1720152263,1720152512,finished,1720152329,1720152512,A100-SXM4-80GB,8,2,64,448,66,183
fed20ea1-6dee-44c5-9842-da8225afc16c,llama3-8b-sft32k,1720152324,1720152690,finished,1720152371,1720152690,A100-SXM4-80GB,8,4,64,448,47,319
72047cef-abf0-4c2e-a192-d83a8d2db0e0,qwen7b-tscpt-lr-1e-4-e2-82ce7-auto,1720152340,1720154313,finished,1720152362,1720154313,A100-SXM4-80GB,8,1,64,448,22,1951
ef103831-1b3a-4c03-8973-299ad3f7775e,qwen7b-tscpt-lr-1e-4-e1-767de-auto,1720152407,1720154314,finished,1720152430,1720154314,A100-SXM4-80GB,8,1,64,448,23,1884
f86f675e-cafe-48f9-9ab3-f49cc84f6f15,geogpt-lxz-sft-magpie-llama3-pro-2ep-72b,1720152492,1720152807,finished,1720152536,1720152807,A100-SXM4-80GB,8,16,64,448,44,271
3e422baa-d3c5-431c-9194-5befbf48f0e4,geo-MoD-1-5B,1720152629,1720152894,finished,1720152694,1720152894,A100-SXM4-80GB,8,2,64,448,65,200
07fdf765-057f-4860-96bb-ff16c6f6efac,lzk-qwen15-7b-scihub-abstract-homework-cpt,1720152748,1720180197,finished,1720152768,1720180197,A100-SXM4-80GB,8,1,64,448,20,27429
ad4d8020-c231-447c-93f1-0169024b9f6b,Mixtral-8x7B-Instruct-shumo,1720152805,1720153275,finished,1720152827,1720153275,A100-SXM4-80GB,8,1,64,448,22,448
320c4db1-28cd-462e-835c-454c0e08318d,geogpt-lxz-sft-magpie-llama3-pro-2ep-72b,1720152874,1720153185,finished,1720152917,1720153185,A100-SXM4-80GB,8,16,64,448,43,268
30f55598-a446-4822-9ed5-3b10daa4f4fe,geo-MoD-1-5B,1720153011,1720153274,finished,1720153078,1720153274,A100-SXM4-80GB,8,2,64,448,67,196
13d55fc9-9868-47d7-8f08-56f762708611,txchen-cpu-task,1720153086,1720155278,finished,1720153108,1720155278,A100-SXM4-80GB,8,1,64,448,22,2170
f85fc714-bfed-4de9-8373-c77e4d998e82,geogpt-lxz-sft-magpie-llama3-pro-2ep-72b,1720153254,1720153593,finished,1720153322,1720153593,A100-SXM4-80GB,8,16,64,448,68,271
57496b26-cc63-41e0-ac8b-d10b266b00e7,Mixtral-8x7B-Instruct-shumo,1720153395,1720240445,finished,1720153419,1720240445,A100-SXM4-80GB,8,1,64,448,24,87026
e48b830c-1e7b-4a94-865e-3022aa7579d5,geo-MoD-1-5B,1720153417,1720153662,finished,1720153464,1720153662,A100-SXM4-80GB,8,2,64,448,47,198
57b05e56-bd00-4b56-9130-a76c3dd33c85,geogpt-prompt-tuning-tg-infer1,1720153449,1720153921,finished,1720153472,1720153921,A100-SXM4-80GB,8,1,64,448,23,449
1e950b67-87e5-4a35-b74b-7e9986201dca,geogpt-lxz-sft-magpie-llama3-pro-2ep-72b,1720153664,1720154003,finished,1720153730,1720154003,A100-SXM4-80GB,8,16,64,448,66,273
cfb7bb71-c77d-4312-8a6d-0af6dba9e297,geo-MoD-1-5B,1720153802,1720154050,finished,1720153869,1720154050,A100-SXM4-80GB,8,2,64,448,67,181
6e273301-69c6-4588-813e-460cbb133353,geogpt-prompt-tuning-tg-infer1,1720154010,1720154402,finished,1720154036,1720154402,A100-SXM4-80GB,8,1,64,448,26,366
b760c44d-bd4b-4be2-be28-01bad7bc9d6e,txchen-train-task,1720154013,1720155353,finished,1720154086,1720155353,A100-SXM4-80GB,8,2,64,448,73,1267
ef2f2883-418c-45df-8dac-c707964ec7de,llama-nodist,1720154024,1720154215,finished,1720154047,1720154215,A100-SXM4-80GB,8,1,64,448,23,168
adf9ade0-feb9-47b2-b388-deead756f0ae,geogpt-lxz-sft-magpie-llama3-pro-2ep-72b,1720154078,1720154417,finished,1720154146,1720154417,A100-SXM4-80GB,8,16,64,448,68,271
8be910fc-fef9-4e5f-8ec7-c8794857a9fb,geo-MoD-1-5B,1720154195,1720154437,finished,1720154261,1720154437,A100-SXM4-80GB,8,2,64,448,66,176
733d294f-6ea7-4fe5-af7e-1e4769dfc368,geogpt-lxz-sft-magpie-llama3-pro-2ep-72b,1720154487,1720154794,finished,1720154531,1720154794,A100-SXM4-80GB,8,16,64,448,44,263
6e127575-7f1d-4317-b92c-ce189e87bc3a,geo-MoD-1-5B,1720154557,1720154772,finished,1720154619,1720154772,A100-SXM4-80GB,8,2,64,448,62,153
a40b18fb-efef-409b-96f9-e237924c88e2,sql-spider-qy-0704-qwen,1720154705,1720154836,finished,1720154727,1720154836,A100-SXM4-80GB,8,1,64,448,22,109
343cb3e7-468f-4ef4-837c-75cf780fe056,geo-base-diff-check,1720154729,1720154981,finished,1720154771,1720154981,A100-SXM4-80GB,8,2,64,448,42,210
0015740b-0b82-4ab3-83e5-e6c4d01c3566,geogpt-lxz-sft-magpie-llama3-pro-2ep-72b,1720154865,1720155219,finished,1720154911,1720155219,A100-SXM4-80GB,8,16,64,448,46,308
c92f3c9f-aeec-472d-947a-a2ab704ab004,geo-MoD-1-5B,1720154908,1720155131,finished,1720154959,1720155131,A100-SXM4-80GB,8,2,64,448,51,172
fd60a29d-b2d2-40a9-9799-994e53878119,sql-spider-qy-0704-qwen,1720154936,1720155067,finished,1720154958,1720155067,A100-SXM4-80GB,8,1,64,448,22,109
39da2466-3e3f-4959-95d3-7860954dcae2,geo-MoD-1-5B,1720155263,1720155492,finished,1720155337,1720155492,A100-SXM4-80GB,8,2,64,448,74,155
9febb23b-a35f-43bb-b585-e3e5ce8e8de8,txchen-cpu-task,1720155278,1720174705,finished,1720155324,1720174705,A100-SXM4-80GB,8,2,64,448,46,19381
dc2ba136-ecd3-49fa-9257-d98b1b714dfd,geogpt-lxz-sft-magpie-llama3-pro-2ep-72b,1720155293,1720155605,finished,1720155339,1720155605,A100-SXM4-80GB,8,16,64,448,46,266
d2448e8a-0ee2-4661-8b89-b2c8ead17dde,sql-spider-qy-0704-qwen,1720155314,1720155449,finished,1720155336,1720155449,A100-SXM4-80GB,8,1,64,448,22,113
44b76a07-d1d5-435e-ba46-f6512b146c4a,sql-spider-qy-0704-qwen,1720155557,1720155964,finished,1720155578,1720155964,A100-SXM4-80GB,8,1,64,448,21,386
2cf7ea85-ba2c-45d5-8c6f-a80d9b98358e,geo-MoD-1-5B,1720155602,1720155832,finished,1720155648,1720155832,A100-SXM4-80GB,8,2,64,448,46,184
618944d8-50c5-4e26-92bd-ba69275cbbde,geo-base-offline-eval,1720155625,1720165269,finished,1720155647,1720165269,A100-SXM4-80GB,8,1,64,448,22,9622
c5055cf5-1b48-47bc-a710-1226cf884e5c,geogpt-lxz-sft-magpie-llama3-pro-2ep-72b,1720155676,1720156010,finished,1720155738,1720156010,A100-SXM4-80GB,8,16,64,448,62,272
5913528b-158b-4822-b3f8-6271fdab4d3e,txchen-lm-eval2,1720155862,1720155996,finished,1720155885,1720155996,A100-SXM4-80GB,8,1,64,448,23,111
04cea553-d1c9-407d-84e8-51ec13ce4185,geo-MoD-1-5B,1720155943,1720156196,finished,1720156009,1720156196,A100-SXM4-80GB,8,2,64,448,66,187
342f76df-e213-4c71-abe7-9953c364f5c1,sql-spider-qy-0704-qwen,1720155964,1720157067,finished,1720155986,1720157067,A100-SXM4-80GB,8,1,64,448,22,1081
28f119f3-7c44-46ad-b6fd-50a01a1a2be5,geogpt-lxz-sft-magpie-llama3-pro-2ep-72b,1720156080,1720156421,finished,1720156146,1720156421,A100-SXM4-80GB,8,16,64,448,66,275
2a00ba0c-c908-4736-bc31-45d8915ccf08,geogpt-sft-common-mix-v2-llama3-8b,1720156125,1720253572,finished,1720156175,1720253572,A100-SXM4-80GB,8,4,64,448,50,97397
342d93c5-32a2-4bc8-909b-bef268e5c9e8,txchen-train-task,1720156274,1720168779,finished,1720156342,1720168779,A100-SXM4-80GB,8,2,64,448,68,12437
8e5edccd-8e07-4975-86d3-76d5e2c8ca23,geo-MoD-1-5B,1720156332,1720156582,finished,1720156398,1720156582,A100-SXM4-80GB,8,2,64,448,66,184
bcfc6b91-48ad-4109-b9a4-81021d39a7b7,geogpt-lxz-sft-magpie-llama3-pro-2ep-72b,1720156490,1720156822,finished,1720156556,1720156822,A100-SXM4-80GB,8,16,64,448,66,266
75abd290-2bf4-4650-9935-0c6bdab15c4e,mistral-longtext-ml1wt-v2-33353-auto,1720156520,1720161096,finished,1720156541,1720161096,A100-SXM4-80GB,8,1,64,448,21,4555
2526ae71-0ef1-4b90-8af1-6f60efe70694,llama3-8b-sft32k,1720156599,1720156794,finished,1720156621,1720156794,A100-SXM4-80GB,8,1,64,448,22,173
23e8bb83-75c6-447f-acdd-61ebef106275,geo-MoD-1-5B,1720156711,1720156932,finished,1720156754,1720156932,A100-SXM4-80GB,8,2,64,448,43,178
8a6b7004-9921-4278-a898-f11a54a5b137,geogpt-lxz-sft-magpie-llama3-pro-2ep-72b,1720156891,1720157267,finished,1720156977,1720157267,A100-SXM4-80GB,8,16,64,448,86,290
7bdc96ee-0ca0-4f6a-b2d0-325cee961b62,geo-MoD-1-5B,1720157068,1720157310,finished,1720157132,1720157310,A100-SXM4-80GB,8,2,64,448,64,178
e3ecec2e-c6d6-42f5-8aef-920ee8483264,sql-spider-qy-0704-qwen,1720157176,1720157309,finished,1720157199,1720157309,A100-SXM4-80GB,8,1,64,448,23,110
81a53316-00ed-4b92-8252-1c7b6d1b6d97,llama3-8b-sft32k,1720157283,1720159208,finished,1720157306,1720159208,A100-SXM4-80GB,8,1,64,448,23,1902
2497731d-6437-482b-b4eb-60b4d2f0701f,sql-spider-qy-0704-qwen,1720157309,1720157454,finished,1720157337,1720157454,A100-SXM4-80GB,8,1,64,448,28,117
2de19b2e-a776-42b9-b58e-66d2ff38fea2,geogpt-lxz-sft-magpie-llama3-pro-2ep-72b,1720157340,1720157652,finished,1720157385,1720157652,A100-SXM4-80GB,8,16,64,448,45,267
3eef1714-9b63-4380-8e4f-17a70c913bd0,geo-MoD-1-5B,1720157455,1720157694,finished,1720157521,1720157694,A100-SXM4-80GB,8,2,64,448,66,173
7037bbb1-48d1-4452-9335-edbec18e7d73,sql-spider-qy-0704-qwen,1720157627,1720157766,finished,1720157649,1720157766,A100-SXM4-80GB,8,1,64,448,22,117
41a9f9e5-87d1-4eaf-851e-308da005a3bd,geogpt-lxz-sft-magpie-llama3-pro-2ep-72b,1720157721,1720158041,finished,1720157769,1720158041,A100-SXM4-80GB,8,16,64,448,48,272
51cc6c73-619a-4b44-b365-4168c13541e6,sql-spider-qy-0704-qwen,1720157766,1720158857,finished,1720157795,1720158857,A100-SXM4-80GB,8,1,64,448,29,1062
d0df1abc-701a-4372-8620-e0b8a2f5fdc3,geo-MoD-1-5B,1720157839,1720158061,finished,1720157902,1720158061,A100-SXM4-80GB,8,2,64,448,63,159
04fa481b-c23f-482b-b91a-0a741c8e9383,mistral-longtext-ml1wt-v2-d9812-auto,1720157958,1720159131,finished,1720157984,1720159131,A100-SXM4-80GB,8,1,64,448,26,1147
d1374711-4061-4df9-9858-40e2a71c0137,mistral-CS-mosaic-v2-2933c-auto,1720157960,1720159090,finished,1720157984,1720159090,A100-SXM4-80GB,8,1,64,448,24,1106
d4fe266c-4a18-4647-a3d9-ce83596c0880,mistral-base-sft3epo-v2-580dc-auto,1720157962,1720159198,finished,1720158027,1720159198,A100-SXM4-80GB,8,1,64,448,65,1171
7dffd784-8f2d-44b9-9fed-e572ceb7dbdc,opencompass-eval-0705,1720157969,1720159755,finished,1720157991,1720159755,A100-SXM4-80GB,8,1,64,896,22,1764
4f46fac2-ae1d-4fff-ae6f-20887488162a,debug,1720157994,1720170350,finished,1720158080,1720170350,A100-SXM4-80GB,8,2,64,896,86,12270
e7eff815-c1de-4049-8243-71320de8d02b,geogpt-lxz-sft-magpie-llama3-pro-2ep-72b,1720158113,1720158459,finished,1720158175,1720158459,A100-SXM4-80GB,8,16,64,448,62,284
452119c4-6f9a-4c12-a940-d21eb86be1c9,geo-MoD-1-5B,1720158202,1720158686,finished,1720158479,1720158686,A100-SXM4-80GB,8,2,64,448,277,207
7c1600ff-be51-4bcb-a693-2c3021b21174,geogpt-lxz-sft-magpie-llama3-pro-2ep-72b,1720158529,1720158880,finished,1720158594,1720158880,A100-SXM4-80GB,8,16,64,448,65,286
4ef328a6-3fbf-4558-8de1-909ca0fc52f9,geo-MoD-1-5B,1720158795,1720159040,finished,1720158858,1720159040,A100-SXM4-80GB,8,2,64,448,63,182
44dbab03-94c7-4be0-a645-aee4a6ec5af7,qwen-72b-test,1720158899,1720284690,finished,1720158920,1720284690,A100-SXM4-80GB,8,1,64,448,21,125770
0f72bff9-9b14-4478-ae47-1f981c2704dc,geogpt-lxz-sft-magpie-llama3-pro-2ep-72b,1720158949,1720159258,finished,1720158993,1720159258,A100-SXM4-80GB,8,16,64,448,44,265
3d924ceb-cd30-4fd5-9654-36f73e9e5d84,geo-MoD-1-5B,1720159167,1720159437,finished,1720159235,1720159437,A100-SXM4-80GB,8,2,64,448,68,202
6499fb43-d97c-41c8-ac9c-864aa4571ff4,llama3-8b-sft32k,1720159208,1720160952,finished,1720159230,1720160952,A100-SXM4-80GB,8,1,64,448,22,1722
a9d6fed0-fc66-4280-a015-9a9cecc41b93,qwen1-14B,1720159232,1720160296,finished,1720159296,1720160296,A100-SXM4-80GB,8,2,64,896,64,1000
b8283fc8-0ff4-40c2-9ac4-a69587460d8c,llama-factory-long,1720159295,1720159515,finished,1720159344,1720159515,A100-SXM4-80GB,8,2,64,448,49,171
85adc766-13f1-49c8-9636-91d04b7fe660,geogpt-lxz-sft-magpie-llama3-pro-2ep-72b,1720159329,1720159672,finished,1720159391,1720159672,A100-SXM4-80GB,8,16,64,448,62,281
e264e47f-1495-4291-a652-c8a37b6d7d12,geo-MoD-1-5B,1720159561,1720159809,finished,1720159625,1720159809,A100-SXM4-80GB,8,2,64,448,64,184
4e4258ad-75c5-450c-a7d5-3aed094a053e,txchen-lm-eval2,1720159679,1720160285,finished,1720159699,1720160285,A100-SXM4-80GB,8,1,64,448,20,586
e59a5447-7b1b-455a-81ae-42b85193906a,geogpt-lxz-sft-magpie-llama3-pro-2ep-72b,1720159742,1720160058,finished,1720159783,1720160058,A100-SXM4-80GB,8,16,64,448,41,275
c96980f9-2222-4173-9ce1-fb24990bd10a,geo-MoD-1-5B,1720159933,1720160143,finished,1720159975,1720160143,A100-SXM4-80GB,8,2,64,448,42,168
0affa507-f1e2-45ae-bc5d-9988262c8d8a,opencompass-eval-0705,1720160030,1720175405,finished,1720160050,1720175405,A100-SXM4-80GB,8,1,64,896,20,15355
d216fc39-933b-44f7-9f5a-1b668861b552,geogpt-lxz-sft-magpie-llama3-pro-2ep-72b,1720160124,1720160447,finished,1720160186,1720160447,A100-SXM4-80GB,8,16,64,448,62,261
f6ed2270-a885-41b8-9d4b-dd4912518328,geo-MoD-1-5B,1720160277,1720160534,finished,1720160342,1720160534,A100-SXM4-80GB,8,2,64,448,65,192
ba97c879-3b0d-4bd2-b267-5040af24d6cd,txchen-lm-eval2,1720160285,1720161434,finished,1720160307,1720161434,A100-SXM4-80GB,8,1,64,448,22,1127
8fa728c0-1953-434e-94e2-85136bd1adfb,geogpt-lxz-sft-magpie-llama3-pro-2ep-72b,1720160515,1720160850,finished,1720160577,1720160850,A100-SXM4-80GB,8,16,64,448,62,273
3ff9fe59-7983-4ef6-9f44-fd2125bfa10d,geo-MoD-1-5B,1720160666,1720160913,finished,1720160727,1720160913,A100-SXM4-80GB,8,2,64,448,61,186
f236e9b6-44cf-4da7-93ef-d05e112d5940,geogpt-lxz-sft-magpie-llama3-pro-2ep-72b,1720160915,1720161250,finished,1720160978,1720161250,A100-SXM4-80GB,8,16,64,448,63,272
1ab75378-05d0-4c6c-a2e1-b4e3050110d4,llama3-8b-sft32k,1720160952,1720170695,finished,1720160973,1720170695,A100-SXM4-80GB,8,1,64,448,21,9722
c42e03b7-5062-452f-94e1-a7ea62539155,geo-MoD-1-5B,1720161027,1720161249,finished,1720161069,1720161249,A100-SXM4-80GB,8,2,64,448,42,180
bbe674fa-ba11-4c57-aa2b-7fcc05c8aa76,geogpt-lxz-sft-magpie-llama3-pro-2ep-72b,1720161317,1720161648,finished,1720161379,1720161648,A100-SXM4-80GB,8,16,64,448,62,269
68b88052-bac1-4480-b0b9-92f04641fb90,geo-MoD-1-5B,1720161377,1720161605,finished,1720161446,1720161605,A100-SXM4-80GB,8,2,64,448,69,159
332a756a-d556-49de-a499-141e2aab6c01,qwen1-5-14B-base-fb2e4-auto,1720161658,1720162319,finished,1720161678,1720162319,A100-SXM4-80GB,8,1,64,448,20,641
2bc73339-6db6-4762-a124-57266de0de59,geogpt-lxz-sft-magpie-llama3-pro-2ep-72b,1720161716,1720162052,finished,1720161780,1720162052,A100-SXM4-80GB,8,16,64,448,64,272
7f0efc1f-ebf0-4288-9d28-d62c4cf08c06,qwen2-72b-chat,1720161734,1720162691,finished,1720161756,1720162691,A100-SXM4-40GB,8,1,32,320,22,935
2045a6e2-ab7e-4562-a8f4-df3ef85a9eab,geo-MoD-1-5B,1720161757,1720161986,finished,1720161825,1720161986,A100-SXM4-80GB,8,2,64,448,68,161
e215b867-fb70-415b-abd6-9a2369ee10ff,geogpt-sft-qwen2-72b-datav08-ep1,1720161824,1720163793,finished,1720161846,1720163793,A100-SXM4-80GB,8,1,64,448,22,1947
92aa87ac-b0f6-4f66-a031-3769099646cc,llama-multi,1720162004,1720163895,finished,1720162048,1720163895,A100-SXM4-80GB,8,2,64,448,44,1847
c9594ee5-d8e8-4e3f-8e81-870686d770d9,geo-MoD-1-5B,1720162093,1720162350,finished,1720162141,1720162350,A100-SXM4-80GB,8,2,64,448,48,209
ccc66aad-be0e-43d5-aa6a-90ed4352310f,geogpt-lxz-sft-magpie-llama3-pro-2ep-72b,1720162121,1720162455,finished,1720162183,1720162455,A100-SXM4-80GB,8,16,64,448,62,272
3b2536fe-09c2-456c-b90c-ffe6ae5d1726,rag-rank,1720162448,1720162581,finished,1720162470,1720162581,A100-SXM4-80GB,8,1,64,448,22,111
3868e442-8836-4f49-836c-9b81b21c8e6c,geo-MoD-1-5B,1720162474,1720162652,finished,1720162521,1720162652,A100-SXM4-80GB,8,2,64,448,47,131
d768bb5b-c60f-421e-8c27-23d725e4f337,geogpt-lxz-sft-magpie-llama3-pro-2ep-72b,1720162521,1720162859,finished,1720162587,1720162859,A100-SXM4-80GB,8,16,64,448,66,272
881e77be-93c3-42ab-9679-f27c012b50fb,sql-spider-qy-0704-qwen,1720162714,1720163920,finished,1720162734,1720163920,A100-SXM4-80GB,8,1,64,448,20,1186
53183473-e59e-46e5-a196-df2b29105c84,geo-MoD-1-5B,1720162757,1720162985,finished,1720162818,1720162985,A100-SXM4-80GB,8,2,64,448,61,167
8eae0168-f9ef-4d3e-ad5d-aa0863adc6a6,geogpt-lxz-sft-magpie-llama3-pro-2ep-72b,1720162926,1720163263,finished,1720162986,1720163263,A100-SXM4-80GB,8,16,64,448,60,277
ac59c655-a375-46ae-8c45-9a497078ed48,geogpt-gate-base-common-2,1720163059,1720172329,finished,1720163082,1720172329,A100-SXM4-80GB,8,1,64,448,23,9247
0d1b0445-1459-4b29-a574-d4dc7f0a1123,geo-MoD-1-5B,1720163099,1720163203,finished,1720163141,1720163203,A100-SXM4-80GB,8,2,64,448,42,62
de4bba86-71b0-4575-82ea-bfb3b0ef8b7d,geogpt-gate-base-val-common,1720163104,1720172376,finished,1720163125,1720172376,A100-SXM4-80GB,8,1,64,448,21,9251
3ff5a92a-04a3-4a42-aa96-225320abd8a9,geogpt-lxz-sft-magpie-llama3-pro-2ep-72b,1720163329,1720163642,finished,1720163368,1720163642,A100-SXM4-80GB,8,16,64,448,39,274
ee543fce-e54f-4301-9ca5-57f084876235,qwen1-14B,1720163495,1720164209,finished,1720163558,1720164209,A100-SXM4-80GB,8,2,64,896,63,651
f7320368-f2bf-438e-af5f-392ef7e12f94,geo-MoD-1-5B,1720163500,1720400670,finished,1720163561,1720400670,A100-SXM4-80GB,8,2,64,448,61,237109
f212de47-94ed-48b8-8760-13d0bc2bc966,geogpt-lxz-sft-magpie-llama3-pro-2ep-72b,1720163708,1720164173,finished,1720163749,1720164173,A100-SXM4-80GB,8,16,64,448,41,424
47589d34-da5d-4902-bd09-8a4852587de6,geo-72B,1720163898,1720169300,finished,1720163966,1720169300,A100-SXM4-80GB,8,16,64,896,68,5334
426188c4-2776-4e2c-8682-1d08467db817,llama-multi,1720163961,1720164276,finished,1720164010,1720164276,A100-SXM4-80GB,8,2,64,448,49,266
afc28fb9-73e2-4a6f-8786-d4527d4c7419,geogpt-sft-qwen2-72b-datav08-ep1,1720163965,1720170110,finished,1720163992,1720170110,A100-SXM4-80GB,8,1,64,448,27,6118
63038983-5d8a-4d1d-9eda-53294541445a,geogpt-lxz-sft-magpie-llama3-pro-2ep-72b,1720164239,1720164731,finished,1720164301,1720164731,A100-SXM4-80GB,8,16,64,448,62,430
578d78a0-e0d7-44e8-bbd1-939ad8c67324,mixtral-sft-test,1720164468,1720164610,finished,1720164489,1720164610,A100-SXM4-80GB,8,1,64,896,21,121
20dd69bf-14ed-4ea1-8b1a-be4b26ad2704,llama-multi,1720164545,1720166068,finished,1720164585,1720166068,A100-SXM4-80GB,8,2,64,448,40,1483
4b381f00-2d9b-4cc3-815f-77d1c54c52a6,geogpt-lxz-sft-magpie-llama3-pro-2ep-72b,1720164797,1720165271,finished,1720164840,1720165271,A100-SXM4-80GB,8,16,64,448,43,431
fcd1eab0-c50f-4514-9056-2f86a2a9b6f5,sql-spider-qy-0704-qwen,1720164837,1720166091,finished,1720164866,1720166091,A100-SXM4-80GB,8,1,64,448,29,1225
75f5d4f7-382b-4237-89d3-31f6c24f4bd1,mixtral-sft-test,1720164869,1720164989,finished,1720164889,1720164989,A100-SXM4-80GB,8,1,64,896,20,100
89189fcc-6cb6-47f3-bf92-1076326366f5,geogpt-eval-deductive,1720165091,1720166585,finished,1720165112,1720166585,A100-SXM4-80GB,8,1,64,896,21,1473
95c59e6a-3fc4-4fb7-8025-54457e2c7b6a,mixtral-sft-test,1720165151,1720165271,finished,1720165170,1720165271,A100-SXM4-80GB,8,1,64,896,19,101
6fa18406-a094-4307-8f83-6beb1c508ed1,geogpt-lxz-sft-magpie-llama3-pro-2ep-72b,1720165335,1720165845,finished,1720165414,1720165845,A100-SXM4-80GB,8,16,64,448,79,431
ad49c952-428f-42ee-93a0-a6d3511fa32b,geogpt-prompt-tuning-tg-infer1,1720165587,1720166027,finished,1720165608,1720166027,A100-SXM4-80GB,8,1,64,448,21,419
1ab38495-0f1c-465e-8189-ca962da69b66,mixtral-sft-test,1720165643,1720165764,finished,1720165664,1720165764,A100-SXM4-80GB,8,1,64,896,21,100
316cbd7d-640e-4158-b055-4b42bd1a9933,qwen1-5-7b-lp-6-2-73f0d-auto,1720165827,1720167835,finished,1720165849,1720167835,A100-SXM4-80GB,8,1,64,448,22,1986
0680d001-148c-4bec-98d1-22ca6927e22c,geogpt-lxz-sft-magpie-llama3-pro-2ep-72b,1720165912,1720166401,finished,1720165972,1720166401,A100-SXM4-80GB,8,16,64,448,60,429
083960f2-6748-4bd5-8abb-56c4129c8065,sql-spider-qy-0704-qwen,1720166091,1720167199,finished,1720166133,1720167199,A100-SXM4-80GB,8,1,64,448,42,1066
e3104023-0d09-406b-af28-3c768a02bf47,q72b-linear-self-attn-2575-bd71f-auto,1720166096,1720181453,finished,1720166136,1720181453,A100-SXM4-80GB,8,1,64,448,40,15317
806ba26e-d535-4421-8b85-fb21232d7086,q72b-linear-other-7525-cb72c-auto,1720166098,1720181648,finished,1720166136,1720181648,A100-SXM4-80GB,8,1,64,448,38,15512
54102bfe-e901-4a1c-bed2-32b92cabc5e4,q72b-linear-other-7525-9a299-auto,1720166099,1720176441,finished,1720166136,1720176441,A100-SXM4-80GB,8,1,64,448,37,10305
15789254-049e-4aa8-aaca-7ef269486ee4,q72b-linear-self-attn-7525-4d3f8-auto,1720166102,1720181454,finished,1720166136,1720181454,A100-SXM4-80GB,8,1,64,448,34,15318
66c76ffd-ebcc-48c9-adfa-0cf6f0d3c567,q72b-linear-other-2575-22201-auto,1720166104,1720176846,finished,1720166136,1720176846,A100-SXM4-80GB,8,1,64,448,32,10710
1b3f3dd2-bd98-4e1f-b55f-3555a95c36c4,q72b-linear-mlp-7525-3c592-auto,1720166106,1720181981,finished,1720166137,1720181981,A100-SXM4-80GB,8,1,64,448,31,15844
4b72b19f-ed84-4f64-9fd5-c6f994bf42a6,q72b-linear-self-attn-2575-f6d9b-auto,1720166108,1720176490,finished,1720166137,1720176490,A100-SXM4-80GB,8,1,64,448,29,10353
f91355cb-4bd1-43eb-baf4-6e0d2283900f,q72b-linear-mlp-2575-59535-auto,1720166110,1720176681,finished,1720166381,1720176681,A100-SXM4-80GB,8,1,64,448,271,10300
48aebef3-079c-4595-8e53-136b1aeceb5f,q72b-linear-self-attn-7525-e9ee7-auto,1720166113,1720176634,finished,1720166137,1720176634,A100-SXM4-80GB,8,1,64,448,24,10497
512afc94-1a23-478a-a9df-06fd29e6de78,q72b-linear-mlp-7525-a16a3-auto,1720166114,1720176540,finished,1720166137,1720176540,A100-SXM4-80GB,8,1,64,448,23,10403
cecbb7d2-2c68-4fdd-96b0-5af242a05349,llama3-8b-base-8d856-auto,1720166176,1720249684,finished,1720166393,1720249684,A100-SXM4-80GB,8,1,64,896,217,83291
9dadb7fb-62a9-4257-9438-4e4408e2f4f2,llama-multi,1720166180,1720175191,finished,1720166376,1720175191,A100-SXM4-80GB,8,1,64,448,196,8815
65deb482-992a-4706-84d6-6140851ffd63,llama3-8b-cpt-32k-1-5b-f8fae-auto,1720166201,1720253393,finished,1720166373,1720253393,A100-SXM4-80GB,8,1,64,896,172,87020
8ca2ac6b-7e60-4d9c-8bf2-59ff230de46d,q72b-linear-mlp-2575-ee01f-auto,1720166211,1720181982,finished,1720166360,1720181982,A100-SXM4-80GB,8,1,64,448,149,15622
74f2369f-f919-4c7d-bf1a-060b5bfdada6,q72b-linear-other-2575-db0aa-auto,1720166213,1720181878,finished,1720166360,1720181878,A100-SXM4-80GB,8,1,64,448,147,15518
f3c0ce18-95c4-41ef-b404-2c42d06dedc8,citysora-modelv4plus-121-256,1720166338,1721224122,finished,1720166421,1721224122,A100-SXM4-80GB,8,4,64,896,83,1057701
3d598a1a-53d9-43b4-a1d0-50d9024077b9,geogpt-lxz-sft-magpie-llama3-pro-2ep-72b,1720166474,1720169764,finished,1720169305,1720169764,A100-SXM4-80GB,8,16,64,448,2831,459
b6b83f3f-5133-4401-b7d8-4fbd88e3810a,geogpt-eval-deductive,1720166773,1720166943,finished,1720166798,1720166943,A100-SXM4-80GB,8,1,64,896,25,145
ca04032c-1d13-4535-a2bf-78531da2dfdc,opencompass-eval-0705,1720166880,1720180420,finished,1720166904,1720180420,A100-SXM4-80GB,8,1,64,896,24,13516
c963bb9c-0311-4f96-8356-b3fd215b9efb,geogpt-eval-deductive,1720167040,1720168421,finished,1720167063,1720168421,A100-SXM4-80GB,8,1,64,896,23,1358
0d77e361-ed70-443f-b88f-404ad5ba73a3,geogpt-prompt-tuning-tg-infer1,1720167424,1720167886,finished,1720167449,1720167886,A100-SXM4-80GB,8,1,64,448,25,437
c1c139c2-9e6b-4c3f-b497-58cfc4cd8fe5,sql-spider-qy-0704-qwen,1720167752,1720171718,finished,1720167776,1720171718,A100-SXM4-80GB,8,1,64,448,24,3942
37236c01-a5d4-4405-908e-4a5875b8347e,qwen7b-tcpt-lr-2e5-hw-e1-ef113-auto,1720167814,1720169601,finished,1720167838,1720169601,A100-SXM4-80GB,8,1,64,448,24,1763
79e4c3b0-c565-41f4-8c51-0a645b89e660,geogpt-prompt-tuning-tg-infer1,1720168074,1720168521,finished,1720168098,1720168521,A100-SXM4-80GB,8,1,64,448,24,423
dc02d933-28e7-4ce1-b79b-85698f00f921,llama-factory-long,1720168179,1720168361,finished,1720168205,1720168361,A100-SXM4-80GB,8,1,64,448,26,156
a1a846e5-1af7-49ff-ab1d-d818935c0c66,q72b-linear-self-attn-5050-47549-auto,1720168244,1720178404,finished,1720168268,1720178404,A100-SXM4-80GB,8,1,64,448,24,10136
18833344-0554-4cd2-a52b-8a448ffa945a,q72b-linear-other-5050-b3fe6-auto,1720168271,1720178470,finished,1720168299,1720178470,A100-SXM4-80GB,8,1,64,448,28,10171
f4aed8dc-3ac9-4c99-8d98-cce94ee38b8c,q72b-linear-mlp-5050-cc827-auto,1720168272,1720178559,finished,1720168299,1720178559,A100-SXM4-80GB,8,1,64,448,27,10260
1965aa5b-7529-43b1-be08-1343426b52df,q72b-linear-self-attn-5050-2237f-auto,1720168275,1720183899,finished,1720168299,1720183899,A100-SXM4-80GB,8,1,64,448,24,15600
1bbd4c57-9436-4c45-976c-c420ad9a1d27,mixtral-sft-test,1720168567,1720169069,finished,1720168592,1720169069,A100-SXM4-80GB,8,1,64,896,25,477
61a9c849-a2b4-4257-b799-9e7d09e4e8fc,qwen1-5-7b-lp-6-2-25bgeo,1720168620,1720339972,finished,1720169768,1720339972,A100-SXM4-80GB,8,16,64,448,1148,170204
ce09e31d-b91f-4768-bf58-9197135c8ebb,geogpt-eval-deductive,1720168648,1720169973,finished,1720168675,1720169973,A100-SXM4-80GB,8,1,64,896,27,1298
07c2363a-8859-4bd6-99b0-01d2fefbd758,geogpt-prompt-tuning-tg-infer1,1720168652,1720169105,finished,1720168677,1720169105,A100-SXM4-80GB,8,1,64,448,25,428
6eb28165-5f60-4c07-8d65-3b1fbcfaf670,mixtral-sft-test,1720169123,1720169338,finished,1720169172,1720169338,A100-SXM4-80GB,8,4,64,896,49,166
4f294925-9812-4060-a37e-641221a7f8c6,q72b-linear-mlp-5050-7d6d5-auto,1720169229,1720184549,finished,1720169255,1720184549,A100-SXM4-80GB,8,1,64,448,26,15294
919fb83e-4134-47eb-ae5f-3504fc8817ae,mixtral-sft-test,1720169338,1720171773,finished,1720169416,1720171773,A100-SXM4-80GB,8,4,64,896,78,2357
00e6b8cd-3963-4b42-b998-79e41f4b267d,geogpt-lxz-sft-magpie-llama3-pro-2ep-72b,1720169848,1720170438,finished,1720170270,1720170438,A100-SXM4-80GB,8,16,64,448,422,168
16f43775-25b1-48ed-b7ef-18f4fb6f79a7,llama-factory-long,1720169912,1720170107,finished,1720169936,1720170107,A100-SXM4-80GB,8,1,64,448,24,171
7801df52-c8f6-4d0d-b0e4-dfde40ead3e9,geogpt-prompt-tuning-tg-infer1,1720170202,1720170613,finished,1720170228,1720170613,A100-SXM4-80GB,8,1,64,448,26,385
38f8e064-5291-4177-b65a-8f962ef7815a,mistral-longtext-ml1wt-v3-98e46-auto,1720170289,1720171466,finished,1720170315,1720171466,A100-SXM4-80GB,8,1,64,448,26,1151
38d40a02-53fa-4d48-8152-9c2c1b62c7e0,geogpt-sft-qwen2-72b-datav08-ep1,1720170326,1720244804,finished,1720170352,1720244804,A100-SXM4-80GB,8,1,64,448,26,74452
49fc64f5-8ad2-4cc2-8dff-4006b4310e63,llama-factory-long,1720170452,1720170695,finished,1720170524,1720170695,A100-SXM4-80GB,8,2,64,448,72,171
e41461fc-a928-432f-ad2f-af82e5057369,llama3-8b-sft32k,1720170695,1720173061,finished,1720170743,1720173061,A100-SXM4-80GB,8,4,64,448,48,2318
183310c4-ac47-4b2a-bb53-c06d307c4148,geogpt-prompt-tuning-tg-infer1,1720170834,1720174066,finished,1720170859,1720174066,A100-SXM4-80GB,8,1,64,448,25,3207
61ab8562-6434-419b-bc13-c5dd614769a5,qwen1-14B,1720170944,1720173352,finished,1720171016,1720173352,A100-SXM4-80GB,8,2,64,896,72,2336
fba73d0f-38f1-4b78-b544-9cb01024b23a,llama-factory-long,1720171159,1720171888,finished,1720171184,1720171888,A100-SXM4-80GB,8,1,64,448,25,704
ccbbb2be-62fc-4e4c-87e9-b8d5a7413e98,Mistral-7B-Instruct-v0-1,1720171332,1720173861,finished,1720171358,1720173861,A100-SXM4-40GB,8,1,32,320,26,2503
b6cd5606-2016-4c65-9c0d-de43f227541a,sql-spider-qy-0704-qwen,1720171718,1720173427,finished,1720171742,1720173427,A100-SXM4-80GB,8,1,64,448,24,1685
f50a0d1f-5be2-4a9f-8b4c-1102023627a3,geogpt-sft-construct-magpie-qwen2-zh-llama3-8b,1720171823,1720237317,finished,1720171897,1720237317,A100-SXM4-80GB,8,8,64,448,74,65420
53cfd8d2-cb66-4d78-8c67-3826c114adbd,qwen1-5-14b-42bcpt-1ep-228f9-auto,1720171852,1720172616,finished,1720171877,1720172616,A100-SXM4-80GB,8,1,64,448,25,739
24eaaaed-75d5-45fd-8dd6-3480b0922938,llama3-8b-sft32k,1720173061,1720173351,finished,1720173132,1720173351,A100-SXM4-80GB,8,4,64,448,71,219
cb3bc1d6-1f31-4f74-baeb-598db2a3dcd9,sql-spider-qy-0703,1720173161,1720176511,finished,1720173187,1720176511,A100-SXM4-80GB,8,1,64,448,26,3324
78bc715b-5831-44b8-81da-cc09e22d34fa,sql-spider-qy-0704-qwen,1720173427,1720189134,finished,1720173452,1720189134,A100-SXM4-80GB,8,1,64,448,25,15682
d6e6e991-b9ca-47a4-a529-77e4d2a03c22,llama-factory-long,1720173832,1720173980,finished,1720173858,1720173980,A100-SXM4-80GB,8,1,64,448,26,122
ec3524cc-3e6e-4523-a799-a1102abbebeb,mistral-7b-instruct-v0-1,1720173933,1720347435,finished,1720173959,1720347435,A100-SXM4-40GB,8,1,32,320,26,173476
6f5065f1-bfcf-4006-aafe-3376f080b1c4,llama-factory-long,1720174403,1720174548,finished,1720174429,1720174548,A100-SXM4-80GB,8,1,64,448,26,119
3e7ad2af-5700-439c-8753-458657c2445b,llama3-8b-sft32k,1720174429,1720174833,finished,1720174500,1720174833,A100-SXM4-80GB,8,4,64,448,71,333
e2bb8362-c049-4223-baf8-e8bddc22800e,llama-factory-long,1720175000,1720175142,finished,1720175024,1720175142,A100-SXM4-80GB,8,1,64,448,24,118
74f31e1d-efba-430a-b6c0-eaa43a994a01,llama-factory-long,1720175239,1720175382,finished,1720175263,1720175382,A100-SXM4-80GB,8,1,64,448,24,119
50911e1a-e122-4db9-a328-da2aa6c05cba,llama3-8b-sft32k,1720175457,1720176218,finished,1720175529,1720176218,A100-SXM4-80GB,8,4,64,448,72,689
0252bc12-df60-4ed8-ab1b-8d9e1b8eead9,llama-factory-long,1720175481,1720175673,finished,1720175505,1720175673,A100-SXM4-80GB,8,1,64,448,24,168
2191c428-2d6c-4f71-9397-5bac1efcfe58,geogpt-dairui-model-merge-exp-1,1720175677,1720176487,finished,1720175703,1720176487,A100-SXM4-80GB,8,1,64,896,26,784
f23ca179-32ff-4802-a1c0-58c2f6935da5,mistral-7b-test,1720175912,1720262657,finished,1720175937,1720262657,A100-SXM4-40GB,8,1,32,320,25,86720
86e3c7bf-6cfc-407d-a963-085663608364,llama-factory-long,1720176218,1720176362,finished,1720176242,1720176362,A100-SXM4-80GB,8,1,64,448,24,120
5716ecd2-3f37-4806-ad99-9065f034f90c,llama-factory-long,1720176556,1720176745,finished,1720176579,1720176745,A100-SXM4-80GB,8,1,64,448,23,166
f9afe8f7-bf8d-409c-9a80-71c49c68353f,geogpt-dairui-model-merge-exp-1,1720176725,1720177542,finished,1720176749,1720177542,A100-SXM4-80GB,8,1,64,896,24,793
5958d9ae-673b-4c4f-baa2-987fd329df96,geogpt-dynamic-fewshot-generation-cw-01,1720176866,1720177473,finished,1720176888,1720177473,A100-SXM4-80GB,8,1,64,896,22,585
f305398b-c04a-4d75-a43c-a260a4ba1134,llama3-8b-pt80k,1720178260,1720400663,finished,1720178327,1720400663,A100-SXM4-80GB,8,4,64,448,67,222336
1d9509ae-aa56-4e62-8db4-58e1e8c03264,qwen7b-tcpt-lr-2e5-hw-e1-231da-auto,1720178873,1720179551,finished,1720178895,1720179551,A100-SXM4-80GB,8,1,64,448,22,656
a037c2ee-6576-4026-af07-68b4b09d75c9,qwen7b-tcpt-lr-2e5-hw-e1-231da-auto,1720180892,1720181548,finished,1720180915,1720181548,A100-SXM4-80GB,8,1,64,448,23,633
4ff9e070-6227-4423-b92c-26753b39ed86,qwen2-72b-6bcpt-2ep,1720183074,1720230252,finished,1720183137,1720230252,A100-SXM4-80GB,8,40,64,448,63,47115
911e3f92-c0fc-446f-b06b-ad00aad3be2a,geogpt-7b-lp40-s2-sft-40w,1720183096,1720212801,finished,1720183174,1720212801,A100-SXM4-80GB,8,2,64,448,78,29627
9661223a-7dfc-40b9-948b-5ea574873776,qwen7b-tcpt-lr-2e5-hw-e1-f0be6-auto,1720183198,1720183864,finished,1720183219,1720183864,A100-SXM4-80GB,8,1,64,448,21,645
ee98cba6-7ae0-422c-b63c-60650afbc131,q72b-linear-other-5050-81376-auto,1720184304,1720199523,finished,1720184324,1720199523,A100-SXM4-80GB,8,1,64,448,20,15199
018c0cad-e788-4655-9df9-51e50c4d3ad8,geogpt-sft-construct-magpie-qwen2-mconly-llama3-8b,1720184365,1720269574,finished,1720188539,1720269574,A100-SXM4-80GB,8,4,64,448,4174,81035
ac8ee158-4bf9-4679-b203-1a69da43e769,qwen7b-tcpt-lr-2e5-hw-e1-f0be6-auto,1720184453,1720185162,finished,1720184474,1720185162,A100-SXM4-80GB,8,1,64,448,21,688
726a2591-2bc7-4d35-bf88-830efd0a9bc0,geogpt-sft-construct-magpie-qwen2-mc-zh-llama3-8b,1720184649,1720297881,finished,1720197761,1720297881,A100-SXM4-80GB,8,4,64,448,13112,100120
4f261efd-6981-4abe-928d-1a5a035fc8fc,qwen1-5-14b-10bcpt-1ep-dc5d2-auto,1720184712,1720185625,finished,1720184733,1720185625,A100-SXM4-80GB,8,1,64,448,21,892
dac28b3b-a8b9-4df7-870b-2a20b80ade06,qwen1-5-14b-138bcpt-1ep-b0e83-auto,1720184795,1720185927,finished,1720185180,1720185927,A100-SXM4-80GB,8,1,64,448,385,747
7a9a3456-80b8-4949-9f25-15e5295b6139,qwen7b-tcpt-lr-2e5-hw-e1-f0be6-auto,1720185467,1720186352,finished,1720185649,1720186352,A100-SXM4-80GB,8,1,64,448,182,703
589ae84d-7dde-4e78-a773-8c50e82756ec,llama-factory-long,1720185818,1720186681,finished,1720185959,1720186681,A100-SXM4-80GB,8,1,64,448,141,722
6fcd051e-a3f0-4168-860b-ee9f07edecea,llama3-8b-sft32k,1720186542,1720197276,finished,1720195737,1720197276,A100-SXM4-80GB,8,4,64,448,9195,1539
b5632b06-c97b-4468-9950-2f394f6c7499,llama-factory-long,1720187679,1720188405,finished,1720187700,1720188404,A100-SXM4-80GB,8,1,64,448,21,704
35127a6d-cb6a-46b5-b43b-7c2fcafe3b1c,llama-factory-long,1720192224,1720192345,finished,1720192244,1720192345,A100-SXM4-80GB,8,1,64,448,20,101
1b858828-cafe-4132-846e-4c90338659ff,llama-factory-long,1720192527,1720193239,finished,1720192548,1720193239,A100-SXM4-80GB,8,1,64,448,21,691
84fdbbed-bdaf-410b-bfb1-ea2d4ccfed1e,qwen7b-tcpt-lr-2e5-hw-e1-f0be6-auto,1720192602,1720193352,finished,1720192624,1720193352,A100-SXM4-80GB,8,1,64,448,22,728
110c2466-f939-405d-9f91-5843d7f95561,llama3-8b-sft-debug,1720192611,1720192832,finished,1720192632,1720192832,A100-SXM4-80GB,8,1,64,448,21,200
2a0808be-db7d-420b-be9e-fe4198dfd2da,sql-spider-qy-0704-qwen,1720192978,1720193704,finished,1720192999,1720193704,A100-SXM4-80GB,8,1,64,448,21,705
683cedf9-39a9-44a5-bbaa-5a7ea15c18ef,llama3-8b-sft-debug,1720193058,1720194483,finished,1720193260,1720194483,A100-SXM4-80GB,8,1,64,448,202,1223
b9855d83-e3a9-494f-a34d-22768df900fd,llama-factory-long,1720193239,1720194119,finished,1720193402,1720194119,A100-SXM4-80GB,8,1,64,448,163,717
a1f496c7-5cb0-4dd8-8d1e-774e7cc8a365,sql-spider-qy-0704-qwen,1720193704,1720210293,finished,1720193725,1720210293,A100-SXM4-80GB,8,1,64,448,21,16568
d8584682-c95a-4a00-8e6b-c629f109fdc4,qwen7b-tcpt-lr-2e5-hw-e1-f0be6-auto,1720194152,1720194777,finished,1720194173,1720194777,A100-SXM4-80GB,8,1,64,448,21,604
640ef17a-bbd3-4353-ab6b-928e704996c8,llama3-8b-sft-debug,1720194483,1720195085,finished,1720194503,1720195085,A100-SXM4-80GB,8,1,64,448,20,582
34d84a54-cfee-4984-9445-ac7b265a4513,llama-factory-long-wosp,1720197033,1720197656,finished,1720197276,1720197656,A100-SXM4-80GB,8,1,64,448,243,380
e503a217-3fcb-479f-8ba1-4a48d9127115,llama-factory-long,1720197113,1720197756,finished,1720197276,1720197756,A100-SXM4-80GB,8,1,64,448,163,480
790f648f-42bb-4e78-8601-df9136348aeb,llama3-8b-instruct-sft32k,1720197277,1720400663,finished,1720216710,1720400663,A100-SXM4-80GB,8,4,64,448,19433,183953
486d6ef5-57e5-4d91-9a54-41d97f6e09aa,llama-factory-long-wosp,1720197999,1720204347,finished,1720203762,1720204347,A100-SXM4-80GB,8,1,64,448,5763,585
67bc9590-9b71-4aef-91ce-a2eb7f7c787e,llama-factory-long,1720198060,1720204982,finished,1720204347,1720204982,A100-SXM4-80GB,8,1,64,448,6287,635
9b03d893-bb3c-4c29-b01f-761a8c90dd3b,ruler-eval-0706-geogpt-0612,1720199033,1720241365,finished,1720204961,1720241365,A100-SXM4-80GB,8,1,64,896,5928,36404
e37f1a20-8f92-49d8-a126-b57f8364350b,ruler-eval-0706-geogpt-0630,1720199075,1720247404,finished,1720210288,1720247404,A100-SXM4-80GB,8,1,64,896,11213,37116
316ac9b5-a2c1-4eae-86a7-781b88961de0,ruler-eval-0706-qwen,1720199095,1720237558,finished,1720199556,1720237558,A100-SXM4-80GB,8,1,64,896,461,38002
33ee867f-7db3-430d-8029-952c2134683b,qwen7b-tcpt-lr-2e5-hw-e1-f0be6-auto,1720199389,1720203734,finished,1720203073,1720203734,A100-SXM4-80GB,8,1,64,448,3684,661
1a290424-07f9-4014-8c4e-2435e41fd953,opencompass-eval-0705,1720199733,1720231520,finished,1720200123,1720231520,A100-SXM4-80GB,8,1,64,896,390,31397
99b78956-eb74-42a0-876b-95880ce1a62a,llama-factory-long,1720226040,1720226214,finished,1720226060,1720226214,A100-SXM4-80GB,8,1,64,448,20,154
94cd89b3-ae8e-4f88-aab3-cd069815c0a9,llama-factory-long,1720226311,1720226853,finished,1720226331,1720226853,A100-SXM4-80GB,8,1,64,448,20,522
845e8f84-8983-440e-8f41-628c358f8c36,llama-factory-long,1720226853,1720227241,finished,1720226872,1720227241,A100-SXM4-80GB,8,1,64,448,19,369
5f34680b-4924-4c0d-a00c-b7d2155fb678,llama-factory-long-wosp,1720227202,1720227740,finished,1720227222,1720227740,A100-SXM4-80GB,8,1,64,448,20,518
90fbea8e-9ff7-41be-80a8-bc38f77b2681,llama-factory-long,1720227241,1720227835,finished,1720227261,1720227835,A100-SXM4-80GB,8,1,64,448,20,574
35157a60-0caa-434b-bd8c-1dcf343b58ab,geogpt-llama3-70b-lp84-22bcpt,1720228625,1720338763,finished,1720228684,1720338763,A100-SXM4-80GB,8,64,64,448,59,110079
f25919df-7f16-4acb-aa22-b60c8082b497,geogpt-gate-chat-eval-3,1720228731,1720532690,finished,1720228751,1720532690,A100-SXM4-80GB,8,1,64,448,20,303939
0c81131c-0c1b-44b4-817f-5f0b5d32c77a,geogpt-gate-chat-eval-geo,1720228791,1720234402,finished,1720230252,1720234402,A100-SXM4-80GB,8,1,64,448,1461,4150
469541f1-c614-4950-b7c3-369268e315ca,train-0704,1720229514,1720231230,finished,1720230262,1720231230,A100-SXM4-80GB,8,1,64,896,748,968
b7ce3f6d-6e11-403b-8358-d9fb9a804b66,qwen2-72b-6bcpt-2ep,1720230891,1720233331,finished,1720232010,1720233331,A100-SXM4-80GB,8,40,64,448,1119,1321
fe70b803-cf3c-4545-8159-f1623345dd49,train-0704,1720231230,1720260562,finished,1720231250,1720260562,A100-SXM4-80GB,8,1,64,896,20,29312
e5a8e1fc-9d2e-4c4d-b7f3-5b28ac02437a,geo-base-offline-eval,1720232919,1720278397,finished,1720233298,1720278397,A100-SXM4-80GB,8,1,64,448,379,45099
78814720-161a-4d98-b5a0-6ff687c2d07f,qwen2-72b-6bcpt-2ep,1720233409,1720345706,finished,1720234440,1720345706,A100-SXM4-80GB,8,40,64,448,1031,111266
337338aa-9159-45de-9e1d-c2c9f45ca645,geogpt-gate-chat-eval-geo,1720234477,1720319494,finished,1720234575,1720319494,A100-SXM4-80GB,8,1,64,448,98,84919
45201089-f020-4c45-932b-0e29a3a0fbef,slimorca-geo-mtm1-mt-wild-14b,1720239266,1720316802,finished,1720239286,1720316802,A100-SXM4-80GB,8,1,64,448,20,77516
960239b2-0740-4344-aad1-ee2ae0ceb0f3,qwen1-5-14b-138bcpt-0-2ep-af841-auto,1720240544,1720241256,finished,1720240564,1720241256,A100-SXM4-80GB,8,1,64,448,20,692
edb56291-59b3-4d09-8653-001c1a705654,qwen7b-tcpt-lr-2e5-hw-e1-f0be6-auto,1720240645,1720241338,finished,1720240666,1720241338,A100-SXM4-80GB,8,1,64,448,21,672
8c457579-7ed8-44d0-8f77-9bd04a7ee1df,data-gen-magpie-3,1720242009,1720295116,finished,1720242028,1720295116,A100-SXM4-80GB,8,1,64,448,19,53088
a4138c68-32cd-4b9f-8044-4c9bc883546b,qwen7b-tcpt-lr-2e5-hw-e1-88a85-auto,1720243567,1720244257,finished,1720243587,1720244257,A100-SXM4-80GB,8,1,64,448,20,670
e5751db6-62e1-4084-ab5a-71049d793cd0,geogpt-sft-construct-magpie-qwen2-womc-llama3-8b,1720245800,1720324956,finished,1720245859,1720324956,A100-SXM4-80GB,8,4,64,448,59,79097
fbcb7fbc-5caa-4de6-a4d5-856ece5e7a84,geogpt-dairui-model-merge-exp-2,1720251731,1720251975,finished,1720251750,1720251975,A100-SXM4-80GB,8,1,64,896,19,225
5c6f4cf8-5a3c-4879-bb0e-0ed709824db6,geogpt-dairui-model-merge-exp-1,1720252272,1720252534,finished,1720252290,1720252534,A100-SXM4-80GB,8,1,64,896,18,244
3ff9b19b-c1cc-412b-a557-0d50541c5edb,geogpt-dairui-model-merge-exp-1,1720252759,1720253021,finished,1720252778,1720253021,A100-SXM4-80GB,8,1,64,896,19,243
d8a69c8c-3c82-4f19-b161-c480759a412f,llama3-8b-cpt-32k-1-5b-f8fae-auto,1720253432,1720368163,finished,1720253452,1720368163,A100-SXM4-80GB,8,1,64,896,20,114711
fa86279e-1be9-4726-bd9b-6836dc5fecfc,geogpt-dairui-model-merge-exp-1,1720253438,1720253682,finished,1720253458,1720253682,A100-SXM4-80GB,8,1,64,896,20,224
3702d15e-af07-448f-a70e-a979df129289,geogpt-dairui-model-merge-exp-1,1720254149,1720358755,finished,1720254170,1720358755,A100-SXM4-80GB,8,1,64,896,21,104585
f5cc38d3-36f6-463b-af74-f253277ce490,mixtral-sft-test,1720254171,1720254325,finished,1720254209,1720254325,A100-SXM4-80GB,8,4,64,896,38,116
626e79f5-c920-4ba8-9a65-dc323303b081,cft-1-8m-sub-plus-mt-qwen2-72b,1720254230,1720316803,finished,1720254249,1720316803,A100-SXM4-80GB,8,1,64,448,19,62554
20e4c051-63f4-4c9f-ba30-f44cc9f9fce1,geogpt-sft-1st-math-llama3-8b,1720254714,1720279418,finished,1720254775,1720279418,A100-SXM4-80GB,8,4,64,448,61,24643
cdd379bd-14c0-43c5-8f3d-f1b87f30a98e,geogpt-prompt-tuning-tg-infer1,1720254760,1720254954,finished,1720254782,1720254954,A100-SXM4-80GB,8,1,64,448,22,172
159486b3-6ee0-4d72-826f-96ae6fd05b30,geogpt-prompt-tuning-tg-infer1,1720254954,1720255161,finished,1720254973,1720255161,A100-SXM4-80GB,8,1,64,448,19,188
d6583106-3d70-42f8-87a8-368875c7893a,mixtral-sft-test,1720255288,1720255478,finished,1720255345,1720255478,A100-SXM4-80GB,8,4,64,896,57,133
a897325e-f300-461e-8a95-ef3eda7a62ef,mixtral-sft-test,1720255516,1720256454,finished,1720255573,1720256454,A100-SXM4-80GB,8,4,64,896,57,881
a7f8c2a0-b13a-4903-b33b-ae66ae3b8b65,mixtral-sft-test,1720256454,1720258054,finished,1720256511,1720258054,A100-SXM4-80GB,8,4,64,896,57,1543
53d88b7d-1211-42bf-8f7c-e9c40e9b3143,geogpt-prompt-tuning-tg-infer2,1720256800,1720256971,finished,1720256821,1720256971,A100-SXM4-80GB,8,1,64,448,21,150
ffd692b9-6816-4685-991f-8b5abd8b3315,geogpt-prompt-tuning-tg-infer1,1720256841,1720257160,finished,1720256990,1720257160,A100-SXM4-80GB,8,1,64,448,149,170
a39f55a5-cf07-4174-8fde-04c8dbe7289c,mixtral-sft-test,1720258054,1720269719,finished,1720269568,1720269719,A100-SXM4-80GB,8,16,64,896,11514,151
2c054663-ca8b-496f-9901-387821d10fd0,qwen7b-tcpt-lr-2e5-hw-e1-2aa9a-auto,1720259501,1720260219,finished,1720259521,1720260219,A100-SXM4-80GB,8,1,64,448,20,698
c10579aa-f9c9-4b8d-b587-7eb0f0c14ed6,qwen7b-tcpt-lr-2e5-hw-e1-c0192-auto,1720260576,1720262515,finished,1720260595,1720262515,A100-SXM4-80GB,8,1,64,448,19,1920
7600a9de-192a-446c-bf6e-f440f32b0868,train-0704,1720261275,1720261936,finished,1720261294,1720261936,A100-SXM4-80GB,8,1,64,896,19,642
0ce8c9d4-8a56-497c-881c-4f471ac8d531,train-0701,1720262672,1720263587,finished,1720262691,1720263587,A100-SXM4-80GB,8,1,64,896,19,896
70105456-f756-4665-af18-e49b4f1bea5a,train-0701,1720263698,1720273460,finished,1720263717,1720273460,A100-SXM4-80GB,8,1,64,896,19,9743
d6dffefd-58db-46bd-9c30-6946edc1c1a8,qwen7b-tcpt-lr-8e5-hw-e1-de5b0-auto,1720268392,1720269068,finished,1720268413,1720269068,A100-SXM4-80GB,8,1,64,448,21,655
891e5d2c-f1ed-46cd-8606-21ef9f4a88d6,qwen7b-tcpt-lr-2e5-c5f68-auto,1720268451,1720269126,finished,1720268470,1720269126,A100-SXM4-80GB,8,1,64,448,19,656
8acfe101-bd99-4790-97a9-13a82789453e,qwen7b-tcpt-lr-8e5-hw-e1-de5b0-auto,1720269645,1720270525,finished,1720269668,1720270525,A100-SXM4-80GB,8,1,64,448,23,857
be415d66-da62-42f4-8f3b-8374d64dedb6,qwen7b-tcpt-lr-2e5-c5f68-auto,1720269649,1720270430,finished,1720269668,1720270430,A100-SXM4-80GB,8,1,64,448,19,762
f01c42d6-bc5c-41fb-9f79-d74b9938ed6c,mixtral-sft-test,1720269980,1720270557,finished,1720270036,1720270557,A100-SXM4-80GB,8,16,64,896,56,521
12895066-df7e-481a-b7e9-06ddcec76573,qwen7b-tcpt-lr-2e5-c5f68-auto,1720270675,1720271327,finished,1720270695,1720271327,A100-SXM4-80GB,8,1,64,448,20,632
bf6ea842-8204-4ee2-808e-3c3177117eb1,mixtral-sft-test,1720271383,1720329758,finished,1720271439,1720329758,A100-SXM4-80GB,8,16,64,896,56,58319
7e2266b1-06dc-4a6a-a5d4-088b28c9a48b,qwen7b-tcpt-lr-8e5-hw-e1-7236d-auto,1720271545,1720273661,finished,1720271563,1720273661,A100-SXM4-80GB,8,1,64,448,18,2098
b011d226-8499-4298-bece-a5d2cb92a928,qwen7b-tcpt-lr-2e-5-53660-auto,1720271620,1720278292,finished,1720271641,1720278292,A100-SXM4-80GB,8,1,64,448,21,6651
d4b9eca1-cdeb-401d-931e-e681b108ddcb,train-0701,1720273517,1720277869,finished,1720273536,1720277869,A100-SXM4-80GB,8,1,64,896,19,4333
5f784f34-68f7-40fb-89bd-d2bcb9a18a17,train-0703,1720274823,1720279318,finished,1720274842,1720279318,A100-SXM4-80GB,8,1,64,896,19,4476
cf2cf50d-e749-4afa-8224-5d5393677e7f,llama-factory-long-wosp,1720276600,1720278489,finished,1720277549,1720278489,A100-SXM4-80GB,8,1,64,448,949,940
3380cf10-3018-4612-aab9-d3e412100d49,geogpt-sft-common-mix-womc-llama3-8b,1720277385,1720351114,finished,1720295135,1720351114,A100-SXM4-80GB,8,8,64,448,17750,55979
51cb5239-4d23-4d46-bcbb-b1358b21fe68,train-lr-8e-5,1720277831,1720278895,finished,1720277888,1720278895,A100-SXM4-80GB,8,1,64,896,57,1007
9ac0405c-4034-438f-8eb2-71dd42d7d160,geo-base-offline-eval,1720278473,1720283991,finished,1720278492,1720283991,A100-SXM4-80GB,8,1,64,448,19,5499
fa021cb8-029c-4df6-a265-d28c748ce1cc,tqme-vllm,1720278701,1720279109,finished,1720278722,1720279109,A100-SXM4-80GB,8,1,64,448,21,387
075a23d4-0a23-4ac6-a5ac-ff9fdcbced6a,train-lr-8e-5,1720279225,1720356915,finished,1720279244,1720356915,A100-SXM4-80GB,8,1,64,896,19,77671
3a6c5acd-b9e5-4fa9-a23b-d1ac21dafb2e,train-0703,1720279318,1720279892,finished,1720279337,1720279892,A100-SXM4-80GB,8,1,64,896,19,555
dccb9ecf-a36b-4ebe-bbff-d68471f85768,tqme-vllm,1720279423,1720279808,finished,1720279443,1720279808,A100-SXM4-80GB,8,1,64,448,20,365
f157e881-01d3-471d-b172-f20e67251f68,tqme-vllm,1720279866,1720280219,finished,1720279885,1720280219,A100-SXM4-80GB,8,1,64,448,19,334
599e2ac5-502d-4fa0-acad-aaf9c1cabed6,llama-factory-long-wosp,1720279874,1720280429,finished,1720279893,1720280429,A100-SXM4-80GB,8,1,64,448,19,536
f9202730-a508-4864-a9a7-cad5ddff1f2c,train-0703,1720280077,1720356914,finished,1720280096,1720356914,A100-SXM4-80GB,8,1,64,896,19,76818
08788b45-fed1-401b-a777-04626a26e392,tqme-vllm,1720280552,1720280910,finished,1720280574,1720280910,A100-SXM4-80GB,8,1,64,448,22,336
1952ee8d-793b-4806-b015-074a5ee53333,qwen7b-base-4a6b6-auto,1720280554,1720285504,finished,1720280575,1720285504,A100-SXM4-80GB,8,1,64,448,21,4929
49760013-228e-4254-b226-ec536e32d56f,qwen7b-chat-bab01-auto,1720280576,1720283181,finished,1720280596,1720283181,A100-SXM4-80GB,8,1,64,448,20,2585
e64382c4-3fba-41c0-8150-14c4e213f518,llama-factory-long,1720280604,1720281181,finished,1720280623,1720281181,A100-SXM4-80GB,8,1,64,448,19,558
981d8260-7f4c-46d1-9de7-5a9b036c3389,geogpt-sft-2nd-qwen2-30w-llama3-8b,1720280886,1720286808,finished,1720284011,1720286808,A100-SXM4-80GB,8,4,64,448,3125,2797
49f4334d-8d5f-4423-bbec-e59b41f25ed6,tqme-vllm,1720280949,1720281894,finished,1720280968,1720281894,A100-SXM4-80GB,8,1,64,448,19,926
1570e0cb-c122-4ab7-86ef-2fd2daa1f917,llama-factory-long-wosp,1720281333,1720281883,finished,1720281351,1720281883,A100-SXM4-80GB,8,1,64,448,18,532
22ca7124-be0f-4e8c-8163-c46112cc3857,tqme-vllm,1720281894,1720298463,finished,1720281912,1720298463,A100-SXM4-80GB,8,1,64,448,18,16551
c57fe222-e6e4-48d8-9aee-ca92d8c3a531,llama-factory-long,1720281959,1720282525,finished,1720281979,1720282525,A100-SXM4-80GB,8,1,64,448,20,546
aa9bd0b2-900e-4d32-b5c4-16d9d29afbea,llama-factory-long-wosp,1720282506,1720283039,finished,1720282525,1720283039,A100-SXM4-80GB,8,1,64,448,19,514
4d84849f-7681-40e0-a293-97276e90a3a6,llama-factory-long,1720282659,1720283561,finished,1720282678,1720283561,A100-SXM4-80GB,8,1,64,448,19,883
2194c9d6-c723-4921-8700-84003e68fbf3,qwen-72b-test,1720284747,1720323627,finished,1720284767,1720323627,A100-SXM4-80GB,8,1,64,448,20,38860
c5e273be-be4e-46c9-8665-eee620fe391e,geogpt-prompt-tuning-tg-infer2,1720289380,1720289571,finished,1720289399,1720289571,A100-SXM4-80GB,8,1,64,448,19,172
83483b0c-a76a-4f09-b195-ede3266cde6b,geogpt-prompt-tuning-tg-infer1,1720289399,1720289648,finished,1720289589,1720289648,A100-SXM4-80GB,8,1,64,448,190,59
b7c74e13-009f-4c20-b3fe-e7124e5b106f,geogpt-sft-2nd-qwen2-30w-llama3-8b,1720312512,1720332568,finished,1720312567,1720332568,A100-SXM4-80GB,8,4,64,448,55,20001
0c1c6188-e212-4a58-9a36-04a5fc1b82ee,slimorca-geo-mtm1-geotable-nt-14b,1720312948,1720403346,finished,1720312967,1720403346,A100-SXM4-80GB,8,1,64,448,19,90379
c6d2c292-a6de-4cae-8dda-d1bda62d1ed5,slimorca-geo-mtm1-funcfil2-14b,1720313333,1720403365,finished,1720316802,1720403365,A100-SXM4-80GB,8,1,64,448,3469,86563
cebd238a-89f3-4e5e-a2c1-e4564391d21d,data-gen-magpie-3,1720317889,1720329060,finished,1720317907,1720329060,A100-SXM4-80GB,8,1,64,448,18,11153
2b0e1bc8-1b49-4806-9f61-059287f96d62,geogpt-7b-lp40-s2-sft-40w,1720318588,1720353702,finished,1720324978,1720353702,A100-SXM4-80GB,8,2,64,448,6390,28724
751add98-95df-44b5-919f-d826e71a4370,geogpt-gate-chat-eval-geo,1720319638,1720327994,finished,1720319658,1720327994,A100-SXM4-80GB,8,1,64,448,20,8336
7f27d36f-c67d-49ab-9461-efab44a91400,geogpt-sft-1sft-2nd-code-llama3-8b,1720321542,1720400671,finished,1720329794,1720400671,A100-SXM4-80GB,8,4,64,448,8252,70877
b51500f1-32d9-4ee3-b26c-1252072307b3,geogpt-qwen2-72b-lp84-s2-gate-2b,1720322285,1720459820,finished,1720329798,1720459820,A100-SXM4-80GB,8,10,64,448,7513,130022
41ee537e-d2a8-483f-a2d2-70db7768814c,qwen1-5-7b-lp40-s2-regate-m-4d524-auto,1720322632,1720400779,finished,1720323650,1720400779,A100-SXM4-80GB,8,1,64,448,1018,77129
04153b9f-f624-46ea-9c50-328e9eb72d55,qwen-72b-test,1720324463,1720326882,finished,1720324936,1720326882,A100-SXM4-80GB,8,1,64,448,473,1946
e97dc98e-cd31-4de9-8f0e-d903fc561d7e,geo-seesaw-sft-code-alpaca-ultra-eval-test,1720325511,1720455805,finished,1720325530,1720455805,A100-SXM4-80GB,8,1,64,896,19,130275
c5e6acda-aded-4d99-a1fd-817c38c7ac4d,qwen7b-base-4a6b6-auto,1720326927,1720327510,finished,1720326946,1720327510,A100-SXM4-80GB,8,1,64,448,19,564
ceaf9e0f-4640-4565-a1ee-f612bc7cf714,qwen-72b-test,1720326938,1720439382,finished,1720326956,1720439382,A100-SXM4-80GB,8,1,64,448,18,112426
490387cc-bb92-4468-9425-5edafdac139d,geogpt-prompt-tuning-tg-infer2,1720330453,1720330633,finished,1720330471,1720330633,A100-SXM4-80GB,8,1,64,448,18,162
a4cfcc2c-7aa9-4b2e-9312-b881bcd554ff,cft-1-8m-sub-plus-mt-qwen2-72b,1720337604,1720403308,finished,1720337622,1720403308,A100-SXM4-80GB,8,1,64,448,18,65686
693df01f-3ede-4c01-9bdb-d1b363519872,geogpt-llama3-70b-lp84-22bcpt,1720338842,1720363877,finished,1720338896,1720363877,A100-SXM4-80GB,8,64,64,448,54,24981
f652b0bc-504f-4c91-9913-fa4f82c2ba01,geogpt-sft-construct-qwen2mconly-pluscode,1720339696,1720432901,finished,1720339751,1720432901,A100-SXM4-80GB,8,4,64,448,55,93150
7c0b0694-caa1-4b42-906a-5a6ec625fd9d,slimorca-geo-mtm1-mt-wild-14b,1720342923,1720403308,finished,1720342941,1720403308,A100-SXM4-80GB,8,1,64,448,18,60367
271d2de1-ab35-471b-a3af-7ef970c7fa11,qwen7b-chat-bab01-auto,1720343719,1720344323,finished,1720343738,1720344323,A100-SXM4-80GB,8,1,64,448,19,585
260f9fd4-1629-44e4-b769-fb87d56f2996,qwen7b-base-4a6b6-auto,1720343795,1720344360,finished,1720343814,1720344360,A100-SXM4-80GB,8,1,64,448,19,546
64019873-0675-464a-9396-662615fbb4f2,qwen7b-tcpt-lr-2e-5-53660-auto,1720343815,1720344417,finished,1720343836,1720344417,A100-SXM4-80GB,8,1,64,448,21,581
b217859b-9eb8-432e-8540-dbc26488cb1c,geo-llamapro-1-5B,1720345118,1720400668,finished,1720345156,1720400668,A100-SXM4-80GB,8,4,64,448,38,55512
3f1ac3b5-ca7f-46fa-823a-4aaa7c46ac22,qwen7b-chat-few-shot-30813-auto,1720345332,1720347691,finished,1720345353,1720347691,A100-SXM4-80GB,8,1,64,448,21,2338
cb59ab30-ef01-4976-9703-2c46d502bc1e,qwen7b-base-few-shot-4198f-auto,1720345372,1720350258,finished,1720345393,1720350258,A100-SXM4-80GB,8,1,64,448,21,4865
41a19e13-805c-4160-ac2f-add6ad462723,sql-spider-qy-0704-qwen,1720346906,1720348364,finished,1720346926,1720348364,A100-SXM4-80GB,8,1,64,448,20,1438
336a50cf-58c5-4edd-9d27-447f277ccd32,sql-spider-qy-llama,1720346947,1720348345,finished,1720346966,1720348345,A100-SXM4-80GB,8,1,64,448,19,1379
683c41dd-5cf3-4192-ba00-7c9aa6545c61,sft-demo-yxs,1720346995,1720347074,finished,1720347014,1720347074,A100-SXM4-80GB,8,1,64,896,19,60
dcb332eb-47fc-4367-a445-b80d8033b44e,geogpt-sft-demo-yxs,1720347323,1720347539,finished,1720347345,1720347539,A100-SXM4-80GB,8,1,64,896,22,194
8b218bcf-4a71-4ffd-88e1-3288487f8f13,sql-spider-qy-0703,1720347357,1720347683,finished,1720347377,1720347683,A100-SXM4-80GB,8,1,64,448,20,306
67d52540-6f24-48cc-884e-0b677fa2f895,sql-spider-qy-0703,1720347890,1720348229,finished,1720347909,1720348229,A100-SXM4-80GB,8,1,64,448,19,320
31d3f0cb-dff5-48ad-9774-870c71321f2e,sql-spider-qy-llama,1720348345,1720348727,finished,1720348364,1720348727,A100-SXM4-80GB,8,1,64,448,19,363
a2d7e0f2-e577-4fb0-b467-270ae1690bd6,sql-spider-qy-0704-qwen,1720348364,1720348727,finished,1720348383,1720348727,A100-SXM4-80GB,8,1,64,448,19,344
5f61a3ea-6d60-41b6-964a-64c357837509,geogpt-sft-demo-yxs,1720348467,1720348581,finished,1720348487,1720348581,A100-SXM4-80GB,8,1,64,896,20,94
141f940a-6758-41e2-ac54-f856618c2890,sql-spider-qy-0704-qwen,1720348727,1720359552,finished,1720348746,1720359552,A100-SXM4-80GB,8,1,64,448,19,10806
99bb6233-d77e-4c73-b61e-afa98126c30e,sql-spider-qy-llama,1720348727,1720360481,finished,1720348746,1720360481,A100-SXM4-80GB,8,1,64,448,19,11735
a98a6559-e4c8-4637-b946-778076375c14,sql-spider-qy-0703,1720349050,1720349164,finished,1720349068,1720349164,A100-SXM4-80GB,8,1,64,448,18,96
00638ef3-71d3-4ed1-9684-f8cdd2361fed,sql-spider-qy-0703,1720349240,1720349353,finished,1720349259,1720349353,A100-SXM4-80GB,8,1,64,448,19,94
3b2ef4f5-0757-4a42-b44e-c85d0a692e57,sql-spider-qy-0703,1720349448,1720349560,finished,1720349467,1720349560,A100-SXM4-80GB,8,1,64,448,19,93
07238121-a30f-4cb1-8bc9-3aa1f2bd1339,sql-spider-qy-0703,1720349676,1720349812,finished,1720349695,1720349812,A100-SXM4-80GB,8,1,64,448,19,117
bc67b4fb-fb88-4a1c-9101-e7bece238456,geogpt-sft-demo-yxs,1720349780,1720349972,finished,1720349800,1720349972,A100-SXM4-80GB,8,1,64,896,20,172
6b1972fa-e18d-412d-a45c-b6451f74a0e2,sql-spider-qy-0703,1720349964,1720350117,finished,1720349983,1720350117,A100-SXM4-80GB,8,1,64,448,19,134
9cceeb03-3983-4075-876d-b6ba8e2731eb,geogpt-sft-demo-yxs,1720350067,1720350182,finished,1720350087,1720350182,A100-SXM4-80GB,8,1,64,896,20,95
ecc25dfd-b6af-4216-8d4b-1e678739ca79,geogpt-sft-demo-yxs,1720350483,1720350577,finished,1720350502,1720350577,A100-SXM4-80GB,8,1,64,896,19,75
e0846205-a60b-4ac8-b98c-5ca68d6d9e4a,geogpt-sft-demo-yxs,1720350950,1720351139,finished,1720350970,1720351139,A100-SXM4-80GB,8,1,64,896,20,169
c3a6aa90-cc42-49e0-88c9-334112445472,tqme-vllm-base,1720351081,1720352309,finished,1720351101,1720352309,A100-SXM4-80GB,8,1,64,448,20,1208
841b7cb9-f5ee-4bf6-85dd-ef11fa584abf,sql-spider-qy-0703,1720351189,1720351540,finished,1720351208,1720351540,A100-SXM4-80GB,8,1,64,448,19,332
2aadd2a7-8f39-4444-b510-2176eeec383c,sql-spider-qy-0703,1720351781,1720351949,finished,1720351800,1720351949,A100-SXM4-80GB,8,1,64,448,19,149
b87c8acb-a172-422e-9e17-e2d4a81e195c,geogpt-sft-demo-yxs,1720351882,1720351976,finished,1720351901,1720351976,A100-SXM4-80GB,8,1,64,896,19,75
143f84f4-2d11-429b-aa89-bdaa956a39db,geogpt-sft-demo-yxs,1720352125,1720352236,finished,1720352144,1720352236,A100-SXM4-80GB,8,1,64,896,19,92
db27644a-24ea-499a-ae82-2f17e82ca18f,sql-spider-qy-0703,1720352693,1720353025,finished,1720352712,1720353025,A100-SXM4-80GB,8,1,64,448,19,313
42a67131-db67-4f89-867a-0367199c2c22,qwen7b-tcpt-lr-2e5-few-shot-279c6-auto,1720353256,1720355890,finished,1720353276,1720355890,A100-SXM4-80GB,8,1,64,448,20,2614
8990ffa1-c035-443d-bb83-d5aece8330e6,qwen7b-tcpt-lr-8e5-hw-e1-3shot-01b14-auto,1720353516,1720355419,finished,1720353537,1720355419,A100-SXM4-80GB,8,1,64,448,21,1882
ca4189cf-ae0d-4580-b91d-31b42fbbeaa0,qwen7b-tcpt-lr-2e5-hw-e1-3shot-69d2f-auto,1720353591,1720355776,finished,1720353612,1720355776,A100-SXM4-80GB,8,1,64,448,21,2164
7e41faa6-2f0b-41e0-a86d-91803ae0fc82,sql-spider-qy-0703,1720355201,1720355581,finished,1720355220,1720355581,A100-SXM4-80GB,8,1,64,448,19,361
c65fcb5a-899f-4ef4-b611-8ef38a4712d3,sql-spider-qy-0703,1720356272,1720356514,finished,1720356291,1720356514,A100-SXM4-80GB,8,1,64,448,19,223
e92d3b3b-a45d-40c6-a73d-01ca27c9e77b,sql-spider-qy-0703,1720356514,1720361990,finished,1720356532,1720361990,A100-SXM4-80GB,8,1,64,448,18,5458
675c04ca-0a45-4043-97b5-517684e38c67,test-0707,1720356988,1720357778,finished,1720357007,1720357778,A100-SXM4-80GB,8,1,64,896,19,771
0ea062f9-5b7f-4dec-b693-c5c8e0add2a1,test-0707,1720357980,1720358347,finished,1720357999,1720358347,A100-SXM4-80GB,8,1,64,896,19,348
79136c7b-1440-432c-bf6a-ab90307217ac,test-0707,1720358403,1720362291,finished,1720358421,1720362291,A100-SXM4-80GB,8,1,64,896,18,3870
5894303b-f940-4868-a2a3-93c1880bd937,tqme-vllm-base,1720358892,1720359469,finished,1720358912,1720359469,A100-SXM4-80GB,8,1,64,448,20,557
34acbac3-bd3b-4023-aa26-e8961c52f1a8,qwen7b-tcpt-lr-8e5-few-shot-1ebfd-auto,1720359137,1720362582,finished,1720359157,1720362582,A100-SXM4-80GB,8,1,64,448,20,3425
57898895-a14b-4193-86b8-9ca431fbb413,tqme-vllm-base,1720361365,1720361941,finished,1720361384,1720361941,A100-SXM4-80GB,8,1,64,448,19,557
9c9740be-cea8-47c0-8027-e55aaec383db,sql-spider-qy-0703,1720361990,1720400667,finished,1720362010,1720400667,A100-SXM4-80GB,8,1,64,448,20,38657
ddc04d48-cbb9-43db-a8c1-ddf2cfae3bb1,tqme-vllm-base,1720362134,1720362879,finished,1720362152,1720362879,A100-SXM4-80GB,8,1,64,448,18,727
e733b3cb-bd2a-484c-aef9-51cfd006ccd8,cft-mt-lr1e-5-14b,1720362203,1720447529,finished,1720362223,1720447529,A100-SXM4-80GB,8,1,64,448,20,85306
9a43e54f-d3dd-4137-8f72-4fe195b68b50,test-0707,1720362478,1720367083,finished,1720362496,1720367083,A100-SXM4-80GB,8,1,64,896,18,4587
24aae51e-69f7-40a4-b3c0-016540a43038,tqme-vllm-base,1720362879,1720365304,finished,1720362897,1720365304,A100-SXM4-80GB,8,1,64,448,18,2407
ba6a07b0-bf88-4428-bb99-c5851ac7c2b5,geogpt-sft-construct-magpie-qwen2-monly-llama3-8b,1720362967,1720439308,finished,1720363004,1720439308,A100-SXM4-80GB,8,4,64,448,37,76304
db728868-3257-486b-950d-13d1510760fe,sql-spider-qy-0704-qwen,1720363834,1720364594,finished,1720363854,1720364594,A100-SXM4-80GB,8,1,64,448,20,740
42184cc0-5025-42a4-870f-d02668984c3e,sql-spider-qy-0704-qwen,1720364594,1720367257,finished,1720364613,1720367257,A100-SXM4-80GB,8,1,64,448,19,2644
9483620e-8159-4aec-8035-d2ef8930c3b3,sql-spider-qy-llama,1720364779,1720367239,finished,1720364799,1720367239,A100-SXM4-80GB,8,1,64,448,20,2440
de8e97df-a7d7-45d5-a858-8e6148160cde,test-0707,1720367175,1720590924,finished,1720367194,1720590924,A100-SXM4-80GB,8,1,64,896,19,223730
8336d407-1881-401a-b143-2f1d00ed3e70,llama3-8b-cpt-32k-1-5b-f8fae-auto,1720400704,1720404437,finished,1720400727,1720404437,A100-SXM4-80GB,8,1,64,896,23,3710
2bb8754d-fb0d-4d8f-a2c1-a2faae0026a4,qwen1-5-7b-lp40-s2-regate-m-4d524-auto,1720400875,1720438470,finished,1720400895,1720438470,A100-SXM4-80GB,8,1,64,448,20,37575
1cfc1348-177d-4f85-accd-0886ac4c6311,qwen1-5-7b-slp40-25bgeo-2ep-59442-auto,1720400895,1720421248,finished,1720400917,1720421248,A100-SXM4-80GB,8,1,64,448,22,20331
3e2a5ea9-6f5a-46ea-a779-535dc577d01b,qwen1-5-7b-50bcpt-2ep-986ab-auto,1720400896,1720421597,finished,1720400917,1720421597,A100-SXM4-80GB,8,1,64,448,21,20680
55b7ca29-0103-4905-bd7d-6ac061273962,debug,1720401479,1720409371,finished,1720401499,1720409371,A100-SXM4-80GB,8,1,64,896,20,7872
2475b9b2-2ef6-4748-a855-6d632ea46e1e,geogpt-qwen2-72b-12b-sample-cpt,1720401784,1720404674,finished,1720401841,1720404674,A100-SXM4-80GB,8,50,64,448,57,2833
9193183c-f6ab-43b7-92ca-3d6af14c69f5,sql-spider-qy-llama,1720401990,1720409318,finished,1720402010,1720409318,A100-SXM4-80GB,8,1,64,448,20,7308
20e19c85-173c-4ab9-9dd2-6241ae76a83b,geogpt-moe-qwen2-1b5-2stage,1720402624,1720402758,finished,1720402682,1720402758,A100-SXM4-80GB,8,2,64,896,58,76
231b603d-4220-4028-81df-4d1c11d372a0,ruler-eval-0708-llama,1720402752,1720489275,finished,1720402771,1720489275,A100-SXM4-80GB,8,1,64,896,19,86504
690ddf74-a582-4e2e-a73c-247eb12a05e4,geogpt-moe-qwen2-1b5-2stage,1720402892,1720407630,finished,1720402930,1720407630,A100-SXM4-80GB,8,2,64,896,38,4700
77542b07-575a-4065-aa3f-50e0bfede1e0,opencompass-eval-0708,1720403222,1720412041,finished,1720403244,1720412041,A100-SXM4-80GB,8,1,64,896,22,8797
c64b4195-4e42-47ce-8954-e701c16c7156,ruler-eval-0708-llama,1720403378,1720431570,finished,1720403396,1720431570,A100-SXM4-80GB,8,1,64,896,18,28174
4f0933c7-7b50-4f76-9d51-b5c70b139d35,sfr-embedding-test,1720403581,1720576572,finished,1720403599,1720576572,A100-SXM4-80GB,8,1,64,448,18,172973
52ec147c-81bc-44cc-b938-385824ddc998,tqme-vllm-base,1720403796,1720448561,finished,1720403816,1720448561,A100-SXM4-80GB,8,1,64,448,20,44745
6325f4f6-d611-4a27-98cc-a5313fdc8c1f,qwen2-72b-instruct-judge,1720403796,1720426730,finished,1720403816,1720426730,A100-SXM4-40GB,8,1,32,320,20,22914
4bb325fb-2723-46f4-bfd7-4cd8c264f721,cft-1-8m-sub-plus-mt-qwen2-72b,1720403866,1720447451,finished,1720403885,1720447451,A100-SXM4-80GB,8,1,64,448,19,43566
1ea7fd4c-00bd-4b5a-8bb3-8a1901e08d7c,llama3-8b-pt80k,1720403919,1720770550,finished,1720403977,1720770550,A100-SXM4-80GB,8,4,64,448,58,366573
890a5b22-dead-4da2-886b-777fe0078fa7,qwen2-moe-instruct-shumo-3f835-auto,1720403964,1720414464,finished,1720403982,1720414464,A100-SXM4-80GB,8,1,64,448,18,10482
d5caf702-9a1c-4b51-9729-aad3760d6862,slimorca-geo-mtm1-mt-wild-14b,1720404094,1720447470,finished,1720404112,1720447470,A100-SXM4-80GB,8,1,64,448,18,43358
3ad8500f-6c25-4665-9d68-024db3e0c9a8,llama3-8b-cpt-32k-1-5b-ae3c9-auto,1720404362,1720426757,finished,1720404381,1720426757,A100-SXM4-80GB,8,1,64,896,19,22376
c6d87ec4-f63f-44b4-9988-edb18ec48427,geogpt-7b-lp40-s2-sft-40w,1720404372,1720404488,finished,1720404408,1720404488,A100-SXM4-80GB,8,2,64,448,36,80
866d753a-52d8-4cd6-b183-f146e52d61d7,opencompass-eval-0708,1720404438,1720413801,finished,1720404457,1720413801,A100-SXM4-80GB,8,1,64,896,19,9344
d5e64fd3-ce5e-4ee8-9635-eafbd0f4762d,llama3-8b-cpt-80k-1-5b-f6ec4-auto,1720404457,1720456497,finished,1720404478,1720456497,A100-SXM4-80GB,8,1,64,896,21,52019
f201d5d8-eae9-49aa-b1a4-e991e870f3d8,ruler-eval-0708-llama,1720404459,1720431570,finished,1720404478,1720431570,A100-SXM4-80GB,8,1,64,896,19,27092
4270da53-9db1-4972-a113-e21d599b194a,geogpt-qwen2-72b-12b-sample-cpt,1720404674,1720504609,finished,1720404730,1720504609,A100-SXM4-80GB,8,100,64,448,56,99879
99241a36-f767-40ac-b2da-27d9740025d5,llama3-70b-23bcpt-2ep-7fbb0-auto,1720404909,1720407224,finished,1720404929,1720407224,A100-SXM4-80GB,8,1,64,448,20,2295
c3fd654e-84e2-4e77-8a13-6edc7585668b,qwen2-72B-6bcpt-2ep-c2bb1-auto,1720405042,1720407410,finished,1720405061,1720407410,A100-SXM4-80GB,8,1,64,448,19,2349
e79acddf-db38-4a27-8c6a-44d18bf8e99b,qwen1-5-7b-lp-6-2-25bgeo-dc895-auto,1720405250,1720407149,finished,1720405269,1720407149,A100-SXM4-80GB,8,1,64,448,19,1880
50dc179a-d680-4a84-900b-756fc51b6598,geogpt-prompt-tuning-tg-infer1,1720405922,1720406093,finished,1720405944,1720406093,A100-SXM4-80GB,8,1,64,448,22,149
43ecd369-0ac1-442d-832d-6193d05a93f3,geogpt-prompt-tuning-tg-infer2,1720405944,1720406191,finished,1720406113,1720406191,A100-SXM4-80GB,8,1,64,448,169,78
f6cf3212-3400-4fb8-b7cb-5be391795b48,geogpt-prompt-tuning-tg-infer1,1720406229,1720406740,finished,1720406250,1720406740,A100-SXM4-80GB,8,1,64,448,21,490
d40a3831-d590-4d13-8552-38413b6b0ba4,geogpt-prompt-tuning-tg-infer2,1720406288,1720407545,finished,1720406757,1720407545,A100-SXM4-80GB,8,1,64,448,469,788
c4dc2aef-eeb5-4507-84c1-f55e5f5cb0e3,sfr-eval,1720406353,1720406468,finished,1720406373,1720406468,A100-SXM4-80GB,8,1,64,448,20,95
7aed20f9-539e-4846-a5b9-ff10cdf070f3,geo-MoD-1-5B,1720406377,1720455535,finished,1720406434,1720455535,A100-SXM4-80GB,8,4,64,448,57,49101
b76faa8d-d31e-4b31-bbc1-77cd5d8c00f6,opencompass-eval-0708,1720406858,1720423831,finished,1720406877,1720423831,A100-SXM4-80GB,8,1,64,896,19,16954
f2ca7501-6750-4d16-b4d2-3c1952ffd792,ruler-eval-0708-llama,1720406913,1720429800,finished,1720406932,1720429800,A100-SXM4-80GB,8,1,64,896,19,22868
38371aef-260b-493b-ad96-0df2952573fe,Mistral-7b-v03-71687-auto,1720407072,1720409897,finished,1720407091,1720409897,A100-SXM4-80GB,8,1,64,448,19,2806
0e2b1b79-aea8-46aa-ad4c-4a32472376d8,geogpt-prompt-tuning-tg-infer1,1720407265,1720408044,finished,1720407563,1720408044,A100-SXM4-80GB,8,1,64,448,298,481
5d8d5c9b-d9bc-40b8-a67e-ab20e0f4f65f,geogpt-moe-qwen2-1b5-2stage,1720407630,1720454085,finished,1720407668,1720454085,A100-SXM4-80GB,8,2,64,896,38,46417
20b348cf-e6be-494b-84db-1a6f159e929d,reranker-inference,1720408014,1720580973,finished,1720408033,1720580973,A100-SXM4-80GB,8,1,64,448,19,172940
b156bb8e-cee2-42e3-82d0-02b578c5ead6,sql-spider-qy-0703,1720408148,1720409466,finished,1720408167,1720409466,A100-SXM4-80GB,8,1,64,448,19,1299
65907298-abeb-48fc-a88f-f399a0ddaa93,geogpt-prompt-tuning-tg-infer1,1720408176,1720409270,finished,1720408196,1720409270,A100-SXM4-80GB,8,1,64,448,20,1074
858dda52-ea03-46af-9e31-a083464f8624,reranker-inference11,1720408519,1720581482,finished,1720408537,1720581482,A100-SXM4-80GB,8,1,64,448,18,172945
3979685a-cd26-4aac-80c9-fee294ff26a9,sfr-eval,1720408740,1720408888,finished,1720408759,1720408888,A100-SXM4-80GB,8,1,64,448,19,129
6c7ac6e3-f239-4916-8789-5749df44671d,sfr-eval,1720409109,1720409593,finished,1720409127,1720409593,A100-SXM4-80GB,8,1,64,448,18,466
3a17b0f4-4ea6-4b33-9040-8dff40c076b5,sql-spider-qy-0703,1720409466,1720412217,finished,1720409485,1720412217,A100-SXM4-80GB,8,1,64,448,19,2732
2837a79e-0dc0-4dd2-8ae3-21bb393e67d1,geogpt-prompt-tuning-tg-infer1,1720409641,1720419127,finished,1720409661,1720419127,A100-SXM4-80GB,8,1,64,448,20,9466
ebb32611-714f-4caf-a0b0-6c3df2f5ca13,geo-72B,1720409735,1720413689,finished,1720409936,1720413689,A100-SXM4-80GB,8,16,64,896,201,3753
b09cebee-8a8a-465c-b458-abbc82b15b41,geogpt-7b-50bcpt-sft,1720409739,1720410008,finished,1720409778,1720410008,A100-SXM4-80GB,8,16,64,448,39,230
a7443304-5943-4ff1-ab80-0e1a3e32b276,mixtral-8x7b-instruct-v01-c196a-auto,1720409877,1720423703,finished,1720409897,1720423703,A100-SXM4-80GB,8,1,64,448,20,13806
220c4dc4-999f-4f4c-a481-fe2365c0d330,geogpt-7b-lp40-s2-sft-40w,1720409966,1720434775,finished,1720410008,1720434775,A100-SXM4-80GB,8,2,64,448,42,24767
36d9dfc6-8e5f-44a6-b54a-3b381a0ff3b2,geogpt-7b-50bcpt-sft,1720410008,1720422951,finished,1720413693,1720422951,A100-SXM4-80GB,8,16,64,448,3685,9258
6c1e08c7-dca4-4858-82b0-a42ed91eaa6e,sql-spider-qy-0703,1720412217,1720416431,finished,1720412235,1720416431,A100-SXM4-80GB,8,1,64,448,18,4196
f914f9db-5aa0-4504-b961-c21f95353974,geogpt-dairui-model-merge-exp-2,1720412425,1720412596,finished,1720412444,1720412596,A100-SXM4-80GB,8,1,64,896,19,152
ae59dff8-762e-4909-a08b-a81de2473b2f,geogpt-dairui-model-merge-exp-2,1720412633,1720421762,finished,1720412653,1720421762,A100-SXM4-80GB,8,1,64,896,20,9109
a7e9bf3f-37d7-4ff4-b6c0-ccfc4f2eedb2,sql-spider-qy-llama,1720415880,1720416411,finished,1720415899,1720416411,A100-SXM4-80GB,8,1,64,448,19,512
c9c38fdc-b2bc-4413-8848-328d9216e247,data-gen-magpie-3,1720416185,1720427180,finished,1720416203,1720427180,A100-SXM4-80GB,8,1,64,448,18,10977
cf6a972c-06a9-4b83-b79b-2a768de53161,sql-spider-qy-llama,1720416411,1720430427,finished,1720416431,1720430427,A100-SXM4-80GB,8,1,64,448,20,13996
adf260da-1504-48a3-88c3-fe3d848e7c6d,sql-spider-qy-0703,1720416431,1720419163,finished,1720416450,1720419163,A100-SXM4-80GB,8,1,64,448,19,2713
e933084f-f87e-4dba-8283-0ef6a4a05a6a,qwen1-14B,1720417593,1720422480,finished,1720417614,1720422480,A100-SXM4-80GB,8,1,64,896,21,4866
64ba0d48-eb4d-4ce2-9d2b-db4d797af3c1,geo-72B,1720418452,1720419143,finished,1720418509,1720419143,A100-SXM4-80GB,8,4,64,896,57,634
1246f761-fab4-4c37-85ee-0f6fd6cc8dfc,sfr-eval,1720418808,1720430183,finished,1720418828,1720430183,A100-SXM4-80GB,8,1,64,448,20,11355
c7c76f61-25bc-43d9-b27e-e1b2d1fb9705,geo-72B-test,1720418853,1720419241,finished,1720419140,1720419241,A100-SXM4-80GB,8,8,64,896,287,101
58bf2b8d-c98e-4527-b05b-1a3630e2767d,debug,1720419116,1720434213,finished,1720419136,1720434213,A100-SXM4-80GB,8,1,64,896,20,15077
217df918-4731-4b19-a0fa-95ccbd1c9051,geo-72B,1720419143,1720420066,finished,1720419279,1720420066,A100-SXM4-80GB,8,4,64,896,136,787
c578140b-c555-4e2f-96f7-8a9e9a9a3739,geogpt-prompt-tuning-tg-infer2,1720419151,1720426869,finished,1720419172,1720426869,A100-SXM4-80GB,8,1,64,448,21,7697
4c2f2580-7e91-4919-90c7-7a6eb72d0d3b,sql-spider-qy-0703,1720419163,1720421283,finished,1720419220,1720421283,A100-SXM4-80GB,8,1,64,448,57,2063
e52fa870-24fc-4549-ba6c-db200bf58954,geo-72B-test,1720419581,1720424862,finished,1720423112,1720424862,A100-SXM4-80GB,8,8,64,896,3531,1750
99ce9f77-e06a-4417-86af-78c9c724d4ad,geogpt-sft-1-8m-wo-geo-newfiltered-llama3-8b,1720419840,1720423092,finished,1720422989,1720423092,A100-SXM4-80GB,8,8,64,448,3149,103
109faad6-4505-4690-9f48-4dd8d50b3c29,geogpt-sft-qwen2-72b-datav081-ep1,1720419968,1720540885,finished,1720419989,1720540885,A100-SXM4-80GB,8,1,64,448,21,120896
0869f081-47f6-4fd4-a1d9-a4be63d7d45d,geo-72B,1720420066,1720423760,finished,1720422985,1720423760,A100-SXM4-80GB,8,8,64,896,2919,775
1d341abb-0614-4fe2-8f60-0723ae2086d3,mixtral-8x7b-instruct-v01-11ba5-auto,1720420069,1720422484,finished,1720420088,1720422484,A100-SXM4-80GB,8,1,64,448,19,2396
b503fa87-0bdd-4eeb-8fe9-fa122ab982da,geo-base-offline-eval,1720421048,1720421146,finished,1720421067,1720421146,A100-SXM4-80GB,8,1,64,448,19,79
d50f0b3d-7316-43fc-8066-0452da6582cf,mixtral-8x7b-instruct-2ep-6fd17-auto,1720421071,1720423354,finished,1720421090,1720423354,A100-SXM4-80GB,8,1,64,448,19,2264
910282b5-14e6-42fd-85ca-87164d70b949,txchen-lm-eval2,1720421231,1720423382,finished,1720421251,1720423382,A100-SXM4-80GB,8,1,64,448,20,2131
ad01328c-0411-44ba-a86d-81dd0348a94c,sql-spider-qy-0703,1720421283,1720425108,finished,1720421303,1720425108,A100-SXM4-80GB,8,1,64,448,20,3805
14cd4055-14a4-4e7a-98e0-b631bcdef828,geogpt-dairui-model-merge-exp-1,1720421533,1720422325,finished,1720421553,1720422325,A100-SXM4-80GB,8,1,64,896,20,772
28b238f0-722e-4245-ba10-436d7e793842,geogpt-dairui-model-merge-exp-2,1720421935,1720422170,finished,1720421954,1720422170,A100-SXM4-80GB,8,1,64,896,19,216
d06754a6-3998-4f6a-8761-410f7e88f7ad,mixtral-sft-test,1720422171,1720511872,finished,1720423857,1720511872,A100-SXM4-80GB,8,16,64,896,1686,88015
cf967aa5-faba-4e06-a53c-cd3de1f6af07,geogpt-dairui-model-merge-exp-1,1720422385,1720431061,finished,1720422405,1720431061,A100-SXM4-80GB,8,1,64,896,20,8656
412cf1a9-d952-475a-a699-fba14d662216,geogpt-prompt-tuning-tg-infer1,1720422492,1720449298,finished,1720427167,1720449298,A100-SXM4-80GB,8,1,64,448,4675,22131
e0eef496-9319-4383-a327-f31c7222afb7,mixtral-8x7b-instruct-v01-2-ebb4c-auto,1720422546,1720435860,finished,1720422566,1720435860,A100-SXM4-80GB,8,1,64,448,20,13294
9f5402e2-dd42-4a89-b92b-f7d963a398ba,geogpt-dairui-model-merge-exp-2,1720422848,1720424332,finished,1720422868,1720424332,A100-SXM4-80GB,8,1,64,896,20,1464
62f058a4-6beb-4ff3-a591-7d8caed77112,geo-mod-05b-test,1720423091,1720423212,finished,1720423135,1720423212,A100-SXM4-80GB,8,2,64,448,44,77
a4de5a38-b27a-4f30-8f20-8f8241ab6d62,geo-mod-05b-test,1720423274,1720423414,finished,1720423333,1720423414,A100-SXM4-80GB,8,2,64,448,59,81
20f0c1ab-92de-4dc2-83ba-606a931c9a7c,txchen-lm-eval2,1720423382,1720424451,finished,1720423402,1720424451,A100-SXM4-80GB,8,1,64,448,20,1049
4ac1fe89-b11e-4e8f-86db-8ddebec8cdd4,geo-mod-05b-test,1720423472,1720423586,finished,1720423511,1720423586,A100-SXM4-80GB,8,2,64,448,39,75
79abbf0c-f678-4c91-a4cd-2b4d3860f5cb,geo-mod-05b-test,1720423643,1720423779,finished,1720423702,1720423779,A100-SXM4-80GB,8,2,64,448,59,77
d3715abc-ace2-4bf0-ab9b-74ed376280ef,geo-mod-05b-test,1720423837,1720424938,finished,1720424881,1720424938,A100-SXM4-80GB,8,2,64,448,1044,57
adf558b2-6cd1-4fef-9e77-4b410020c666,llama3-8b-cpt-32k-3b-ed09e-auto,1720424288,1720455970,finished,1720424326,1720455970,A100-SXM4-80GB,8,1,64,896,38,31644
da98d0e6-9c20-4d72-86b9-4287d65472f2,txchen-lm-eval2,1720424451,1720425697,finished,1720424471,1720425697,A100-SXM4-80GB,8,1,64,448,20,1226
e7297d93-81ce-47be-82e9-2339a06d1d65,geogpt-dairui-model-merge-exp-2,1720424785,1720425034,finished,1720424844,1720425034,A100-SXM4-80GB,8,1,64,896,59,190
bf1a4572-1b65-474f-aed5-23de1b8df000,geo-mod-05b-test,1720424996,1720425109,finished,1720425034,1720425109,A100-SXM4-80GB,8,2,64,448,38,75
455d0cb4-c153-4478-933a-20805960447b,geo-mod-05b-test,1720425166,1720425298,finished,1720425223,1720425298,A100-SXM4-80GB,8,2,64,448,57,75
d3c7a057-be02-493f-9158-e3d2f249a13d,mistral-7b-instruct-v0-1,1720425316,1720437777,finished,1720425335,1720437777,A100-SXM4-40GB,8,1,32,320,19,12442
7d8d17ed-8cf0-482e-af09-6ab15077dbef,geo-mod-05b-test,1720425356,1720425495,finished,1720425414,1720425495,A100-SXM4-80GB,8,2,64,448,58,81
7cdd3d55-54a7-460e-b692-0f9366de0b7a,mistral-7b-test,1720425451,1720437758,finished,1720425472,1720437758,A100-SXM4-40GB,8,1,32,320,21,12286
3eaf3abf-19cc-465b-aed3-595b9349a416,geogpt-dairui-model-merge-exp-2,1720425473,1720425805,finished,1720425495,1720425805,A100-SXM4-80GB,8,1,64,896,22,310
e51108f2-16c9-4eb1-96c3-3d2c4446b4a5,geo-mod-05b-test,1720425552,1720425845,finished,1720425612,1720425845,A100-SXM4-80GB,8,2,64,448,60,233
37f2899e-e7d8-4f41-a594-badb32297f1c,sfr-embedding,1720425725,1720426146,finished,1720425743,1720426146,A100-SXM4-80GB,8,1,64,448,18,403
faa9ebef-6bb4-4cbb-9384-0dca6b59094d,llama3-8b-instruct-2d5c4-auto,1720425761,1720457796,finished,1720425781,1720457796,A100-SXM4-80GB,8,1,64,896,20,32015
6edc49e3-4a55-4730-b7ac-65ad693d953b,geogpt-sft-1-8m-wo-geo-newfiltered-llama3-8b,1720425827,1720428022,finished,1720425885,1720428022,A100-SXM4-80GB,8,8,64,448,58,2137
4dc9a661-09c8-45b9-bc0e-a209c82c49e3,geo-mod-05b-test,1720425962,1720428254,finished,1720428040,1720428254,A100-SXM4-80GB,8,2,64,448,2078,214
a8a8e9ce-fe3f-4c0a-a003-518259f59e49,sfr-embedding,1720426147,1720430339,finished,1720426165,1720430339,A100-SXM4-80GB,8,1,64,448,18,4174
9bb41c35-819d-40eb-bab9-b4db17b15349,lzk-qwen15-7b-scihub-abstract-homework-cpt,1720426198,1720433246,finished,1720426218,1720433246,A100-SXM4-80GB,8,1,64,448,20,7028
9d1ce227-484a-43cd-b3c9-a22da46ab6d4,txchen-lm-eval2,1720426238,1720428495,finished,1720426869,1720428495,A100-SXM4-80GB,8,1,64,448,631,1626
60744ef5-6b93-43df-832b-5a2bd8639286,qwen2-72b-chat-v1-5-0708-dpo,1720426768,1720461614,finished,1720457086,1720461614,A100-SXM4-80GB,8,16,64,448,30318,4528
5891c75b-f171-4455-99f6-a57a88365d2c,qwen2-72b-instruct-judge,1720426790,1720448954,finished,1720426809,1720448954,A100-SXM4-40GB,8,1,32,320,19,22145
af111d05-7333-496f-a84c-1f26daba9510,llama3-8b-ins-sft-32k-c-ep1-ff07b-auto,1720426835,1720454537,finished,1720428034,1720454537,A100-SXM4-80GB,8,1,64,896,1199,26503
56bab3db-d75c-41bb-9d72-9ddf4279a759,geogpt-dairui-model-merge-exp-2,1720427103,1720456197,finished,1720427997,1720456197,A100-SXM4-80GB,8,1,64,896,894,28200
dd046097-9ad1-4b0b-9465-799588e7f1b6,geogpt-dairui-eval-code,1720427441,1720428881,finished,1720428020,1720428881,A100-SXM4-80GB,8,1,64,896,579,861
81c48e6b-177f-47cf-89d9-a1e6a1867ae2,qwen7b-tcpt-lr-2e5-b1726-auto,1720427675,1720429496,finished,1720428028,1720429496,A100-SXM4-80GB,8,1,64,448,353,1468
baa572bf-7044-4639-9aa5-3cfa48aabfc4,qwen7b-tcpt-lr-2e5-hw-e1-68bd9-auto,1720427830,1720430967,finished,1720428028,1720430967,A100-SXM4-80GB,8,1,64,448,198,2939
df88ed2f-960d-42b9-b049-3f6112d47f1a,training-sora,1720427934,1720432795,finished,1720428794,1720432795,A100-SXM4-80GB,8,2,64,448,860,4001
dd473214-0fb4-4a85-878f-ff21f071800e,qwen7b-base-9c5e0-auto,1720428007,1720433025,finished,1720428028,1720433025,A100-SXM4-80GB,8,1,64,448,21,4997
6b7c6f3e-76e3-4d1f-b3f8-78e9edc941bd,qwen7b-chat-c12b6-auto,1720428049,1720429973,finished,1720428262,1720429973,A100-SXM4-80GB,8,1,64,448,213,1711
916b5ef1-dcfa-42fb-9bf6-5a3ee64bfeb9,geo-mod-05b-test,1720428373,1720428760,finished,1720428527,1720428760,A100-SXM4-80GB,8,2,64,448,154,233
a23df5d8-8a9e-4598-a955-823315ffa1bd,geogpt-dairui-eval-code,1720428882,1720429265,finished,1720428902,1720429265,A100-SXM4-80GB,8,1,64,896,20,363
706f6cbe-f33f-4331-8115-9f23469d91f3,geogpt-sft-1-8m-wo-geo-newfiltered-llama3-8b,1720429006,1720519238,finished,1720433260,1720519238,A100-SXM4-80GB,8,8,64,448,4254,85978
f53b569a-af0c-4e83-98e1-8e0fd957e368,qwen1-5-7b-7a8e3-auto,1720429452,1720463620,finished,1720429474,1720463620,A100-SXM4-80GB,8,1,64,448,22,34146
7cf03a5a-a7a3-4232-8d8c-8fdf045d2f1e,geogpt-dairui-eval-code,1720429469,1720430593,finished,1720429509,1720430593,A100-SXM4-80GB,8,1,64,896,40,1084
cdc008f3-1898-46d1-ae6a-969d5932dc69,qwen7b-tcpt-lr-8e5-aeddc-auto,1720429675,1720431209,finished,1720429754,1720431209,A100-SXM4-80GB,8,1,64,448,79,1455
92bd2e92-a505-4c07-b550-f9e17ceaa284,qwen1-5-7b-lp40-25bgeo-d3b3d-auto,1720429929,1720464113,finished,1720429950,1720464113,A100-SXM4-80GB,8,1,64,448,21,34163
45dac057-44f2-4a22-9a1d-58442e12e729,qwen7b-tcpt-lr-8e5-hw-e1-3a7cf-auto,1720430111,1720431974,finished,1720430134,1720431974,A100-SXM4-80GB,8,1,64,448,23,1840
6a232c23-369b-4acd-a1de-e641e537d24f,geo-mod-05b-test,1720430126,1720430634,finished,1720430385,1720430634,A100-SXM4-80GB,8,2,64,448,259,249
90554594-9a10-49f4-b08d-da92d61e52f8,geo-base-offline-eval,1720430343,1720442608,finished,1720430428,1720442608,A100-SXM4-80GB,8,1,64,448,85,12180
0491e248-9408-4ad6-8a6e-eeb88a0d4fb4,sql-spider-qy-0704-qwen,1720430425,1720433078,finished,1720430550,1720433078,A100-SXM4-80GB,8,1,64,448,125,2528
7ddb256b-340d-4016-a1df-78287642fb44,geogpt-dairui-eval-code,1720430593,1720431102,finished,1720430634,1720431102,A100-SXM4-80GB,8,2,64,896,41,468
d86adb6b-417e-461a-984a-e6dcdc5618ed,txchen-lm-eval2,1720430601,1720432749,finished,1720431229,1720432749,A100-SXM4-80GB,8,1,64,448,628,1520
74d55f20-a313-4f6c-ac7c-f509d45892c5,sql-spider-qy-llama,1720430675,1720433099,finished,1720431039,1720433099,A100-SXM4-80GB,8,1,64,448,364,2060
d4d33ed0-bd8e-4847-9b1b-b63efe5e571b,geo-mod-05b-test,1720430737,1720454086,finished,1720431122,1720454086,A100-SXM4-80GB,8,2,64,448,385,22964
53b04c74-42fd-463c-a9ea-5b313b22344f,sql-spider-qy-0703,1720430899,1720433037,finished,1720430979,1720433037,A100-SXM4-80GB,8,1,64,448,80,2058
ae426a6d-0f44-4ba3-9fac-3ba8d4a9b4a4,ruler-eval-0708-llama,1720431570,1720437887,finished,1720431591,1720437887,A100-SXM4-80GB,8,1,64,896,21,6296
cc46ab8d-d7e8-4ce2-9b18-564e92531b8e,ruler-eval-0708-llama,1720431570,1720437868,finished,1720431591,1720437868,A100-SXM4-80GB,8,1,64,896,21,6277
834e417b-100f-4766-a77b-791d232d6020,geogpt-dairui-eval-code,1720431926,1720433237,finished,1720432800,1720433237,A100-SXM4-80GB,8,2,64,896,874,437
7963b0bf-db04-4846-bc06-5531e0de8148,geogpt-dairui-model-merge-exp-1,1720431946,1720679186,finished,1720431986,1720679186,A100-SXM4-80GB,8,1,64,896,40,247200
485b4070-9e29-4dbe-b2ec-a565b0a34432,llama-factory-long,1720432856,1720433296,finished,1720432875,1720433296,A100-SXM4-80GB,8,1,64,448,19,421
836b99a7-d293-4683-bd98-f5809cc7b136,sql-spider-qy-0703,1720433037,1720440552,finished,1720433057,1720440552,A100-SXM4-80GB,8,1,64,448,20,7495
cf420aea-9e81-4a1f-b624-0232883f2c23,sql-spider-qy-0704-qwen,1720433078,1720441096,finished,1720433099,1720441096,A100-SXM4-80GB,8,1,64,448,21,7997
7dd2b3b4-f801-445c-aa26-5caefc5d7a38,sql-spider-qy-llama,1720433099,1720477507,finished,1720433120,1720477507,A100-SXM4-80GB,8,1,64,448,21,44387
1a100beb-320d-4b0c-8339-45f342a5413e,geogpt-dairui-eval-code,1720433238,1720435459,finished,1720434197,1720435459,A100-SXM4-80GB,8,2,64,896,959,1262
c41c3599-bb8c-4a7d-b78c-43b71ecbbc36,llama-factory-long,1720435052,1720436063,finished,1720435434,1720436063,A100-SXM4-80GB,8,4,64,448,382,629
aaacc948-11a1-4321-ad0d-8abdbe192e06,geogpt-dairui-eval-code,1720435459,1720504018,finished,1720435858,1720504018,A100-SXM4-80GB,8,1,64,896,399,68160
456ff05a-7ab2-45e4-8ff5-a722601e07c6,debug,1720436571,1720440303,finished,1720436591,1720440303,A100-SXM4-80GB,8,1,64,896,20,3712
a3d6b1a0-c410-432d-88a9-40c4f3f4b5c0,qwen7b-tcpt-lr-2e5-hw-plain-e1-0b83f-auto,1720437257,1720439851,finished,1720437277,1720439851,A100-SXM4-80GB,8,1,64,448,20,2574
e8128758-71b5-4573-ba24-25543ca5f57d,qwen7b-tcpt-lr-2e5-hw-plain-e1-4958c-auto,1720437354,1720439065,finished,1720437374,1720439065,A100-SXM4-80GB,8,1,64,448,20,1691
fb6b3380-4e8b-4131-b703-ab946fd1eb7c,qwen2-72b-open-vllm-test2,1720438178,1720493366,finished,1720438198,1720493366,A100-SXM4-40GB,8,1,32,320,20,55168
28ca612e-e2ee-45fd-87e7-0d2880895da7,slimorca-geo-mtm1-geotable-nt-14b,1720438699,1720524935,finished,1720438719,1720524935,A100-SXM4-80GB,8,1,64,448,20,86216
6455c9e6-6a7f-409b-92b6-bfdd94c8ff52,geogpt-7b-50bcpt-sft,1720439120,1720514776,finished,1720461632,1720514776,A100-SXM4-80GB,8,16,64,448,22512,53144
65ac8043-e1d6-4eba-9965-29486f2609eb,geogpt-eval-40wsft-bs1024,1720439271,1720442593,finished,1720439291,1720442593,A100-SXM4-80GB,8,1,64,448,20,3302
8ef54b87-5a0b-4984-a453-7b5184622824,geogpt-eval-40wsft-bs1024-comm,1720439311,1720739011,finished,1720439331,1720739011,A100-SXM4-80GB,8,1,64,448,20,299680
aea96146-60c8-49aa-b504-395e4e046b9d,qwen-72b-test,1720439441,1720440532,finished,1720439462,1720440532,A100-SXM4-80GB,8,1,64,448,21,1070
3b93c0d7-abcd-4f4a-858c-0549b87a9ed9,geo-72B,1720439843,1720454085,finished,1720440786,1720454085,A100-SXM4-80GB,8,8,64,896,943,13299
41f4bbbb-420f-452f-b3c4-93d26cd8df5d,geo-72B-memcost,1720439999,1720440788,finished,1720440038,1720440788,A100-SXM4-80GB,8,4,64,896,39,750
12c39bc7-37dd-48ea-88c8-feddf3dda004,debug,1720440303,1720443991,finished,1720440323,1720443991,A100-SXM4-80GB,8,1,64,896,20,3668
f7a4839c-a7e6-4823-a5ef-43576624937c,qwen-72b-test,1720440590,1720490812,finished,1720440609,1720490812,A100-SXM4-80GB,8,1,64,448,19,50203
1977d0fd-8793-46ca-8c97-635d4423c866,mixtral-8x7b-instruct-2ep-0d493-auto,1720440791,1720453009,finished,1720440811,1720453009,A100-SXM4-80GB,8,1,64,448,20,12198
c1339de0-7c35-43e8-b5d2-9e2466658f8d,llama3-8b-cpt-32k-1-5b-ae3c9-auto,1720440882,1720469392,finished,1720441091,1720469392,A100-SXM4-80GB,8,1,64,896,209,28301
7b20b51c-4d04-4016-8c08-159d5ecf2e64,mixtral-8x7b-sft-1ep,1720441060,1720546489,finished,1720449310,1720546489,A100-SXM4-80GB,8,4,64,896,8250,97179
d0e39b83-9a9c-4897-be6f-0bca5e3c7324,geo-72B-memcost,1720441306,1720456255,finished,1720455573,1720456255,A100-SXM4-80GB,8,8,64,896,14267,682
d8a38195-a348-4487-a6db-1eccc1848589,geo-72B-zero3,1720441327,1720457045,finished,1720456274,1720457045,A100-SXM4-80GB,8,8,64,896,14947,771
93141ffc-9776-4a72-99bf-3cfcbc244f0c,geo-72B-zero3,1720441329,1720456392,finished,1720454123,1720456392,A100-SXM4-80GB,8,8,64,896,12794,2269
2e46c51a-a696-4858-b8e6-48e7bfc8ffdc,qwen7b-base-new-ca0ac-auto,1720441877,1720447437,finished,1720442596,1720447437,A100-SXM4-80GB,8,1,64,448,719,4841
6e51aa1c-6c01-4739-8733-1a3b4bf5dcd3,sql-spider-qy-0704-qwen,1720441949,1720451994,finished,1720443972,1720451994,A100-SXM4-80GB,8,1,64,448,2023,8022
104f4149-302d-4f94-b309-eb86d4653a9f,sql-spider-qy-0703,1720442084,1720451172,finished,1720442568,1720451172,A100-SXM4-80GB,8,1,64,448,484,8604
b3782cde-6782-4f24-9302-9bd201724892,geogpt-72b-lp84-gate-10bcpt-2ep-eval3,1720442362,1720461730,finished,1720447454,1720461730,A100-SXM4-80GB,8,1,64,448,5092,14276
f37d9556-b5d9-4b6e-988c-dfa0335c63ec,cft-mt-lr5e-6-14b,1720447528,1720524934,finished,1720447549,1720524934,A100-SXM4-80GB,8,1,64,448,21,77385
f443db9a-7dc0-4cf3-b15c-7c716a5de36e,qwen2-72b-instruct-judge,1720449010,1720506557,finished,1720449028,1720506557,A100-SXM4-40GB,8,1,32,320,18,57529
75c290a1-e425-425d-af18-34648482f757,geogpt-prompt-multidataset-llama2-pre,1720449143,1720451243,finished,1720449317,1720451243,A100-SXM4-80GB,8,1,64,896,174,1926
800ff2bb-6928-4678-bf83-2d828e624f6d,geogpt-prompt-tuning-tg-infer2,1720449240,1720480777,finished,1720451262,1720480777,A100-SXM4-80GB,8,1,64,448,2022,29515
00781cdd-2ddd-4f71-8664-7c0aebf50e00,tq-embedding-2,1720450452,1720765407,finished,1720450473,1720765407,A100-SXM4-40GB,1,32,8,32,21,314934
c1f0a3cf-a026-4f2e-95e9-6d1f9cc93b0d,tq-embedding-3,1720450571,1720765429,finished,1720450595,1720765429,A100-SXM4-40GB,1,32,8,32,24,314834
9cab9952-ce7b-44c0-81ad-904a6b9c3b78,tq-embedding-1,1720450637,1720765429,finished,1720450661,1720765429,A100-SXM4-40GB,1,8,8,32,24,314768
29072788-8951-48dc-b63b-33cd0d91de07,sql-spider-qy-0703,1720451458,1720452106,finished,1720451975,1720452106,A100-SXM4-80GB,8,1,64,448,517,131
7a7edb83-3535-4cd7-bb35-3127d76fb74a,sql-spider-qy-0703,1720452405,1720453636,finished,1720452426,1720453636,A100-SXM4-80GB,8,1,64,448,21,1210
9c521106-03b8-42d7-9edf-e89a6a0d8209,sql-spider-qy-0704-qwen,1720452426,1720454163,finished,1720453006,1720454163,A100-SXM4-80GB,8,1,64,448,580,1157
fb48e191-c31f-447b-9df0-b61c3ebd88f8,sql-spider-qy-0704-qwen,1720455177,1720460776,finished,1720455196,1720460776,A100-SXM4-80GB,8,1,64,448,19,5580
2014404e-6487-48b8-b568-3e819f058ab2,sql-spider-qy-0703,1720455234,1720488586,finished,1720455253,1720488586,A100-SXM4-80GB,8,1,64,448,19,33333
6515480b-6449-417a-a6d9-64bf7ed0365b,geo-MoD-1-5B,1720455653,1720457024,finished,1720456216,1720457024,A100-SXM4-80GB,8,4,64,448,563,808
cbc6ab62-dd6e-41c8-ae06-7665f98a3436,geo-MoD-1-5B,1720457144,1720458028,finished,1720457200,1720458028,A100-SXM4-80GB,8,4,64,448,56,828
dad9a23c-6de6-4003-8d92-cfb01f869d57,llama3-8b-instruct-2d5c4-auto,1720457889,1720486860,finished,1720457909,1720486860,A100-SXM4-80GB,8,1,64,896,20,28951
28710e8d-abf3-48a1-b3b2-fdca0146e9b6,geo-seesaw-sft-code-alpaca-ultra-eval-test,1720457952,1720491241,finished,1720457972,1720491241,A100-SXM4-80GB,8,1,64,896,20,33269
f254f33e-9025-4c21-96a9-decb9016eb6f,geo-MoD-1-5B,1720458143,1720561915,finished,1720458199,1720561915,A100-SXM4-80GB,8,4,64,448,56,103716
7fb683e5-af4d-4d82-9695-a91f0834867c,geogpt-prompt-tuning-tg-infer1,1720458284,1720481939,finished,1720480796,1720481939,A100-SXM4-80GB,8,1,64,448,22512,1143
73cff510-9ddd-4fbb-a257-86cc09c0787d,llama3-70b-lp84-23bcpt-2ep-3d533-auto,1720464662,1720503513,finished,1720464681,1720503513,A100-SXM4-80GB,8,1,64,448,19,38832
cfe12fc6-b42c-495a-ad95-0e0149f2dc8d,qwen2-72b-6bcpt-2ep-45421-auto,1720465156,1720510878,finished,1720465176,1720510878,A100-SXM4-80GB,8,1,64,448,20,45702
7bb3c9cd-5405-4645-b269-eb38ccafd442,qwen1-5-7b-lp-6-2-25bgeo-21431-auto,1720470657,1720506192,finished,1720470676,1720506192,A100-SXM4-80GB,8,1,64,448,19,35516
a5767cbe-a7ea-46f9-a5b4-e399d413bd76,geo-base-offline-eval,1720484454,1720497276,finished,1720484472,1720497276,A100-SXM4-80GB,8,1,64,448,18,12804
e164a266-3d71-4911-9470-8a1658c64958,llama3-8b-cpt-32k-3b-ed09e-auto,1720487485,1720514156,finished,1720487504,1720514156,A100-SXM4-80GB,8,1,64,896,19,26652
5a54d2c4-42d0-42f1-952c-4e6cf45cf18b,llama3-8b-instruct-54f8e-auto,1720487542,1720496324,finished,1720487562,1720496324,A100-SXM4-80GB,8,1,64,896,20,8762
7c5d085e-003a-4f2a-85d2-8dc433f86a13,debug,1720487545,1720497522,finished,1720487565,1720497522,A100-SXM4-80GB,8,1,64,896,20,9957
5dc28089-ad73-49df-b8cd-35667308fa61,llama3-8b-ins-sft-32k-c-ep1-6fcfc-auto,1720487562,1720498185,finished,1720487581,1720498185,A100-SXM4-80GB,8,1,64,896,19,10604
d486ae6b-afd4-45f9-9b75-193541d9bf99,ruler-eval-0708-llama,1720487692,1720489256,finished,1720487710,1720489256,A100-SXM4-80GB,8,1,64,896,18,1546
eb4c8294-b62e-4d4c-851d-374c75589889,ruler-eval-0709,1720487837,1720524438,finished,1720487856,1720524438,A100-SXM4-80GB,8,1,64,896,19,36582
1712822e-70fb-4c7d-8655-a86abf79e9b0,geo-72B,1720488104,1720500064,finished,1720488144,1720500064,A100-SXM4-80GB,8,8,64,896,40,11920
9acd7795-37aa-4559-a283-34f48a62ad08,sql-spider-qy-0703,1720488958,1720489448,finished,1720488977,1720489448,A100-SXM4-80GB,8,1,64,448,19,471
998e4b49-57fe-4c6a-bab7-22c9344375e3,sql-spider-qy-0704-qwen,1720489092,1720495918,finished,1720489242,1720495918,A100-SXM4-80GB,8,1,64,448,150,6676
e43b72be-13ff-4484-bd71-9415091d8fd8,ruler-eval-0709,1720489217,1720525371,finished,1720489275,1720525371,A100-SXM4-80GB,8,1,64,896,58,36096
a08a8960-3f75-41d2-b2a1-1a53ea11b667,ruler-eval-0709,1720489293,1720489647,finished,1720489463,1720489647,A100-SXM4-80GB,8,1,64,896,170,184
d5721612-93b8-43d3-a3a0-e864d2efe781,sql-spider-qy-0703,1720489448,1720491611,finished,1720489632,1720491611,A100-SXM4-80GB,8,1,64,448,184,1979
6d76dfd5-ab8f-4f20-adb6-30b56aaa9b3f,geogpt-gate-base-common-2,1720489695,1720501011,finished,1720491264,1720501011,A100-SXM4-80GB,8,1,64,448,1569,9747
0207c429-dcd2-4633-8c39-1080525d282d,geogpt-gate-base-val-common,1720489714,1720490929,finished,1720490817,1720490929,A100-SXM4-80GB,8,1,64,448,1103,112
0e20fca3-9b29-4b2c-84e6-9dede03b5ed4,geogpt-angular-eval,1720489789,1720491264,finished,1720490910,1720491264,A100-SXM4-80GB,8,1,64,448,1121,354
4d4c6763-adeb-4134-8245-27f6e083c693,ruler-eval-0709,1720489968,1720491420,finished,1720491236,1720491420,A100-SXM4-80GB,8,1,64,896,1268,184
d1a052c0-6f88-48fa-9c46-3634ed81dd97,sql-spider-qy-llama,1720490307,1720508575,finished,1720500043,1720508575,A100-SXM4-80GB,8,1,64,448,9736,8532
e0fc122e-7276-4432-92e1-5a2ae77b4e98,llama3-8b-cpt-80k-1-5b-f6ec4-auto,1720490526,1720529216,finished,1720500117,1720529216,A100-SXM4-80GB,8,1,64,896,9591,29099
b931677e-edfc-4dd6-80fb-ce589829d02d,qwen-72b-test,1720490867,1720503550,finished,1720491666,1720503550,A100-SXM4-80GB,8,1,64,448,799,11884
965a7aad-ddbd-4a49-85b7-47d171db7ff7,llama-actsave,1720490942,1720491628,finished,1720491424,1720491628,A100-SXM4-80GB,8,1,64,448,482,204
ae27cfeb-e002-4812-be50-e866d87d2bea,tq-geo-extractor-cpu,1720491155,1720491211,finished,1720491174,1720491211,A100-SXM4-40GB,1,1,16,256,19,37
c88b7d29-fca9-4ea5-b79e-4b4990858c82,geogpt-gate-base-val-common,1720491283,1720509816,finished,1720500048,1720509816,A100-SXM4-80GB,8,1,64,448,8765,9768
497cbaa6-fd6a-4119-a0c3-b811475c82f7,geogpt-angular-eval,1720491467,1720491670,finished,1720491596,1720491670,A100-SXM4-80GB,8,1,64,448,129,74
798ab7e7-6449-423a-8b87-dd8bad2f85e7,ruler-eval-0709,1720491532,1720526910,finished,1720491643,1720526910,A100-SXM4-80GB,8,1,64,896,111,35267
2fcb40f7-d04e-4e6b-a9dd-a8f2508c4cc3,geogpt-72b-lp84-gate-10bcpt-2ep-eval,1720491766,1720497356,finished,1720497262,1720497356,A100-SXM4-80GB,8,1,64,448,5496,94
8cf1186e-2667-48fd-bfe5-dee347c0e727,geogpt-prompt-multidataset-llama2-pre,1720491770,1720498294,finished,1720498197,1720498294,A100-SXM4-80GB,8,1,64,896,6427,97
1a450aef-3ec8-4fa7-8eeb-bb454dbf1e66,geogpt-72b-lp84-gate-10bcpt-2ep-eval2,1720491786,1720621941,finished,1720495903,1720621941,A100-SXM4-80GB,8,1,64,448,4117,126038
336f330f-d9ed-487a-b240-da0e4b577ebb,geogpt-72b-lp84-gate-10bcpt-2ep-eval3,1720491827,1720497412,finished,1720497318,1720497412,A100-SXM4-80GB,8,1,64,448,5491,94
404817a0-1396-4d5a-8dbe-6fc9c9f26e3d,geogpt-72b-lp84-gate-10bcpt-2ep-eval4,1720491827,1720497490,finished,1720497375,1720497490,A100-SXM4-80GB,8,1,64,448,5548,115
e0cbf5ac-f316-4140-b73c-fb26f5fead91,geogpt-72b-lp84-gate-10bcpt-2ep-eval3,1720491846,1720500147,finished,1720500048,1720500147,A100-SXM4-80GB,8,1,64,448,8202,99
e22f5a87-9063-4dde-9a4f-7384b2517404,llama-actsave,1720491859,1720506104,finished,1720500160,1720506104,A100-SXM4-80GB,8,1,64,448,8301,5944
894ac5e5-f00e-4f6f-a457-aa9fdf259e9e,tq-geo-extractor-cpu,1720492314,1720492371,finished,1720492334,1720492371,A100-SXM4-40GB,1,1,16,256,20,37
b88316f5-b6ea-41ea-94c8-03aafae4169f,zjllm-sci-llama-3-7b-infer,1720492319,1720507354,finished,1720500057,1720507354,A100-SXM4-80GB,8,1,64,448,7738,7297
0c08d095-f8d1-4e4f-8f02-0c743d928595,tq-geo-extractor-cpu,1720492519,1720765384,finished,1720492539,1720765384,A100-SXM4-40GB,1,1,16,256,20,272845
d83646d5-95ad-468c-afc6-bbd6e1eb736b,qwen2-72b-open-vllm-test2,1720493421,1720579004,finished,1720493440,1720579004,A100-SXM4-40GB,8,1,32,320,19,85564
087be105-0706-4c44-bd59-fdfd5533df9c,qwen7b-base-b4fac-auto,1720493947,1720515661,finished,1720495662,1720515661,A100-SXM4-80GB,8,1,64,448,1715,19999
2966bed5-3914-4fa0-bd40-a5ae750e6c87,qwen7b-chat-e8462-auto,1720494006,1720515832,finished,1720496548,1720515832,A100-SXM4-80GB,8,1,64,448,2542,19284
5dda2359-9022-4b38-bd97-25f94a9f65e5,m8x7b-10bcpt-1ep-auxloss-f1980-auto,1720494020,1720499960,finished,1720497429,1720499960,A100-SXM4-80GB,8,1,64,448,3409,2531
ae9e1743-ce21-429f-bb6e-fc956d816188,qwen7b-tcpt-lr-2e5-cbf1f-auto,1720494084,1720521577,finished,1720500052,1720521577,A100-SXM4-80GB,8,1,64,448,5968,21525
96edf2a2-305f-4a21-b508-3325ae7f576f,qwen7b-tcpt-lr-8e5-5a7a9-auto,1720494216,1720520691,finished,1720500052,1720520691,A100-SXM4-80GB,8,1,64,448,5836,20639
5ca93752-ba6b-4c0b-b2d1-ba262f415541,geogpt-llama3-70b-lp84-22bcpt,1720495011,1720614937,finished,1720504698,1720614937,A100-SXM4-80GB,8,64,64,448,9687,110239
19532e76-90e6-49bd-acb3-f29685cf11a8,sql-spider-qy-0704-qwen,1720495918,1720500356,finished,1720496329,1720500356,A100-SXM4-80GB,8,1,64,448,411,4027
762834aa-2b92-4187-9fe0-f37d91af5070,geo-seesaw-sft-code-alpaca-ultra-eval-test,1720496444,1720631305,finished,1720497505,1720631305,A100-SXM4-80GB,8,1,64,896,1061,133800
964e7bac-501a-4c74-ab68-af39b83bb135,rag-bert-online,1720498128,1720498187,finished,1720498148,1720498187,A100-SXM4-40GB,1,1,8,32,20,39
3bd9461e-f246-40e5-b0e5-56394987e2f0,geogpt-qwen2-chat-0612dpo-linear-w55,1720498249,1720585606,finished,1720498269,1720585606,A100-SXM4-80GB,8,1,64,448,20,87337
b131d6b8-2601-495c-a3e3-b60f91638a91,llama3-70b-instruct,1720498429,1720499421,finished,1720499010,1720499421,A100-SXM4-40GB,8,1,32,320,581,411
87aa56c0-c270-47c0-a030-b927106fe867,rag-bert-online,1720498497,1720498731,finished,1720498517,1720498731,A100-SXM4-40GB,1,1,8,32,20,214
1da93a90-46b8-4f58-980a-175c22a24914,tqme-vllm,1720498626,1720512831,finished,1720499988,1720512831,A100-SXM4-80GB,8,1,64,448,1362,12843
3af3a07d-0d6a-4c6a-bfaa-aa4a75dbd2ec,geogpt-prompt-multidataset-llama2-pre,1720499149,1720500170,finished,1720500051,1720500170,A100-SXM4-80GB,8,1,64,896,902,119
4e671d37-0305-4ff6-905b-9fbaa0adcce1,geogpt-7b-lp40-s2-sft-1-8m-freezegate,1720499224,1720505016,finished,1720504672,1720505016,A100-SXM4-80GB,8,16,64,448,5448,344
55cbdfc9-5ce5-40fb-b995-8a7798c4fe91,geo-72B-memcost,1720500002,1720500472,finished,1720500044,1720500472,A100-SXM4-80GB,8,1,64,896,42,428
9a1157fc-7ed6-4b94-9781-3efe4145b21b,qwen7b-tcpt-lr-2e5-hw-e1-3bddc-auto,1720500191,1720517110,finished,1720500345,1720517110,A100-SXM4-80GB,8,1,64,448,154,16765
fb6483ae-6e3b-449e-9c91-8b279fe760e8,sql-spider-qy-0704-qwen,1720501067,1720501448,finished,1720501087,1720501448,A100-SXM4-80GB,8,1,64,448,20,361
691fa9ed-6176-497c-9990-5170cf705720,sql-spider-qy-0704-qwen,1720501448,1720517145,finished,1720501468,1720517145,A100-SXM4-80GB,8,1,64,448,20,15677
6e4c2633-9e24-4f33-8eb6-c5c5f08069f8,geo-72B-memcost,1720502606,1720503593,finished,1720502626,1720503593,A100-SXM4-80GB,8,1,64,896,20,967
02a2b559-f24e-45fe-8139-2da668843ce7,geo-base-moe-growing,1720502848,1720503712,finished,1720503550,1720503712,A100-SXM4-80GB,8,2,64,448,702,162
d9d32eba-5568-4485-8837-f4ea43101a65,qwen-72b-test,1720503612,1720505665,finished,1720503633,1720505665,A100-SXM4-80GB,8,1,64,448,21,2032
bc8e8272-5b0f-48f6-8d79-202d61d86919,debug,1720503729,1720511012,finished,1720503750,1720511012,A100-SXM4-80GB,8,1,64,896,21,7262
dda26f3e-fe41-41c2-bb03-3e056cf5a715,geo-base-moe-growing,1720503794,1720504077,finished,1720503854,1720504077,A100-SXM4-80GB,8,2,64,448,60,223
e0f3fa73-1ef1-4ac3-ba15-56a88ef5501d,llama3-70b-instruct,1720503902,1720592836,finished,1720503923,1720592836,A100-SXM4-40GB,8,1,32,320,21,88913
58e4cf82-71bb-4ec4-aa76-3af3f89ba7f6,geogpt-dairui-eval-code,1720504018,1720505296,finished,1720504038,1720505296,A100-SXM4-80GB,8,1,64,896,20,1258
7145fcfd-e286-46a7-a31f-13bad2e24cf4,geo-72B-memcost,1720504079,1720504865,finished,1720504101,1720504865,A100-SXM4-80GB,8,1,64,896,22,764
6f19fe2b-3409-456d-bf9d-51709d14b3cd,geo-base-moe-growing,1720504122,1720505095,finished,1720504667,1720505095,A100-SXM4-80GB,8,2,64,448,545,428
9dfd27d5-b10b-417d-b4b5-e19e957c9dd2,qwen2-72b-lp84-6bgeo-589e9-auto,1720504127,1720504891,finished,1720504148,1720504891,A100-SXM4-80GB,8,1,64,448,21,743
2566749f-11f8-4573-9b76-9071c9d4ef7a,go-test-05B,1720504865,1720505161,finished,1720504887,1720505161,A100-SXM4-80GB,8,1,64,896,22,274
010c6fe8-6c09-4a29-8a77-d7d7dcce9b62,rag-bert-online,1720505114,1720505178,finished,1720505136,1720505178,A100-SXM4-40GB,1,1,8,32,22,42
51c65aad-50c6-4bdf-af9d-d9e7d5752a64,geogpt-7b-lp40-s2-sft-1-8m-freezegate,1720505165,1720506046,finished,1720505226,1720506046,A100-SXM4-80GB,8,16,64,448,61,820
fbb5e1cd-e407-4094-a469-f6751367a6d0,geo-base-moe-growing,1720505274,1720505561,finished,1720505338,1720505561,A100-SXM4-80GB,8,2,64,448,64,223
81488aeb-ad93-4fe7-851e-7dfe47a69a57,rag-bert-online,1720505292,1720765199,finished,1720505313,1720765199,A100-SXM4-40GB,1,1,8,32,21,259886
b5f8807e-2ab4-47ce-bf74-4f2efbd8241a,geogpt-dairui-eval-code,1720505296,1720506209,finished,1720505317,1720506209,A100-SXM4-80GB,8,1,64,896,21,892
7996653a-be43-4361-8695-6c5dd9076a23,mixtral-sft-wo-cpt,1720505606,1720535394,finished,1720505667,1720535394,A100-SXM4-80GB,8,16,64,896,61,29727
a9376303-c9d1-40a8-8eff-6a7f3510e884,sfr-ft-3,1720505689,1720505934,finished,1720505710,1720505934,A100-SXM4-80GB,8,1,64,448,21,224
fb1d725d-5247-4659-b98f-64df0cb7fe01,qwen-72b-test,1720505733,1720509645,finished,1720505754,1720509645,A100-SXM4-80GB,8,1,64,448,21,3891
b43591ed-a161-4497-bb86-1790f11a7030,geo-base-moe-growing,1720505795,1720506084,finished,1720505856,1720506084,A100-SXM4-80GB,8,2,64,448,61,228
b45081b6-22a1-404b-9da9-5e3f573c9bdb,geogpt-72b-lp84-gate-10bcpt-2ep-eval,1720505901,1720506024,finished,1720505921,1720506024,A100-SXM4-80GB,8,1,64,448,20,103
c6ff856b-5316-4884-8965-cd114fccc5e6,qwen2-72b-12bsamplecpt-1-3ep-30203-auto,1720506068,1720508432,finished,1720506090,1720508432,A100-SXM4-80GB,8,1,64,448,22,2342
2e4cc2e8-e1c5-4dde-8329-99182c858761,qwen2-72b-10-8bcpt2ep-c06ad-auto,1720506148,1720552113,finished,1720506169,1720552113,A100-SXM4-80GB,8,1,64,448,21,45944
398568ab-be70-4749-a7c6-46af0c5eeefb,geogpt-dairui-eval-code,1720506209,1720507120,finished,1720506230,1720507120,A100-SXM4-80GB,8,1,64,896,21,890
687d0f51-2a06-46cb-8450-04c41d60ab88,geogpt-7b-lp40-s2-sft-1-8m-freezegate,1720506255,1720536096,finished,1720506300,1720536096,A100-SXM4-80GB,8,16,64,448,45,29796
65d0617e-804e-4179-90e0-7d9c4453c69d,geo-base-moe-growing,1720506273,1720506570,finished,1720506343,1720506570,A100-SXM4-80GB,8,2,64,448,70,227
692e14f6-d946-47b0-b74c-1bdbf4f636f8,llama-actsave,1720506292,1720514934,finished,1720506319,1720514934,A100-SXM4-80GB,8,1,64,448,27,8615
caac9b7e-6865-428a-8921-4e3d083748ac,geogpt-prompt-tuning-tg-infer1,1720506453,1720518530,finished,1720506476,1720518530,A100-SXM4-80GB,8,1,64,448,23,12054
c5f6d29b-555a-4e5b-a730-beb5b2b83020,qwen2-72b-instruct-judge,1720506617,1720510208,finished,1720506638,1720510208,A100-SXM4-40GB,8,1,32,320,21,3570
1c90c9fe-7e0b-4f3d-83d1-c002c7d31738,geogpt-llama3-70b-0521,1720506617,1720510228,finished,1720506638,1720510228,A100-SXM4-40GB,8,1,32,320,21,3590
26cf37ba-5fb1-403a-a4e9-0a30d6108812,geo-base-moe-growing,1720506672,1720509974,finished,1720506738,1720509974,A100-SXM4-80GB,8,2,64,448,66,3236
7063eefd-77cb-4eed-b1db-6cd59bb685fc,geogpt-72b-lp84-gate-10bcpt-2ep-eval3,1720506720,1720520811,finished,1720506743,1720520811,A100-SXM4-80GB,8,1,64,448,23,14068
b87b7e89-5084-42f5-a1e8-1af4e88289dd,geogpt-72b-lp84-gate-10bcpt-2ep-eval,1720506743,1720569638,finished,1720507488,1720569638,A100-SXM4-80GB,8,1,64,448,745,62150
ee0c8b0b-569f-4173-ae78-4c3ed741a34e,geogpt-72b-lp84-gate-10bcpt-2ep-eval4,1720506743,1720645516,finished,1720511852,1720645516,A100-SXM4-80GB,8,1,64,448,5109,133664
f3c0fcef-89b9-427f-8aca-e03b4539c0be,geogpt-72b-lp84-gate-10bcpt-2ep-eval3,1720506765,1720514533,finished,1720511852,1720514533,A100-SXM4-80GB,8,1,64,448,5087,2681
b5a8a1b7-ce62-4984-80b4-97e13086058c,sfr-ft-3,1720506817,1720507563,finished,1720507115,1720507563,A100-SXM4-80GB,8,1,64,448,298,448
0d007ab9-596b-4cbe-84f9-f083cacc979b,geogpt-dairui-eval-code,1720507120,1720524225,finished,1720509995,1720524225,A100-SXM4-80GB,8,2,64,896,2875,14230
0205694b-e638-4b62-954d-cb2272dfe65e,geogpt-prompt-multidataset-llama2-pre,1720507287,1720509717,finished,1720509199,1720509717,A100-SXM4-80GB,8,1,64,896,1912,518
b52a3892-ea66-497f-a73c-11b2072c1eaf,zjllm-sci-llama-3-7b-infer,1720507354,1720509473,finished,1720507374,1720509473,A100-SXM4-80GB,8,1,64,448,20,2099
dfe1210d-896c-4b71-8dc2-4a28f068bf37,llama3-70b-10bcpt-1ep-05c7a-auto,1720507488,1720558339,finished,1720508640,1720558339,A100-SXM4-80GB,8,1,64,448,1152,49699
6a9804c1-de7e-4cf2-9ad3-7e2b36ac4f04,mixtral-8x22b-sft,1720507569,1720536113,finished,1720536055,1720536113,A100-SXM4-80GB,8,64,64,896,28486,58
19b46d2a-bc4b-46fe-ac55-78ecae97bbfe,sfr-embedding,1720507585,1721008620,finished,1720508465,1721008620,A100-SXM4-80GB,8,1,64,448,880,500155
a4b63827-d76e-47af-b193-e88f112efc76,sfr-ft-3,1720507812,1720509230,finished,1720508571,1720509230,A100-SXM4-80GB,8,1,64,448,759,659
0e0457ad-a8dc-4f9a-b872-1f329219d501,geo-base-moe-subtoken,1720508040,1720512187,finished,1720511890,1720512187,A100-SXM4-80GB,8,2,64,448,3850,297
1d96dab3-3194-49ce-bbf9-286928cabffd,go-test-05B,1720508063,1720508657,finished,1720508469,1720508657,A100-SXM4-80GB,8,1,64,896,406,188
46543589-bae9-4cbc-823f-7312fc913dd4,go-test-05B,1720509063,1720513120,finished,1720509104,1720513120,A100-SXM4-80GB,8,1,64,896,41,4016
118a4868-354f-4b00-a33c-d150dcdedd92,geogpt-prompt-eval-all,1720509154,1722219780,finished,1720509798,1722219780,A100-SXM4-80GB,8,1,64,896,644,1709982
73dffa30-f87e-41e9-82db-3e02fceba0c9,geogpt-dairui-model-merge-exp-2,1720509276,1720510489,finished,1720509482,1720510489,A100-SXM4-80GB,8,1,64,896,206,1007
e86621bb-8c89-42e9-b7b0-e5a0c3950f7d,zjllm-sci-llama-3-7b-infer,1720509473,1720512052,finished,1720509724,1720512052,A100-SXM4-80GB,8,1,64,448,251,2328
a9bfb0d2-6d61-44cd-8d15-98c28a911ffb,sql-spider-qy-0703,1720509502,1720511725,finished,1720509645,1720511725,A100-SXM4-80GB,8,1,64,448,143,2080
721b3dfe-2bcd-4aaa-be42-074a3bfc7570,geogpt-prompt-multidataset-llama2-pre,1720509717,1720559511,finished,1720518551,1720559511,A100-SXM4-80GB,8,1,64,896,8834,40960
dbd0f49e-8a82-481c-adc6-b0b8cb9a881c,training-sora,1720509888,1720546542,finished,1720510010,1720546542,A100-SXM4-80GB,8,1,64,448,122,36532
b30e56e9-4770-4da0-a71c-abd1cfc2c90a,qwen2-72b-instruct-judge,1720510269,1720765448,finished,1720510292,1720765448,A100-SXM4-40GB,8,1,32,320,23,255156
53be3595-1dcb-4e35-90d5-399dfef892cb,qwen-72b-test,1720510284,1720581228,finished,1720511704,1720581228,A100-SXM4-80GB,8,1,64,448,1420,69524
a24d8dda-e095-410a-ac1f-38fb567e8847,geogpt-llama3-70b-0521,1720510292,1720765469,finished,1720510313,1720765469,A100-SXM4-40GB,8,1,32,320,21,255156
12b0672f-ba2f-48c4-83df-f67f62868a35,geogpt-dairui-model-merge-exp-2,1720510489,1720562907,finished,1720510874,1720562907,A100-SXM4-80GB,8,1,64,896,385,52033
33d42863-90fd-4ffa-a602-40c9c0055c0e,sfr-ft-3,1720510749,1720512515,finished,1720511010,1720512515,A100-SXM4-80GB,8,1,64,448,261,1505
82905b8a-4e90-4805-b49a-8d32f659a86e,rag-embedding-sfr-offline,1720510810,1720510850,finished,1720510831,1720510850,A100-SXM4-40GB,1,1,8,32,21,19
1cf5e3c5-73c1-4d54-8222-a2dc00261598,rag-embedding-sfr-online,1720511296,1720511338,finished,1720511317,1720511338,A100-SXM4-40GB,1,1,16,256,21,21
b68058d3-cf59-49a1-9699-a3acf99b6306,sql-spider-qy-0703,1720511826,1720513452,finished,1720511847,1720513452,A100-SXM4-80GB,8,1,64,448,21,1605
c734c0bf-be68-453d-a7d7-b4eef131ee4c,geo-base-moe-growing,1720511870,1720512228,finished,1720511910,1720512228,A100-SXM4-80GB,8,2,64,448,40,318
07f6d8bc-90ba-4808-969f-617854c76718,bge-reranker-online,1720511948,1720512248,finished,1720511970,1720512248,A100-SXM4-40GB,1,1,8,32,22,278
68a26519-b8a3-4854-b364-e63b7aa25a21,zjllm-sci-llama-3-7b-infer,1720512052,1720512578,finished,1720512074,1720512578,A100-SXM4-80GB,8,1,64,448,22,504
ee885907-30f3-43e0-994b-a4a44658492e,llama3-70b-05d16-auto,1720512085,1720561880,finished,1720512107,1720561880,A100-SXM4-80GB,8,1,64,448,22,49773
1742198c-23b9-42e7-92b3-f3690d9e14dd,geo-base-moe-growing,1720512229,1720512713,finished,1720512291,1720512713,A100-SXM4-80GB,8,2,64,448,62,422
32d9cda9-00a2-4334-9159-3f584227b778,geo-base-moe-subtoken,1720512293,1720512564,finished,1720512354,1720512564,A100-SXM4-80GB,8,2,64,448,61,210
38d1cc08-558e-4040-96d1-b8ece0ca0659,debug,1720512435,1720513739,finished,1720512455,1720513739,A100-SXM4-80GB,8,1,64,896,20,1284
bb7eb66e-35c2-4c95-8e33-14317d898d11,sfr-ft-2,1720512538,1720512841,finished,1720512560,1720512841,A100-SXM4-80GB,8,1,64,448,22,281
fe829172-2c5c-4782-b3c6-5c6d93c5cfb1,geo-base-moe-subtoken,1720512564,1720512693,finished,1720512606,1720512693,A100-SXM4-80GB,8,2,64,448,42,87
01fd6569-52a4-4965-9048-786b0e5f7465,zjllm-sci-llama-3-7b-infer,1720512578,1720589917,finished,1720512599,1720589917,A100-SXM4-80GB,8,1,64,448,21,77318
4c623d77-127e-426c-ab37-c8f6a6fd716d,rag-reranker-online,1720512665,1720512776,finished,1720512690,1720512776,A100-SXM4-40GB,1,1,8,32,25,86
6c09923d-2610-4c69-9494-eb2e4f1ecb19,geo-base-moe-growing,1720512756,1720580268,finished,1720512823,1720580268,A100-SXM4-80GB,8,2,64,448,67,67445
2b719fd9-d8dd-4a54-93cd-0c5a455c8069,geo-base-moe-subtoken,1720512757,1720513078,finished,1720512801,1720513078,A100-SXM4-80GB,8,2,64,448,44,277
87564704-147e-4ebe-a83a-56566a5b5706,tqme-vllm,1720512831,1720513728,finished,1720512852,1720513728,A100-SXM4-80GB,8,1,64,448,21,876
a8c2e288-33e9-43f9-9215-b6ed21af74d0,sfr-ft-2,1720512923,1720513136,finished,1720512945,1720513136,A100-SXM4-80GB,8,1,64,448,22,191
72ef62af-754c-43eb-b8e1-735c4a9d8753,geo-base-moe-subtoken,1720513078,1720514486,finished,1720513140,1720514486,A100-SXM4-80GB,8,2,64,448,62,1346
4c229c42-43c2-4b73-ae25-a9445be13855,sfr-ft-2,1720513470,1720514382,finished,1720513491,1720514382,A100-SXM4-80GB,8,1,64,448,21,891
7954f10e-51b8-4647-8a9a-8c14054fc5bc,qwen2-72b-12bsamplecpt-1-3ep-75a50-auto,1720514440,1720560205,finished,1720514469,1720560205,A100-SXM4-80GB,8,1,64,448,29,45736
07ffa726-1228-483d-a569-81360088f770,geo-base-moe-subtoken,1720514486,1720515063,finished,1720514548,1720515063,A100-SXM4-80GB,8,2,64,448,62,515
90527d82-c809-49d3-868f-1418ec623838,mixtral-8x7b-instruct-3ep-e6fde-auto,1720514632,1720516994,finished,1720514653,1720516994,A100-SXM4-80GB,8,1,64,448,21,2341
ad95ce37-50cf-46ad-aedb-607ef50d53f9,llama-actsave,1720514996,1720515566,finished,1720515018,1720515566,A100-SXM4-80GB,8,1,64,448,22,548
09a465bc-0f4a-4997-bf21-ba672a98cc73,geo-base-moe-subtoken,1720515063,1720517055,finished,1720515125,1720517055,A100-SXM4-80GB,8,2,64,448,62,1930
3b7cb4a4-d2bf-412d-a3f6-5b34d4eca500,go-test-05B,1720515338,1720519358,finished,1720515360,1720519358,A100-SXM4-80GB,8,1,64,896,22,3998
02663d4f-8c2c-4664-b3a6-660f86424f1e,llama-actsave,1720515673,1720515864,finished,1720515695,1720515864,A100-SXM4-80GB,8,1,64,448,22,169
a46d95f3-e078-432f-8d22-3e0aa94a146f,qwen7b-tcpt-lr-8e5-hw-e1-e2c82-auto,1720515915,1720534214,finished,1720515936,1720534214,A100-SXM4-80GB,8,1,64,448,21,18278
db25e2f9-fe4c-4cac-becd-ab26a2582908,debug,1720516090,1720518135,finished,1720516111,1720518135,A100-SXM4-80GB,8,1,64,896,21,2024
56a1e06d-c396-4153-bb3b-5c367c8450af,rag-embedding-sfr-online,1720516906,1720765177,finished,1720516926,1720765177,A100-SXM4-40GB,1,1,16,256,20,248251
1745a47f-ab1d-41fb-b0fd-08f26c23a1d9,geo-base-moe-subtoken,1720517055,1720518380,finished,1720517101,1720518380,A100-SXM4-80GB,8,2,64,448,46,1279
d2799a15-0d6b-4b33-b00c-859055b80c89,rag-embedding-sfr-offline,1720517121,1720765176,finished,1720517143,1720765176,A100-SXM4-40GB,1,1,8,32,22,248033
8c4fac09-136c-4dec-9f01-a813513978a2,sql-spider-qy-0704-qwen,1720517145,1720519175,finished,1720517166,1720519175,A100-SXM4-80GB,8,1,64,448,21,2009
6ccc99c8-d2f7-4a9f-b7b9-6a3dc9544a50,sfr-ft-2,1720517245,1720518194,finished,1720517267,1720518194,A100-SXM4-80GB,8,1,64,448,22,927
82257932-c34d-4909-ae22-17d484108c75,llama-actsave,1720517247,1720574476,finished,1720517269,1720574476,A100-SXM4-80GB,8,1,64,448,22,57207
bbe233c6-2eda-4b4d-9bdd-844ca2d055fe,sql-spider-qy-0703,1720517335,1720532410,finished,1720517355,1720532410,A100-SXM4-80GB,8,1,64,448,20,15055
33191c9f-6cab-4817-b400-c08e812a7005,geo-base-moe-subtoken,1720518381,1720520785,finished,1720518441,1720520785,A100-SXM4-80GB,8,2,64,448,60,2344
de4eaded-7db4-4747-963f-50ab3ac56755,sfr-ft-4,1720518945,1720541777,finished,1720518966,1720541777,A100-SXM4-80GB,8,1,64,448,21,22811
1fb1316b-81ba-429b-a5df-5564c6ceae26,text-split2,1720519618,1720519869,finished,1720519641,1720519869,A100-SXM4-80GB,8,1,64,896,23,228
ad330d98-62c2-4317-a68d-e9d06b388d90,text-split,1720519640,1720519869,finished,1720519662,1720519869,A100-SXM4-80GB,8,1,64,448,22,207
605193af-dc3a-46b9-9a0c-4e4618174ece,llama-factory-long,1720519785,1720523664,finished,1720519845,1720523664,A100-SXM4-80GB,8,4,64,448,60,3819
d83ae1e0-1407-46a8-8927-84ad2436eb16,sql-spider-qy-llama,1720520134,1720520581,finished,1720520154,1720520581,A100-SXM4-80GB,8,1,64,448,20,427
cdcee994-bd8f-4089-9470-51d78d287dc0,text-split2,1720520194,1720521067,finished,1720520214,1720521067,A100-SXM4-80GB,8,1,64,896,20,853
96538276-1e42-4c4a-8164-20bb796bef8a,tqme-vllm,1720520368,1720521739,finished,1720520389,1720521739,A100-SXM4-80GB,8,1,64,448,21,1350
32b8f5d6-1cc9-4696-a8c4-8e4e7e061df9,geo-base-moe-subtoken,1720520785,1720522126,finished,1720520847,1720522126,A100-SXM4-80GB,8,2,64,448,62,1279
1a1ac001-a433-47ce-b4c5-c1c65cca7cbe,text-split,1720520826,1720520946,finished,1720520845,1720520946,A100-SXM4-80GB,8,1,64,448,19,101
1096db35-8cc1-4720-943b-acd0e828e5af,sql-spider-qy-llama,1720520908,1720521369,finished,1720520927,1720521369,A100-SXM4-80GB,8,1,64,448,19,442
89258cf6-fe38-487b-8166-e4f27c2c722a,text-split2,1720521067,1720557141,finished,1720521087,1720557141,A100-SXM4-80GB,8,1,64,896,20,36054
00a82102-4177-4891-b3d3-2dc0c89551ef,text-split,1720521148,1720576958,finished,1720521168,1720576958,A100-SXM4-80GB,8,1,64,448,20,55790
58c7681f-fbd1-4368-b656-e0a529d21a8d,llama-factory-cpt-80k-lora,1720521646,1720524156,finished,1720521687,1720524156,A100-SXM4-80GB,8,4,64,448,41,2469
2432efef-c74d-4079-843d-4406d02324b4,llama-factory-long,1720523664,1720524178,finished,1720523706,1720524178,A100-SXM4-80GB,8,4,64,448,42,472
7f2ebdbe-f0eb-4ebf-8190-24e645a83a72,qwen1-5-7b-50bcpt2ep-1-8msft-1b62b-auto,1720523673,1720535673,finished,1720523694,1720535673,A100-SXM4-80GB,8,1,64,448,21,11979
8cea4aa1-36b4-4eb0-ac9e-a55fa48df934,llama-factory-cpt-80k-lora,1720524156,1720746946,finished,1720524219,1720746946,A100-SXM4-80GB,8,4,64,448,63,222727
400c5ad3-4b60-41c7-9fd5-ba2bacd196fc,llama-factory-long,1720524178,1720765809,finished,1720524218,1720765809,A100-SXM4-80GB,8,4,64,448,40,241591
0dbb9855-6b0a-46e4-afcd-f9cce4b56299,qwen1-5-7b-50bcpt2ep-1-8msft-6207b-auto,1720524268,1720524575,finished,1720524289,1720524575,A100-SXM4-80GB,8,1,64,448,21,286
d349a02e-18e3-4d0a-80f7-0ea313fd07e6,geogpt-prompt-tuning-tg-infer1,1720524412,1720561318,finished,1720559529,1720561318,A100-SXM4-80GB,8,1,64,448,35117,1789
5591014b-1355-457c-a1d7-1a25b141e8b9,mixtral-8x7b-instruct-3ep-ee476-auto,1720524488,1720536706,finished,1720524509,1720536706,A100-SXM4-80GB,8,1,64,448,21,12197
03e5712a-5442-4e8d-9da0-c6abe611b251,data-gen-magpie-3,1720524550,1720524713,finished,1720524573,1720524713,A100-SXM4-80GB,8,1,64,448,23,140
cdf86c8c-5cb2-4ef3-b8a8-1ad4e5e922f3,qwen1-5-7b-50bcpt2ep-1-8msft-9bdfb-auto,1720524554,1720526395,finished,1720524576,1720526395,A100-SXM4-80GB,8,1,64,448,22,1819
2f5ca067-975d-4910-b680-761042237cce,geogpt-dairui-eval-code,1720524813,1720538540,finished,1720524873,1720538540,A100-SXM4-80GB,8,2,64,896,60,13667
37e934cc-59c5-4a41-a6a8-14300081bbe4,cft-1-8m-sub-plus-mt-qwen2-72b,1720524996,1720611973,finished,1720525019,1720611973,A100-SXM4-80GB,8,1,64,448,23,86954
5753bc7b-3c14-49c4-b419-796f106bf94c,geogpt-dairui-eval-code-3,1720525017,1720552815,finished,1720525037,1720552815,A100-SXM4-80GB,8,1,64,896,20,27778
13450110-5b30-49b0-8644-a9f5e7e4d1bf,geogpt-sft-construct-magpie-qwen2-mc-llama3-8b-2,1720525479,1720525603,finished,1720525540,1720525603,A100-SXM4-80GB,8,4,64,448,61,63
7922cde2-4a87-41b2-9eb6-505bb25df6ae,m8x7b-10bcpt-1ep-auxloss-f1980-auto,1720525964,1720526577,finished,1720525985,1720526577,A100-SXM4-80GB,8,1,64,448,21,592
c66f5c34-164c-47a5-b36e-dd3f9fab6b5f,geogpt-sft-construct-magpie-qwen2-mc-llama3-8b-2,1720526207,1720574555,finished,1720526249,1720574555,A100-SXM4-80GB,8,4,64,448,42,48306
7c28a239-6488-4860-85fa-18d2e128a096,qwen1-5-7b-50bcpt2ep-1-8msft-9bdfb-auto,1720526517,1720528449,finished,1720526540,1720528449,A100-SXM4-80GB,8,1,64,448,23,1909
52507ec8-2217-4acd-97f6-f98df07e3177,geogpt-moe-qwen2-1b5-2stage,1720526617,1720526698,finished,1720526658,1720526698,A100-SXM4-80GB,8,2,64,896,41,40
d237f657-b69b-4f48-8b5c-6bc53a092469,geo-base-moe-subtoken,1720527036,1720527479,finished,1720527097,1720527479,A100-SXM4-80GB,8,2,64,448,61,382
9d491dfd-8b87-4b8d-bb32-abba2f73619e,geo-base-moe-subtoken,1720527479,1720528024,finished,1720527540,1720528024,A100-SXM4-80GB,8,2,64,448,61,484
4e40c499-35f0-4a40-8005-fe5ffa5eaa7e,geo-base-moe-subtoken,1720528024,1720528486,finished,1720528086,1720528486,A100-SXM4-80GB,8,2,64,448,62,400
003ba12e-6862-4357-8dbd-ad72bc49bfa3,geo-base-moe-subtoken,1720528486,1720528986,finished,1720528546,1720528986,A100-SXM4-80GB,8,2,64,448,60,440
452d5f97-4b27-42c5-8bce-35ee238e45f6,geogpt-moe-qwen2-1b5-2stage,1720534383,1720534463,finished,1720534443,1720534463,A100-SXM4-80GB,8,2,64,896,60,20
18b73b89-2a01-4084-8a38-84c82f50ac12,geogpt-merged-expert-moe-0b5-freeze-attn,1720534485,1720534568,finished,1720534527,1720534568,A100-SXM4-80GB,8,2,64,896,42,41
18973c68-7113-4b0e-95c8-3adcde386ffc,geogpt-moe-qwen2-1b5-2stage,1720534527,1720534607,finished,1720534568,1720534607,A100-SXM4-80GB,8,2,64,896,41,39
4556fdd9-c8e0-48ac-86fa-0a6239b8ef88,geogpt-sft-construct-magpie-qwen2-m-nc-llama3-8b,1720534823,1720535296,finished,1720534863,1720535296,A100-SXM4-80GB,8,4,64,448,40,433
c172d6b6-6da3-4399-9485-35056ab134d7,geogpt-sft-construct-magpie-qwen2-m-nc-llama3-8b,1720535453,1720535533,finished,1720535512,1720535533,A100-SXM4-80GB,8,4,64,448,59,21
c886ffb5-86d0-42f5-8476-f9294bd7233a,geogpt-sft-construct-magpie-qwen2-m-nc-llama3-8b,1720535732,1720535831,finished,1720535771,1720535831,A100-SXM4-80GB,8,4,64,448,39,60
76ceedb7-9a07-4aeb-85e9-2a7bdd2642f0,geogpt-moe-qwen2-1b5-2stage,1720535951,1720536053,finished,1720535992,1720536053,A100-SXM4-80GB,8,2,64,896,41,61
3093c2c5-6cc9-4949-9641-deb8f46c9fc0,geogpt-merged-expert-moe-0b5-freeze-attn,1720535951,1720536054,finished,1720536011,1720536054,A100-SXM4-80GB,8,2,64,896,60,43
b4083c44-5c51-47b4-a80f-c7eec45c1667,geogpt-sft-construct-magpie-qwen2-m-nc-llama3-8b,1720536092,1720536302,finished,1720536132,1720536302,A100-SXM4-80GB,8,4,64,448,40,170
1c0b800f-4644-4243-83a1-817a31bd04e4,mixtral-8x22b-sft,1720536222,1720536396,finished,1720536342,1720536396,A100-SXM4-80GB,8,64,64,896,120,54
76d91f0a-ac1b-43d8-92eb-2ed3c81123b5,mixtral-8x22b-sft,1720536563,1720536656,finished,1720536603,1720536656,A100-SXM4-80GB,8,64,64,896,40,53
c950f5a8-d75f-4d6d-8b58-5285002e3a7f,sql-spider-qy-0703,1720536724,1720536803,finished,1720536744,1720536803,A100-SXM4-80GB,8,1,64,448,20,59
ec518af2-635f-4906-a62c-9788cc6e0efb,mixtral-8x22b-sft,1720536826,1720536937,finished,1720536885,1720536937,A100-SXM4-80GB,8,64,64,896,59,52
f13b8d69-16ce-4a21-80aa-b60f29319007,sql-spider-qy-0703,1720537063,1720537177,finished,1720537083,1720537177,A100-SXM4-80GB,8,1,64,448,20,94
f3a65c1f-7aea-4595-ac22-2343292b8e5b,mixtral-8x22b-sft,1720537065,1720537159,finished,1720537105,1720537159,A100-SXM4-80GB,8,64,64,896,40,54
916e98e3-3911-419f-98ab-d54c7ce7857a,sql-spider-qy-0704-qwen,1720537245,1720537326,finished,1720537265,1720537326,A100-SXM4-80GB,8,1,64,448,20,61
ce8f8125-7632-4864-bee7-56774b820b50,mixtral-8x22b-sft,1720537329,1720537442,finished,1720537388,1720537442,A100-SXM4-80GB,8,64,64,896,59,54
9cfe32c8-ab2b-4cbd-88cd-500d2cdf9e1a,sql-spider-qy-0703,1720537527,1720575953,finished,1720537547,1720575953,A100-SXM4-80GB,8,1,64,448,20,38406
2c4d5fbd-1bd7-446e-a4c8-3577576d4413,sql-spider-qy-0704-qwen,1720537589,1720538402,finished,1720537608,1720538402,A100-SXM4-80GB,8,1,64,448,19,794
22f2642a-40c9-4a7b-ba33-f719fa5002d4,mixtral-8x22b-sft,1720537612,1720570972,finished,1720537671,1720570972,A100-SXM4-80GB,8,64,64,896,59,33301
30bd0933-5819-4741-9a6a-aaf569cadc1e,geogpt-moe-qwen2-1b5-2stage,1720537777,1720596356,finished,1720537840,1720596356,A100-SXM4-80GB,8,2,64,896,63,58516
cb6ec866-cd21-4087-bdc4-2f0fc00f2a6d,geogpt-merged-expert-moe-0b5-freeze-attn,1720537778,1720570546,finished,1720538559,1720570546,A100-SXM4-80GB,8,2,64,896,781,31987
e9899edf-a3db-4b78-8d7d-a403c627652c,geogpt-sft-construct-magpie-qwen2-m-nc-llama3-8b,1720537821,1720573440,finished,1720546509,1720573440,A100-SXM4-80GB,8,4,64,448,8688,26931
2b7fb95a-ee4d-4acd-85d4-045f0eda86b1,sql-spider-qy-0704-qwen,1720538402,1720553383,finished,1720538422,1720553383,A100-SXM4-80GB,8,1,64,448,20,14961
bcc3d1ae-adff-449a-b43d-eed1407a9989,geogpt-tableqa-sft-qwen2-72b-0703-datav091,1720547438,1720585603,finished,1720552147,1720585603,A100-SXM4-80GB,8,4,64,896,4709,33456
eb176ab2-4a5a-4e6a-9b41-926b23db8c02,mixtral-8x22b-sft,1720571030,1720572311,finished,1720571085,1720572311,A100-SXM4-80GB,8,64,64,896,55,1226
ce3bebdc-eb73-4523-b9f4-25888a40d16c,geo-base-offline-eval,1720571243,1720581267,finished,1720571262,1720581267,A100-SXM4-80GB,8,1,64,448,19,10005
5a689cc5-5212-4046-8172-4504a5975dbd,mixtral-8x22b-sft,1720572382,1720573650,finished,1720572438,1720573650,A100-SXM4-80GB,8,64,64,896,56,1212
2ed736e3-c192-41af-a806-1b60396db94c,geogpt-sft-construct-magpie-qwen2-m-nc-llama3-8b,1720573498,1720575128,finished,1720573536,1720575128,A100-SXM4-80GB,8,4,64,448,38,1592
ef4ece9c-2b25-43fd-acc4-2e25f8040e16,mixtral-8x22b-sft,1720573721,1720575033,finished,1720573778,1720575033,A100-SXM4-80GB,8,64,64,896,57,1255
bd514619-46dd-4a7d-b11d-250fdd601660,geogpt-moe-qwen15-a27B-alpaca-sft,1720574374,1720580854,finished,1720580773,1720580854,A100-SXM4-80GB,8,2,64,448,6399,81
2b398ace-b91a-481d-8d05-f018e2b2132c,llama3-8b-cpt-32k-3b-ed09e-auto,1720574376,1720596553,finished,1720574396,1720596553,A100-SXM4-80GB,8,1,64,896,20,22157
f4ba8da9-cbfb-4c8a-9811-a12202be745d,llama-actsave,1720574645,1720575143,finished,1720574665,1720575143,A100-SXM4-80GB,8,1,64,448,20,478
6b5a7e91-4b30-44d3-a156-b7d2385eddb4,sfr-ft-4,1720574818,1720577965,finished,1720574837,1720577965,A100-SXM4-80GB,8,1,64,448,19,3128
c4966c01-f7f8-4b8d-b2e8-e97216d4cae5,mixtral-8x22b-sft,1720575106,1720576344,finished,1720575165,1720576344,A100-SXM4-80GB,8,64,64,896,59,1179
c79dea9f-8025-4ec0-b3d4-121094622d14,llama-actsave,1720575210,1720575441,finished,1720575231,1720575441,A100-SXM4-80GB,8,1,64,448,21,210
f04a50d6-921b-4967-9cb2-7241cd03f1b9,geogpt-sft-construct-magpie-qwen2-m-nc-llama3-8b,1720575215,1720576982,finished,1720575272,1720576982,A100-SXM4-80GB,8,4,64,448,57,1710
3dec1a0e-c027-413f-874b-360797471df1,llama-actsave,1720575894,1720576144,finished,1720575913,1720576144,A100-SXM4-80GB,8,1,64,448,19,231
375bdc02-64f4-4b34-af29-06d33aad8716,geogpt-sft-construct-magpie-qwen2-mc-llama3-8b-2,1720576051,1720576417,finished,1720576109,1720576417,A100-SXM4-80GB,8,4,64,448,58,308
9a96c3be-19c2-4a19-ba2a-88218fd7930d,sql-spider-qy-llama,1720576186,1720580798,finished,1720576208,1720580798,A100-SXM4-80GB,8,1,64,448,22,4590
f295b49e-50f2-40cd-9220-8e28ac29427d,llama-actsave,1720576205,1720576413,finished,1720576226,1720576413,A100-SXM4-80GB,8,1,64,448,21,187
f5c44091-e666-40e5-a2a1-b42e40b6245e,marker-xiaodian,1720576354,1720576493,finished,1720576374,1720576493,A100-SXM4-80GB,8,1,64,448,20,119
56ebda15-3faa-421c-83ba-9556786c8431,mixtral-8x22b-sft,1720576417,1720577660,finished,1720576455,1720577660,A100-SXM4-80GB,8,64,64,896,38,1205
b133a01d-d784-4cd3-a62c-31ba686aae96,llama-actsave,1720576555,1720576784,finished,1720576574,1720576784,A100-SXM4-80GB,8,1,64,448,19,210
6fd988b7-94e8-47d0-b148-c9c69cc12846,rag-reranker-online,1720576956,1720577077,finished,1720576977,1720577077,A100-SXM4-40GB,1,1,8,32,21,100
9b6e01a9-a0c2-454e-9b20-6195c004725a,text-split,1720576958,1720591207,finished,1720576978,1720591207,A100-SXM4-80GB,8,1,64,448,20,14229
1c503fa9-da24-48b5-a03d-e3c632da0571,text-split2,1720576978,1720591207,finished,1720576998,1720591207,A100-SXM4-80GB,8,1,64,896,20,14209
c282e53d-aff1-4910-96ae-4476a11f9242,geogpt-sft-construct-magpie-qwen2-m-nc-llama3-8b,1720577042,1720579184,finished,1720577101,1720579184,A100-SXM4-80GB,8,4,64,448,59,2083
6c04b6c6-03e0-4120-b061-6f6d294ffbd4,qwen1-5-7b-chat-72730-auto,1720577045,1720578949,finished,1720577065,1720578949,A100-SXM4-80GB,8,1,64,448,20,1884
9eefd12d-8d71-47cf-84ff-ef163a813083,llama-actsave,1720577233,1720578982,finished,1720577252,1720578982,A100-SXM4-80GB,8,1,64,448,19,1730
4983d53b-8cb3-44f8-bd60-b7f37ada498c,rag-reranker-online,1720577516,1720577987,finished,1720577536,1720577987,A100-SXM4-40GB,1,1,8,32,20,451
e9ffb319-5f99-4a50-8076-257693f9e68b,geogpt-sft-qwen2-72b-datav081-ep1,1720577579,1720615236,finished,1720577598,1720615236,A100-SXM4-80GB,8,1,64,448,19,37638
d65850dd-5807-4d81-9a3f-b7367adf54d1,mixtral-8x22b-sft,1720577731,1720621825,finished,1720577770,1720621825,A100-SXM4-80GB,8,64,64,896,39,44055
1433da53-8311-4583-838c-0677442ca34e,sfr-ft-4,1720577965,1720580572,finished,1720577986,1720580572,A100-SXM4-80GB,8,1,64,448,21,2586
51c59690-77f7-43a7-a270-94379ca8c72a,rag-reranker-online,1720577987,1720747879,finished,1720578006,1720747879,A100-SXM4-40GB,1,1,8,32,19,169873
03aa0b52-d5e3-40c0-ac1d-9a143de9ffca,mixtral8x7b-instruct-1ep-wocpt-74b4e-auto,1720578052,1720580353,finished,1720578072,1720580353,A100-SXM4-80GB,8,1,64,448,20,2281
0a7437a7-4ec1-4c64-a1c9-8b79674682a5,mixtral-8x7b-instruct-1ep-1ec16-auto,1720578113,1720580394,finished,1720578132,1720580394,A100-SXM4-80GB,8,1,64,448,19,2262
568623af-eea3-4966-8999-a9b655351c7a,geogpt-eval-1-8msft,1720578135,1720727301,finished,1720578156,1720727301,A100-SXM4-80GB,8,1,64,448,21,149145
7013a253-675e-472d-90f8-f483e3a7eec9,geogpt-eval-1-8msft-c,1720578175,1720704369,finished,1720578195,1720704369,A100-SXM4-80GB,8,1,64,448,20,126174
ffd91191-2a02-439b-a27e-a1e72624555c,mixtral-8x7b-instruct-1ep-7d204-auto,1720578212,1720590933,finished,1720578233,1720590933,A100-SXM4-80GB,8,1,64,448,21,12700
142784d3-e0e5-4a0b-ae1c-e01d8d2e8358,mixtral8x7b-instruct-1ep-wocpt-a7b52-auto,1720578272,1720591343,finished,1720578292,1720591343,A100-SXM4-80GB,8,1,64,448,20,13051
10c7c370-7fe3-4e8e-87c8-62d29481e653,geogpt-sft-construct-magpie-qwen2-m-nc-llama3-8b,1720579246,1720579454,finished,1720579307,1720579454,A100-SXM4-80GB,8,4,64,448,61,147
5adbfa5f-3ca6-4fd3-9d48-d75daa904566,geogpt-sft-construct-magpie-qwen2-mc-llama3-8b-2,1720579473,1720579832,finished,1720579535,1720579832,A100-SXM4-80GB,8,4,64,448,62,297
f365fbd9-e991-44c4-b360-932eec88e27e,citysora-modelv4plus-256,1720579492,1720602282,finished,1720579554,1720602282,A100-SXM4-80GB,8,4,64,896,62,22728
9fea9f14-5eb4-4a2f-96b8-0936e5c7b29a,geogpt-sft-construct-magpie-qwen2-m-nc-llama3-8b,1720579991,1720580313,finished,1720580050,1720580313,A100-SXM4-80GB,8,4,64,448,59,263
72d07e83-278d-4575-aebb-7bfe38bd4bc6,geo-base-moe-subtoken,1720580190,1720580697,finished,1720580310,1720580697,A100-SXM4-80GB,8,2,64,448,120,387
5b7b9cc3-dab3-4e0e-ab37-6f0334a4bb05,geogpt-sft-construct-magpie-qwen2-m-nc-llama3-8b,1720580374,1720640362,finished,1720580435,1720640362,A100-SXM4-80GB,8,4,64,448,61,59927
f9eca0f5-5cbe-4b8d-840c-0187f4699edd,geogpt-sft-construct-magpie-qwen2-mc-llama3-8b-2,1720580435,1720617001,finished,1720580497,1720617001,A100-SXM4-80GB,8,4,64,448,62,36504
b788c2e7-31f0-4d2e-b035-5060d502c42d,sfr-ft-4,1720580572,1720581503,finished,1720580591,1720581503,A100-SXM4-80GB,8,1,64,448,19,912
f0767c54-c1a2-447f-9c41-cb257cde4a25,geogpt-prompt-tuning-tg-infer1,1720580726,1720581179,finished,1720580747,1720581179,A100-SXM4-80GB,8,1,64,448,21,432
7809efda-760b-4d57-a6c8-0399a8feb0ae,geo-base-moe-growing,1720580739,1720586434,finished,1720580879,1720586434,A100-SXM4-80GB,8,2,64,448,140,5555
32e11aa0-3103-46b8-aac7-ad6b5d243cdd,m8x7b-10bcpt-1ep-auxloss-f1980-auto,1720580821,1720596565,finished,1720580841,1720596565,A100-SXM4-80GB,8,1,64,448,20,15724
a10ed318-18d4-4569-9f7f-242a2f748527,qwen-72b-test,1720581285,1720594812,finished,1720581304,1720594812,A100-SXM4-80GB,8,1,64,448,19,13508
c1065278-9fe1-4678-99cc-fadfc8f90462,zj-llama3-sci-sft,1720581430,1720596546,finished,1720581452,1720596546,A100-SXM4-80GB,8,1,64,448,22,15094
80ac3864-59bd-4b1a-9fd1-4f5373b3a1f7,zj-llama3-sft,1720581474,1720668448,finished,1720581495,1720668448,A100-SXM4-80GB,8,1,64,448,21,86953
b91990ac-b0f2-4dab-8034-cb8ba0f15a59,sfr-ft-4,1720581503,1720754424,finished,1720581524,1720754424,A100-SXM4-80GB,8,1,64,448,21,172900
c9afdb79-09f6-418a-a704-49f9815b9134,sfr-ft-3,1720581524,1720582931,finished,1720581544,1720582931,A100-SXM4-80GB,8,1,64,448,20,1387
bfcf4c83-6f14-4cc8-8025-bc1dd1005247,sfr-ft-2,1720581544,1720581779,finished,1720581563,1720581779,A100-SXM4-80GB,8,1,64,448,19,216
03befec9-b35b-4067-8573-6050bb39c9ff,sfr-ft-2,1720581897,1720582203,finished,1720581917,1720582203,A100-SXM4-80GB,8,1,64,448,20,286
aba5ee62-58c2-433d-9bd2-6b549d6a2022,mixtral-8x22b-10bcpt-1ep-13e37-auto,1720582187,1720596565,finished,1720582209,1720596565,A100-SXM4-80GB,8,1,64,448,22,14356
303d001d-cbac-4039-8ee2-49f0dbdf9967,marker-xiaodian,1720582380,1720582461,finished,1720582400,1720582461,A100-SXM4-80GB,8,1,64,896,20,61
7464226f-ed2c-4395-b170-550432ef7a4f,geo-cpt-05B-geo-common-hsl,1720582488,1720892246,finished,1720582509,1720892246,A100-SXM4-80GB,8,1,64,896,21,309737
b50b770a-7bca-4547-8e79-a1480c7e822c,geogpt-prompt-tuning-tg-infer1,1720582820,1720582943,finished,1720582840,1720582943,A100-SXM4-80GB,8,1,64,448,20,103
0068d2f7-67b1-42bc-ab6a-8da294281e79,go-test-05B,1720582894,1720586037,finished,1720582915,1720586037,A100-SXM4-80GB,8,1,64,896,21,3122
75724e30-9819-4628-9bad-f4603ebc444e,geogpt-prompt-tuning-tg-infer1,1720583332,1720585120,finished,1720583358,1720585120,A100-SXM4-80GB,8,1,64,448,26,1762
575218a0-d1c1-4cb1-8e37-a53298243230,lzk-qwen15-7b-scihub-abstract-homework-sft,1720583796,1720611832,finished,1720583822,1720611832,A100-SXM4-80GB,8,1,64,448,26,28010
049a98a9-15b0-4f72-8282-e54f3b8c01be,geo-sae-test,1720584324,1720584431,finished,1720584350,1720584431,A100-SXM4-80GB,8,1,64,896,26,81
723caedb-c4d7-4a71-99b1-70a2ea564e67,mixtral-8x22b-v01-ae591-auto,1720584353,1720596566,finished,1720584380,1720596566,A100-SXM4-80GB,8,1,64,448,27,12186
c3d45e2a-aa32-40fd-b880-86c35d8821a3,mixtral-8x7b-10bcpt-1ep-s42-1c6d9-auto,1720584356,1720596536,finished,1720584380,1720596536,A100-SXM4-80GB,8,1,64,448,24,12156
c6cacac9-4c16-489d-9285-f9adc74b5a63,mixtral-test-3-4b988-auto,1720584382,1720596536,finished,1720584407,1720596536,A100-SXM4-80GB,8,1,64,448,25,12129
62f35864-8723-4cc4-abbc-86abba9631a7,geogpt-dairui-eval-code,1720584431,1720585759,finished,1720585632,1720585759,A100-SXM4-80GB,8,1,64,896,1201,127
406cffd8-dcc5-49fe-93ff-1f1499bb670b,geogpt-dairui-eval-code-3,1720584509,1720586488,finished,1720585710,1720586488,A100-SXM4-80GB,8,2,64,896,1201,778
5f45a5e3-3f72-4ce7-88cc-f3669f1eb764,geo-sae-test,1720584611,1720585684,finished,1720585107,1720585684,A100-SXM4-80GB,8,1,64,896,496,577
22e05cad-15cd-465f-ba52-aa472eef5119,geogpt-sft-80wc-magpie-qwen2-mc-new-zh-llama3-8b,1720585134,1720688746,finished,1720585657,1720688746,A100-SXM4-80GB,8,4,64,448,523,103089
c4f1c910-3ea1-4991-a809-b9ca39677b02,geogpt-dairui-eval-code,1720585885,1720586409,finished,1720586037,1720586409,A100-SXM4-80GB,8,1,64,896,152,372
b1759597-485a-47b7-af3d-b3df7d1a9c29,go-test-05B,1720586037,1720596103,finished,1720586409,1720596103,A100-SXM4-80GB,8,1,64,896,372,9694
ac3292d8-60d6-4a4f-a1ae-30824025cff5,geo-base-moe-growing,1720587884,1720588259,finished,1720587932,1720588259,A100-SXM4-80GB,8,2,64,448,48,327
bb0144d3-f3f7-4c75-b34f-d44091b88443,geo-base-moe-growing,1720588259,1720664743,finished,1720588334,1720664743,A100-SXM4-80GB,8,2,64,448,75,76409
5201d5f9-c1c0-425b-ba30-569245aad390,geo-base-moe-subtoken,1720588563,1720590172,finished,1720588614,1720590172,A100-SXM4-80GB,8,2,64,448,51,1558
3008d656-a617-4d2b-8172-845e7445d019,geogpt-dairui-eval-code-2,1720589603,1720590200,finished,1720589926,1720590200,A100-SXM4-80GB,8,1,64,448,323,274
bee6816e-142c-4331-8cd3-ad5270962f0d,geo-base-moe-subtoken,1720590172,1720591368,finished,1720590251,1720591368,A100-SXM4-80GB,8,2,64,448,79,1117
92c265b1-679c-4974-b843-99d412af91b7,geogpt-dairui-eval-code-2,1720590200,1720590378,finished,1720590226,1720590378,A100-SXM4-80GB,8,1,64,448,26,152
0f437b77-c16b-4182-8f0f-8e84fbb2c433,geo-sae-test,1720590353,1720590553,finished,1720590378,1720590553,A100-SXM4-80GB,8,1,64,896,25,175
e161a8fe-491a-43fc-a7dd-3ca07093e39b,txchen-cpu-task,1720590944,1720591094,finished,1720591019,1720591094,A100-SXM4-80GB,8,2,64,448,75,75
5ef7ca9c-8977-4705-abed-c4a060556da7,text-split,1720591207,1720660803,finished,1720591236,1720660803,A100-SXM4-80GB,8,1,64,448,29,69567
efbe0a64-788f-445e-a4da-ba252e6dda13,text-split2,1720591207,1720660804,finished,1720591236,1720660804,A100-SXM4-80GB,8,1,64,896,29,69568
de859301-0437-4c06-b936-b5ab58cfc4a7,geogpt-dairui-eval-code-2,1720591316,1720591664,finished,1720591342,1720591664,A100-SXM4-80GB,8,1,64,448,26,322
0ac4ff02-e5d0-4a9c-860c-78f7109881fd,geo-base-moe-subtoken,1720591368,1720592253,finished,1720591416,1720592253,A100-SXM4-80GB,8,2,64,448,48,837
78962f64-41a1-4d53-a525-71197c929231,reranker-base,1720591436,1720764425,finished,1720591462,1720764425,A100-SXM4-80GB,8,1,64,896,26,172963
8d962bef-833c-4979-9385-fe2057cee2e2,reranker-inference11,1720591437,1720764537,finished,1720591462,1720764537,A100-SXM4-80GB,8,1,64,448,25,173075
f7afd99a-6724-4c77-a6e3-e85c6f26cecd,mixtral-8x7b,1720591985,1720765581,finished,1720592010,1720765581,A100-SXM4-80GB,8,1,64,448,25,173571
bc94aeb7-0bc6-4bf3-a0e6-eaa2c555fe74,geo-base-moe-subtoken,1720592253,1720594144,finished,1720592328,1720594144,A100-SXM4-80GB,8,2,64,448,75,1816
3924e05f-fbb0-4388-901e-6e1e0f6f3fef,geogpt-dairui-eval-code-2,1720592801,1720594342,finished,1720594120,1720594342,A100-SXM4-80GB,8,1,64,448,1319,222
61854ffb-a69c-4b7a-a35a-19deb4c34a3f,llama3-70b-instruct,1720592909,1720768424,finished,1720594924,1720768424,A100-SXM4-80GB,8,1,64,448,2015,173500
3a90605b-7398-4921-845d-3ceacd28b74c,train-0710,1720593880,1720594932,finished,1720594335,1720594932,A100-SXM4-80GB,8,1,64,896,455,597
0c4a6bd6-c322-4a00-9923-fdfdc97668fd,geogpt-sft-qwen2-72b-datav08-ep1,1720593937,1720604141,finished,1720594119,1720604141,A100-SXM4-80GB,8,1,64,448,182,10022
0c3f623b-346e-4967-9302-4d729617f69a,geogpt-dairui-eval-code-2,1720594494,1720594939,finished,1720594814,1720594939,A100-SXM4-80GB,8,1,64,448,320,125
f4de1c02-df60-4aa1-b664-1fb22e4dc164,train-0710,1720594932,1720680331,finished,1720594956,1720680331,A100-SXM4-80GB,8,1,64,896,24,85375
662e247c-02bd-4f85-b909-d71232a5ebd2,zjllm-sci-llama-3-7b-infer,1720595298,1720596409,finished,1720596018,1720596409,A100-SXM4-80GB,8,1,64,448,720,391
12f8b68d-c279-42f5-8244-1262e9758172,sfr-ft-2,1720595300,1720596071,finished,1720595918,1720596071,A100-SXM4-80GB,8,1,64,448,618,153
6bf591ae-b29e-43db-b674-504e0a86fba0,geogpt-dairui-eval-code-2,1720595583,1720596328,finished,1720596077,1720596328,A100-SXM4-80GB,8,1,64,448,494,251
187c8601-c9b6-42cb-a450-3b8b3aef131b,go-test-05B,1720596290,1720596477,finished,1720596356,1720596477,A100-SXM4-80GB,8,1,64,896,66,121
0df340d4-fc53-4328-9f07-a792a469ad06,geogpt-dairui-eval-code-2,1720596328,1720596476,finished,1720596356,1720596476,A100-SXM4-80GB,8,1,64,448,28,120
875cc167-7ea9-41e4-87ce-f34be2eff785,marker-xiaodian,1720596405,1720597027,finished,1720596496,1720597027,A100-SXM4-80GB,8,1,64,896,91,531
7f840d07-0379-4d60-ba4f-c82dc15d9f79,zjllm-sci-llama-3-7b-infer,1720596409,1720598206,finished,1720596496,1720598206,A100-SXM4-80GB,8,1,64,448,87,1710
a6bf9187-a189-45bd-8bc9-6e63932a0f4c,geogpt-moe-qwen15-alpaca-sft,1720596412,1720596941,finished,1720596608,1720596941,A100-SXM4-80GB,8,2,64,448,196,333
f5379327-4c7a-4b45-8669-57f8359a04a0,sfr-embedding-test,1720596416,1720596971,finished,1720596609,1720596971,A100-SXM4-80GB,8,1,64,448,193,362
ddc21e21-faf7-47e6-a43d-f2f0f9ac2121,geogpt-moe-qwen2-1b5-2stage,1720596437,1720654880,finished,1720596590,1720654880,A100-SXM4-80GB,8,2,64,896,153,58290
f6421b25-50c1-41b2-9dd2-cca62408d487,qwen-72b-test,1720596474,1720597005,finished,1720596589,1720597005,A100-SXM4-80GB,8,1,64,448,115,416
f50bd8e0-d2a3-4350-b6dd-a5c2eda6d69f,geogpt-dairui-eval-code-2,1720596476,1720596698,finished,1720596506,1720596698,A100-SXM4-80GB,8,1,64,448,30,192
9d300443-bbf0-4bc7-9afa-5b4bdbba411e,go-test-05B,1720596477,1720604918,finished,1720596506,1720604918,A100-SXM4-80GB,8,1,64,896,29,8412
835b6fbe-21a8-48d1-9687-1830808154a1,geogpt-dairui-eval-code-3,1720596671,1720597823,finished,1720596698,1720597823,A100-SXM4-80GB,8,1,64,896,27,1125
1a172e1f-2688-4810-9e1f-4ee26e6227db,llama3-8b-cpt-32k-3b-ed09e-auto,1720596690,1720596942,finished,1720596719,1720596942,A100-SXM4-80GB,8,1,64,896,29,223
7895eaa7-5ed0-47f3-b81b-89de49008b3f,geogpt-dairui-eval-code-2,1720596698,1720597823,finished,1720596728,1720597823,A100-SXM4-80GB,8,1,64,448,30,1095
21323ac8-8bda-48c7-acfd-bc1cca6f913e,mixtral-8x22b-10bcpt-1ep-13e37-auto,1720596702,1720596954,finished,1720596732,1720596954,A100-SXM4-80GB,8,1,64,448,30,222
c848c6dd-150f-4fce-8590-6ce6c453f01d,sfr-ft-2,1720596885,1720597870,finished,1720597030,1720597870,A100-SXM4-80GB,8,1,64,448,145,840
c35fedf1-bc40-45ca-8f3f-0cc5893a8928,geo-mod-05b-test,1720596951,1720598583,finished,1720597007,1720598583,A100-SXM4-80GB,8,1,64,448,56,1576
0a1e5ff4-66df-4feb-b151-b319e9843ae4,sfr-embedding-test,1720596971,1720665320,finished,1720596998,1720665320,A100-SXM4-80GB,8,1,64,448,27,68322
84153e20-237e-44af-b4c4-112065b61d0a,llama-actsave,1720597001,1720597817,finished,1720597032,1720597817,A100-SXM4-80GB,8,1,64,448,31,785
0169d73c-f64b-487d-8357-47ebcdb30a74,qwen-72b-test,1720597005,1720597874,finished,1720597036,1720597874,A100-SXM4-80GB,8,1,64,448,31,838
15e8db12-89b1-43cf-81d1-2b54cab1136d,mixtral-8x22b-v01-ae591-auto,1720597010,1720597827,finished,1720597043,1720597827,A100-SXM4-80GB,8,1,64,448,33,784
2b6eb7b5-b621-47a1-85a1-76f5e044f5f0,marker-xiaodian,1720597027,1720597812,finished,1720597060,1720597812,A100-SXM4-80GB,8,1,64,896,33,752
eb755a96-8c13-454c-b2b2-37c2981f7a5c,geogpt-moe-qwen15-alpaca-sft,1720597377,1720694925,finished,1720614977,1720694925,A100-SXM4-80GB,8,2,64,448,17600,79948
1963cc38-5797-46ec-b4d4-b078de8febca,geo-base-moe-subtoken,1720597525,1720601832,finished,1720597875,1720601832,A100-SXM4-80GB,8,2,64,448,350,3957
17f76def-c6f3-4f2d-86dc-28a3eefb0c20,m8x7b-10bcpt-1ep-auxloss-f1980-auto,1720597540,1720597899,finished,1720597828,1720597899,A100-SXM4-80GB,8,1,64,448,288,71
894f06d6-feb5-4c0d-bdc6-94eebd87dfaf,marker-xiaodian,1720597812,1720597962,finished,1720597890,1720597962,A100-SXM4-80GB,8,1,64,896,78,72
1150634b-6c20-45a6-9c84-371f434b26ce,llama-actsave,1720597817,1720598902,finished,1720597846,1720598902,A100-SXM4-80GB,8,1,64,448,29,1056
b365c9c5-565a-4f40-805b-f8b1ad2c53a7,geogpt-dairui-eval-code-3,1720597823,1720598278,finished,1720597898,1720598278,A100-SXM4-80GB,8,1,64,896,75,380
00c39a99-e9f7-4783-a262-79874b1f761f,geogpt-ultrafuser-direct-eval,1720597826,1720597970,finished,1720597851,1720597970,A100-SXM4-80GB,8,1,64,448,25,119
ed60a482-6b2b-46c7-b835-592084da6abc,sfr-ft-2,1720597870,1720612010,finished,1720611860,1720612010,A100-SXM4-80GB,8,1,64,448,13990,150
cf938650-28e1-4efe-93f6-8839b0095669,qwen-72b-test,1720597874,1720615996,finished,1720606673,1720615996,A100-SXM4-80GB,8,1,64,448,8799,9323
a84bb1bf-25cc-45af-a811-d2429a4fc493,llama3-8b-cpt-32k-3b-ed09e-auto,1720597913,1720625378,finished,1720597942,1720625378,A100-SXM4-80GB,8,1,64,896,29,27436
6939d8c9-589a-4a29-8c71-eb547d35356a,mixtral-8x22b-10bcpt-1ep-13e37-auto,1720597924,1720643714,finished,1720598363,1720643714,A100-SXM4-80GB,8,1,64,448,439,45351
56b6bf89-e2eb-418c-9c18-adf629783229,mixtral-8x7b-10bcpt-1ep-s42-1c6d9-auto,1720597926,1720599685,finished,1720597950,1720599685,A100-SXM4-80GB,8,1,64,448,24,1735
65f46ca5-22da-4095-9b37-e5c0ab760953,mixtral-8x22b-v01-ae591-auto,1720597928,1720644014,finished,1720598279,1720644014,A100-SXM4-80GB,8,1,64,448,351,45735
474d55f4-2696-44be-b4cd-87fc65a0640a,m8x7b-10bcpt-1ep-auxloss-f1980-auto,1720597972,1720626911,finished,1720598237,1720626911,A100-SXM4-80GB,8,1,64,448,265,28674
2693a52c-10d4-4d15-8fc2-96f4af449094,marker-xiaodian,1720598045,1720598291,finished,1720598227,1720598291,A100-SXM4-80GB,8,1,64,896,182,64
8532b3e2-2db3-4c01-b1ec-9c157e649f59,zjllm-sci-llama-3-7b-infer,1720598206,1720771343,finished,1720598396,1720771343,A100-SXM4-80GB,8,1,64,448,190,172947
143e9ac2-d718-4b9a-bfe1-6c7c2115aa89,geogpt-ultrafuser-direct-eval,1720598279,1720598430,finished,1720598300,1720598430,A100-SXM4-80GB,8,1,64,448,21,130
996702a5-d86e-4ea3-88ac-1b088ee016e1,marker-xiaodian,1720598374,1720599547,finished,1720598420,1720599547,A100-SXM4-80GB,8,1,64,896,46,1127
ed94fdd2-91fa-441e-a1ce-f8887d41ed8c,geogpt-dairui-eval-code-3,1720598383,1720613562,finished,1720611865,1720613562,A100-SXM4-80GB,8,1,64,896,13482,1697
1b236672-181e-44e3-9521-9ae1391db404,geogpt-dairui-model-merge-exp-2,1720598428,1720602199,finished,1720601812,1720602199,A100-SXM4-80GB,8,1,64,896,3384,387
ee9d454d-8057-49e7-a249-c90d87b0c29a,qwen1-14B,1720598602,1720612518,finished,1720612032,1720612518,A100-SXM4-80GB,8,1,64,896,13430,486
f3b50c2e-9984-4ae7-98a4-c27fece4a3f6,geo-05b-print,1720598670,1720616624,finished,1720613694,1720616624,A100-SXM4-80GB,8,1,64,896,15024,2930
7c69bc38-5b5d-4741-8104-95d087c704a2,mixtral-8x7b-v01-36bc9-auto,1720598930,1720638401,finished,1720602285,1720638401,A100-SXM4-80GB,8,1,64,448,3355,36116
31a5cba9-2363-4a7d-a7aa-585e832f6ff0,marker-xiaodian,1720599632,1720602089,finished,1720601825,1720602089,A100-SXM4-80GB,8,1,64,896,2193,264
38a25da9-dd80-4336-be34-8ee3cae61afe,llama-actsave,1720599659,1720602476,finished,1720601851,1720602476,A100-SXM4-80GB,8,1,64,448,2192,625
66d47161-0e13-49fb-9324-11ac8527d671,geo-mod-05b-test,1720599683,1720602538,finished,1720602283,1720602538,A100-SXM4-80GB,8,1,64,448,2600,255
4c878311-e522-4630-a9d6-97178b14cc20,mixtral-8x7b-10bcpt-1ep-s42-1c6d9-auto,1720599786,1720638645,finished,1720602181,1720638645,A100-SXM4-80GB,8,1,64,448,2395,36464
db7b35e5-6d71-42d0-865a-1a7b736e5612,geogpt-prompt-tuning-tg-infer1,1720599815,1720621102,finished,1720611767,1720621102,A100-SXM4-80GB,8,1,64,448,11952,9335
8231eca1-6bd5-43c1-bb68-b46236bb6e02,qwen1-5-14b-42bcpt-8afcf-auto,1720600519,1720604820,finished,1720602311,1720604820,A100-SXM4-80GB,8,1,64,448,1792,2509
36732b07-0d20-428d-a659-c5875f68aae0,geogpt-sft-80wc-common-mix-new-30w-llama3-8b,1720600575,1720693777,finished,1720602304,1720693777,A100-SXM4-80GB,8,4,64,448,1729,91473
f2ab230d-2045-45ea-a263-e809e94e2e31,opencompass-eval-0710,1720601328,1720613837,finished,1720613601,1720613837,A100-SXM4-80GB,8,1,64,896,12273,236
58b149a8-6b06-424b-9122-c08c97ebc4af,marker-xiaodian,1720602172,1720602834,finished,1720602296,1720602834,A100-SXM4-80GB,8,1,64,896,124,538
a34dc878-71f2-4940-8f61-64061433f23e,citysora-modelv4plus-256,1720602283,1720662458,finished,1720614954,1720662458,A100-SXM4-80GB,8,4,64,896,12671,47504
0e5054c8-114c-4955-a107-e5500342c495,marker-xiaodian,1720602920,1720605447,finished,1720604910,1720605447,A100-SXM4-80GB,8,1,64,896,1990,537
049f54b4-a376-4cec-951b-ffbda95bf28f,geogpt-dairui-model-merge-exp-2,1720603031,1720604942,finished,1720604834,1720604942,A100-SXM4-80GB,8,1,64,896,1803,108
5fa0c4c1-8375-4346-972b-7ebe06885e32,geogpt-dairui-eval-code-2,1720603053,1720605833,finished,1720605707,1720605833,A100-SXM4-80GB,8,1,64,448,2654,126
226a64e0-b782-4798-93c2-b0529706d314,geogpt-dairui-eval-code,1720603383,1720605706,finished,1720604918,1720605706,A100-SXM4-80GB,8,1,64,448,1535,788
7c66282b-a6a4-4bcf-abc3-36f1a4c9b08c,geo-mod-05b-test,1720603655,1720606484,finished,1720605790,1720606484,A100-SXM4-80GB,8,1,64,448,2135,694
5adc3f0a-f509-4b00-a1fa-4a0f3fb6080d,geogpt-sft-qwen2-72b-datav08-ep1,1720604229,1720627887,finished,1720604917,1720627887,A100-SXM4-80GB,8,1,64,448,688,22970
ddf6bf2c-5719-49f9-ab90-ac187a4be1db,llama-factory-zj-test,1720604517,1720615508,finished,1720614980,1720615508,A100-SXM4-80GB,8,2,64,896,10463,528
3402cdc0-bd38-40c9-8897-105c46bda795,marker-xiaodian,1720605529,1720605762,finished,1720605699,1720605762,A100-SXM4-80GB,8,1,64,896,170,63
c11409ae-f367-4ebb-b05c-53d4c0d699ce,geogpt-dairui-model-merge-exp-2,1720605706,1720606716,finished,1720606568,1720606716,A100-SXM4-80GB,8,1,64,896,862,148
9f65fbc4-5045-41b0-a7a6-a509768ba4a7,marker-xiaodian,1720605846,1720606623,finished,1720606560,1720606623,A100-SXM4-80GB,8,1,64,896,714,63
1e5d8c52-b75d-44a3-8e5e-148571f6590f,geogpt-dairui-eval-code-2,1720606273,1720606568,finished,1720606463,1720606568,A100-SXM4-80GB,8,1,64,448,190,105
e1636007-c360-4653-87c0-e3a30532a71a,marker-xiaodian,1720606708,1720611857,finished,1720611795,1720611857,A100-SXM4-80GB,8,1,64,896,5087,62
7d36e9e8-04ca-4370-8673-fe2382232a0e,geogpt-dairui-model-merge-exp-2,1720608537,1720613628,finished,1720610242,1720613628,A100-SXM4-80GB,8,1,64,896,1705,3386
465a7b08-0f01-429f-8f31-3b4e9aaae88c,geogpt-dairui-eval-code-2,1720608538,1720610285,finished,1720610178,1720610285,A100-SXM4-80GB,8,1,64,448,1640,107
34f45a8c-b2af-4955-8147-9e184884b67b,llama3-8b-instruct-sft32k,1720609018,1720622801,finished,1720614949,1720622801,A100-SXM4-80GB,8,4,64,448,5931,7852
ff98a4e9-8fd3-497a-a36c-a32bc5059684,geogpt-ultrafuser-direct-eval,1720610182,1720615303,finished,1720613845,1720615303,A100-SXM4-80GB,8,1,64,448,3663,1458
cd96eb68-fd02-4043-a99d-7a779181ca59,mixtral-sft-wo-cpt,1720610418,1720644133,finished,1720614958,1720644133,A100-SXM4-80GB,8,16,64,896,4540,29175
54702444-e6c9-498a-9e5d-664a86b4efca,marker-xiaodian,1720611942,1720612283,finished,1720612007,1720612283,A100-SXM4-80GB,8,1,64,896,65,276
df649b9b-af72-43aa-a0bf-ece4afbcb436,geogpt-dairui-eval-code-2,1720612058,1720613584,finished,1720612521,1720613584,A100-SXM4-80GB,8,1,64,448,463,1063
7da0db12-6741-4e50-9701-cafae84da9b1,marker-xiaodian,1720612368,1720612577,finished,1720612513,1720612577,A100-SXM4-80GB,8,1,64,896,145,64
cd8575ff-8825-4506-a4cf-6aa372bbfe82,marker-xiaodian,1720612660,1720613643,finished,1720613576,1720613643,A100-SXM4-80GB,8,1,64,896,916,67
9344d687-39e6-4776-b709-0998abe8c298,geogpt-dairui-eval-code-3,1720613562,1720613693,finished,1720613585,1720613693,A100-SXM4-80GB,8,1,64,896,23,108
29ea13ca-026a-4256-bed7-368394a727ef,geogpt-dairui-eval-code-2,1720613585,1720613738,finished,1720613607,1720613738,A100-SXM4-80GB,8,1,64,448,22,131
a73264d1-d23e-4123-956b-949fbaf866b3,geo-mod-05b-test,1720613693,1720613974,finished,1720613716,1720613974,A100-SXM4-80GB,8,1,64,448,23,258
2abdd7d8-2043-44da-b41d-f60aa714dab6,marker-xiaodian,1720613730,1720613899,finished,1720613836,1720613899,A100-SXM4-80GB,8,1,64,896,106,63
99bad9cd-1e0c-446c-9e9a-1347e7fb6dcb,geogpt-dairui-eval-code-2,1720613952,1720614311,finished,1720613974,1720614311,A100-SXM4-80GB,8,1,64,448,22,337
ffb83324-4f22-4d2f-8ede-ba153317dfb6,geogpt-dairui-eval-code-3,1720613953,1720615192,finished,1720614906,1720615192,A100-SXM4-80GB,8,1,64,896,953,286
2fe4cb4c-4996-461e-be42-b66544127416,marker-xiaodian,1720613988,1720614365,finished,1720614303,1720614365,A100-SXM4-80GB,8,1,64,896,315,62
b245494a-c11c-48da-8346-61c0ede4ec81,geogpt-dairui-model-merge-exp-2,1720614059,1720614438,finished,1720614311,1720614438,A100-SXM4-80GB,8,1,64,896,252,127
10db48e3-16ac-4ece-890f-dbd992e98ead,geogpt-dairui-eval-code-2,1720614311,1720614740,finished,1720614416,1720614740,A100-SXM4-80GB,8,1,64,448,105,324
1a666aa4-0d09-4a6c-8bf6-da6107340f58,marker-xiaodian,1720614451,1720614815,finished,1720614753,1720614815,A100-SXM4-80GB,8,1,64,896,302,62
f4216fb2-a50d-45b5-b56e-42bb55d10ae2,geo-mod-05b-test,1720614481,1720615831,finished,1720614906,1720615831,A100-SXM4-80GB,8,1,64,448,425,925
4124d09c-b107-46fe-9c26-88104845dff2,geogpt-dairui-model-merge-exp-2,1720614653,1720614985,finished,1720614761,1720614985,A100-SXM4-80GB,8,1,64,896,108,224
bc49dd2d-5a67-44da-b8a4-11caa5af925a,marker-xiaodian,1720614898,1720614998,finished,1720614920,1720614998,A100-SXM4-80GB,8,1,64,896,22,78
ca906892-f584-4967-82e0-66a11a0ffe4f,marker-xiaodian,1720615097,1720615184,finished,1720615118,1720615184,A100-SXM4-80GB,8,1,64,896,21,66
7f29f7ea-f022-4e0f-9891-2c3b426dd979,geogpt-dairui-eval-code-3,1720615193,1720615618,finished,1720615214,1720615618,A100-SXM4-80GB,8,1,64,896,21,404
1f7585b4-2c53-470f-ba95-2f43a2c61351,marker-xiaodian,1720615272,1720615356,finished,1720615294,1720615356,A100-SXM4-80GB,8,1,64,896,22,62
4416e6e4-e9aa-4171-9e11-53a552c55a7b,marker-xiaodian,1720615441,1720615504,finished,1720615461,1720615504,A100-SXM4-80GB,8,1,64,896,20,43
c9332134-e454-4ad3-b55e-c303846ccce6,sfr-ft-3,1720615528,1720615696,finished,1720615549,1720615696,A100-SXM4-80GB,8,1,64,448,21,147
454f494e-4072-4f53-8fc5-4214eb27702a,marker-xiaodian,1720615589,1720615673,finished,1720615610,1720615673,A100-SXM4-80GB,8,1,64,896,21,63
5622b549-dae3-427e-9eba-489b9bacaec4,marker-xiaodian,1720615756,1720615844,finished,1720615776,1720615844,A100-SXM4-80GB,8,1,64,896,20,68
9ac4dd99-a260-4282-9bca-1802dad67571,geogpt-dairui-model-merge-exp-2,1720615785,1720616432,finished,1720615807,1720616432,A100-SXM4-80GB,8,1,64,896,22,625
3b451976-151f-4907-8185-132be6ef58ee,geogpt-dairui-eval-code-3,1720615808,1720616433,finished,1720615830,1720616433,A100-SXM4-80GB,8,1,64,896,22,603
cfae00c7-f7dd-4ba2-b792-76ffeb34a79f,marker-xiaodian,1720615927,1720616011,finished,1720615948,1720616011,A100-SXM4-80GB,8,1,64,896,21,63
95896e4c-6798-4bed-88ff-92d83240e72f,qwen-72b-test,1720616059,1720616516,finished,1720616079,1720616516,A100-SXM4-80GB,8,1,64,448,20,437
446bc5a8-61a4-4fc6-9196-0e4e39e32c95,marker-xiaodian,1720616093,1720616174,finished,1720616114,1720616174,A100-SXM4-80GB,8,1,64,896,21,60
1dca7f5d-9eb1-41d7-ab99-20ab248c5af0,marker-xiaodian,1720616256,1720616339,finished,1720616277,1720616339,A100-SXM4-80GB,8,1,64,896,21,62
b6b72e8e-b2c4-48c5-9637-d09c6325e192,marker-xiaodian,1720616425,1720616509,finished,1720616445,1720616509,A100-SXM4-80GB,8,1,64,896,20,64
ed5ec641-e8c5-4e60-af0d-ff0a6d3ef724,qwen-72b-test,1720616581,1720789747,finished,1720616601,1720789747,A100-SXM4-80GB,8,1,64,448,20,173146
359c450a-36e8-4cf9-b238-2d803287df96,marker-xiaodian,1720616595,1720616679,finished,1720616615,1720616679,A100-SXM4-80GB,8,1,64,896,20,64
580a947e-5d99-4094-abd0-a91fc3bd9be3,geo-05b-print,1720616624,1720617586,finished,1720616645,1720617586,A100-SXM4-80GB,8,1,64,896,21,941
9579223f-3b1f-42e6-963a-d753dd4c6261,llama-factory-zj-test,1720616661,1720617165,finished,1720616726,1720617165,A100-SXM4-80GB,8,2,64,896,65,439
9ee4646b-c9ea-47ea-82c7-3a19b480f801,geogpt-dairui-model-merge-exp-2,1720616708,1720617045,finished,1720616730,1720617045,A100-SXM4-80GB,8,1,64,896,22,315
72622b14-71e5-4509-9250-647882efee39,geogpt-dairui-eval-code-2,1720616731,1720617066,finished,1720616753,1720617066,A100-SXM4-80GB,8,1,64,448,22,313
726f163b-dd5e-43b0-800b-2994f5c0512a,marker-xiaodian,1720616766,1720616848,finished,1720616786,1720616848,A100-SXM4-80GB,8,1,64,896,20,62
9ce4a937-5331-4e68-bfcb-cbc1ae899812,marker-xiaodian,1720616931,1720617037,finished,1720616951,1720617037,A100-SXM4-80GB,8,1,64,896,20,86
259d34af-e256-4369-89e7-13e5324ec3df,geogpt-dairui-model-merge-exp-2,1720617045,1720617337,finished,1720617066,1720617337,A100-SXM4-80GB,8,1,64,896,21,271
38a82f9e-380a-48bf-99e3-4a4a27d15316,geogpt-dairui-eval-code-2,1720617067,1720617338,finished,1720617087,1720617338,A100-SXM4-80GB,8,1,64,448,20,251
850d5bc4-5981-4f5e-8dcf-122643f55502,marker-xiaodian,1720617121,1720617204,finished,1720617142,1720617204,A100-SXM4-80GB,8,1,64,896,21,62
9b5c2405-5267-4018-acda-704c2625eb91,marker-xiaodian,1720617287,1720617370,finished,1720617309,1720617370,A100-SXM4-80GB,8,1,64,896,22,61
72c99fc5-ef27-43a6-b05f-de605be0e7da,marker-xiaodian,1720617453,1720617534,finished,1720617473,1720617534,A100-SXM4-80GB,8,1,64,896,20,61
bc38909d-2378-495d-a6b5-4127daef5528,geo-05b-print,1720617586,1720618083,finished,1720617608,1720618083,A100-SXM4-80GB,8,1,64,896,22,475
ec088aa8-448b-4049-9d18-86228ecf65f6,marker-xiaodian,1720617621,1720617704,finished,1720617642,1720617704,A100-SXM4-80GB,8,1,64,896,21,62
39d25129-ea77-447a-a70b-c1aaf88a4aee,marker-xiaodian,1720617787,1720617869,finished,1720617808,1720617869,A100-SXM4-80GB,8,1,64,896,21,61
fce615bd-3ae7-4bdb-aebe-b04c254d79d3,marker-xiaodian,1720617951,1720618034,finished,1720617972,1720618034,A100-SXM4-80GB,8,1,64,896,21,62
6d43973e-99b6-477c-a903-1a1f700a5e53,geo-05b-print,1720618083,1720618312,finished,1720618104,1720618312,A100-SXM4-80GB,8,1,64,896,21,208
9c71031a-0052-4128-adc5-21af970671cd,marker-xiaodian,1720618118,1720618200,finished,1720618138,1720618200,A100-SXM4-80GB,8,1,64,896,20,62
1308da0a-4242-4ffc-b38e-a3d6c3f69fac,marker-xiaodian,1720618283,1720618366,finished,1720618304,1720618366,A100-SXM4-80GB,8,1,64,896,21,62
f491ca71-948e-4c72-b741-a57ea472dc13,marker-xiaodian,1720618448,1720618533,finished,1720618469,1720618533,A100-SXM4-80GB,8,1,64,896,21,64
a8b2ba72-f263-4cf9-aa00-7c1650ecf004,geo-05b-print,1720618477,1720619432,finished,1720618499,1720619432,A100-SXM4-80GB,8,1,64,896,22,933
2ac07740-1eb9-417a-b008-2feceb36a2d6,marker-xiaodian,1720618616,1720618699,finished,1720618637,1720618699,A100-SXM4-80GB,8,1,64,896,21,62
a06366be-307c-44f6-b6bc-4202982b3779,marker-xiaodian,1720618782,1720618864,finished,1720618803,1720618864,A100-SXM4-80GB,8,1,64,896,21,61
4590bdf8-b6a2-4541-999a-a6769ed4fcbc,marker-xiaodian,1720618946,1720619030,finished,1720618968,1720619030,A100-SXM4-80GB,8,1,64,896,22,62
3c4b1452-efef-4021-9a90-4ddb334f33eb,marker-xiaodian,1720619112,1720619174,finished,1720619132,1720619174,A100-SXM4-80GB,8,1,64,896,20,42
ee82b5a4-a6cc-4ada-add4-9997832ed51f,marker-xiaodian,1720619257,1720619341,finished,1720619278,1720619341,A100-SXM4-80GB,8,1,64,896,21,63
7ca310f6-aef6-445c-93a6-ccc2eff825d4,marker-xiaodian,1720619425,1720619509,finished,1720619446,1720619509,A100-SXM4-80GB,8,1,64,896,21,63
ed6ff330-c54b-4918-b44f-1eacf8b325e3,geo-05b-print,1720619432,1720659749,finished,1720619453,1720659749,A100-SXM4-80GB,8,1,64,896,21,40296
2f1e6977-f968-4867-aafa-799dc17f3e03,marker-xiaodian,1720619591,1720619673,finished,1720619611,1720619673,A100-SXM4-80GB,8,1,64,896,20,62
2334400f-fb03-47c6-a172-020951263b7e,test,1720619715,1720843615,finished,1720619738,1720843615,A100-SXM4-80GB,8,1,64,896,23,223877
39a46523-fe78-40bb-94ec-93e6bd615158,marker-xiaodian,1720619738,1720619822,finished,1720619760,1720619822,A100-SXM4-80GB,8,1,64,896,22,62
2b85bc0a-62cf-4325-9e1d-ea640907a9d8,marker-xiaodian,1720619904,1720620009,finished,1720619925,1720620009,A100-SXM4-80GB,8,1,64,896,21,84
6f42893e-2d60-48e3-bfbe-c3e8c4c52f0e,marker-xiaodian,1720620093,1720620176,finished,1720620114,1720620176,A100-SXM4-80GB,8,1,64,896,21,62
c7a62c8b-2e52-4449-8910-fc8b72836137,marker-xiaodian,1720620259,1720620343,finished,1720620280,1720620343,A100-SXM4-80GB,8,1,64,896,21,63
d74b5934-39ac-4c60-b2ac-404833c695d8,marker-xiaodian,1720620425,1720620508,finished,1720620445,1720620508,A100-SXM4-80GB,8,1,64,896,20,63
dea5761b-b2d3-4d5a-b2ed-beef4eb3fdf6,marker-xiaodian,1720620590,1720620673,finished,1720620611,1720620673,A100-SXM4-80GB,8,1,64,896,21,62
3b8ceb03-674d-42ef-a8ff-65beebd03ee1,marker-xiaodian,1720620756,1720620838,finished,1720620776,1720620838,A100-SXM4-80GB,8,1,64,896,20,62
cc84f86d-9d49-4135-bee2-4a224c17023b,marker-xiaodian,1720620921,1720621004,finished,1720620942,1720621004,A100-SXM4-80GB,8,1,64,896,21,62
53c2200f-f878-4ce1-8784-c78075dfaf1b,marker-xiaodian,1720621086,1720621170,finished,1720621108,1720621170,A100-SXM4-80GB,8,1,64,896,22,62
a303da8b-280a-4c48-a925-d66c8217cf7d,slimorca-geo-mtm1-geotable-nt-14b,1720621158,1720689997,finished,1720621179,1720689997,A100-SXM4-80GB,8,1,64,448,21,68818
c0461c65-babb-4315-a3bf-0340312ddb68,marker-xiaodian,1720621253,1720621336,finished,1720621274,1720621336,A100-SXM4-80GB,8,1,64,896,21,62
4bff729b-2592-40e8-8dc5-ade961e12a6b,marker-xiaodian,1720621420,1720621505,finished,1720621441,1720621505,A100-SXM4-80GB,8,1,64,896,21,64
6e54d281-bb8c-4584-9ef1-4a2fcd297fda,geogpt-moe-0b5-step4-freeze-attn,1720621491,1720624302,finished,1720621555,1720624302,A100-SXM4-80GB,8,2,64,896,64,2747
31d29759-dee8-4570-9473-8ed7306bbec6,marker-xiaodian,1720621589,1720621676,finished,1720621610,1720621676,A100-SXM4-80GB,8,1,64,896,21,66
c4c4713a-3f5d-4dad-bace-ca48a5d64303,geogpt-moe-0b5-start12-freeze-attn,1720621619,1720624303,finished,1720621684,1720624303,A100-SXM4-80GB,8,2,64,896,65,2619
7e583faa-fa70-4240-a53f-3dc01a71ef00,geogpt-llama3-lp84-sft,1720621731,1720622242,finished,1720621850,1720622242,A100-SXM4-80GB,8,64,64,448,119,392
880a9eda-aab7-4e56-8231-31b4ad8f494d,marker-xiaodian,1720621760,1720621928,finished,1720621796,1720621928,A100-SXM4-80GB,8,1,64,896,36,132
051f6680-0f83-4735-b51d-9478e14a616c,geogpt-7b-lp40-s2-sft-1-8m-freezegate,1720621898,1720651767,finished,1720621942,1720651767,A100-SXM4-80GB,8,16,64,448,44,29825
049548c6-ba64-48f5-bf2c-9c9d3d2f67b3,marker-xiaodian,1720622020,1720622125,finished,1720622041,1720622125,A100-SXM4-80GB,8,1,64,896,21,84
406b76c3-2c81-470a-8225-9d9856c58c20,marker-xiaodian,1720622209,1720622436,finished,1720622229,1720622436,A100-SXM4-80GB,8,1,64,896,20,207
eacae3b1-b8ca-4469-8c70-3a85dea3b8c7,geogpt-llama3-lp84-sft,1720622318,1720707550,finished,1720622380,1720707550,A100-SXM4-80GB,8,64,64,448,62,85170
52e5b09f-f4c1-4769-a38e-61503b3bb273,llama3-70b-lp84-23bcpt-09ep-9934a-auto,1720622513,1720624881,finished,1720622535,1720624881,A100-SXM4-80GB,8,1,64,448,22,2346
7c7dae6f-716c-4443-adb4-31491c523cc5,marker-xiaodian,1720622523,1720622627,finished,1720622544,1720622627,A100-SXM4-80GB,8,1,64,896,21,83
4959ba2d-f308-4888-b5a1-71faed43fc67,marker-xiaodian,1720622711,1720622798,finished,1720622732,1720622798,A100-SXM4-80GB,8,1,64,896,21,66
4d745181-9b12-4289-880d-8bcfaa997400,llama3-8b-instruct-sft32k,1720622801,1720624450,finished,1720622844,1720624450,A100-SXM4-80GB,8,4,64,448,43,1606
cae5a09c-36ad-403f-8d57-7b3b27beace5,marker-xiaodian,1720622884,1720622967,finished,1720622904,1720622967,A100-SXM4-80GB,8,1,64,896,20,63
c0027d6a-29b6-4290-b855-fbcd8c88cccc,marker-xiaodian,1720623051,1720623134,finished,1720623071,1720623134,A100-SXM4-80GB,8,1,64,896,20,63
e53104e8-6f89-40f8-b722-eded6e4e7c53,marker-xiaodian,1720623217,1720623301,finished,1720623238,1720623301,A100-SXM4-80GB,8,1,64,896,21,63
87c3eaa2-6008-4d08-b7e1-826bd2850f9a,marker-xiaodian,1720623385,1720623469,finished,1720623406,1720623469,A100-SXM4-80GB,8,1,64,896,21,63
9c350f9b-9a66-424e-a448-6ecf8cb7079d,marker-xiaodian,1720623554,1720623657,finished,1720623574,1720623657,A100-SXM4-80GB,8,1,64,896,20,83
ad1b2aa2-2b19-400c-a5ac-7cfbb112dcc0,llama-factory-long-sp-pt-test,1720623661,1720628541,finished,1720627407,1720628541,A100-SXM4-80GB,8,1,64,448,3746,1134
12b3acbf-9a1d-41d9-af6d-99ffd1999d4d,marker-xiaodian,1720623743,1720623826,finished,1720623763,1720623826,A100-SXM4-80GB,8,1,64,896,20,63
3cd22236-34bd-4f68-98d7-d6732940d181,marker-xiaodian,1720623909,1720623997,finished,1720623931,1720623997,A100-SXM4-80GB,8,1,64,896,22,66
05bee0b3-0304-4de0-b48f-b35143449733,geogpt-sft-80wc-magpie-qwen2-chm-llama3-8b,1720623962,1720702145,finished,1720624026,1720702145,A100-SXM4-80GB,8,4,64,448,64,78119
63e82fc5-2d04-47f7-a946-b49d8b7d65a7,marker-xiaodian,1720624081,1720624164,finished,1720624102,1720624164,A100-SXM4-80GB,8,1,64,896,21,62
96ab82ee-6fda-4cec-aa7c-c8c53c6d8d92,marker-xiaodian,1720624251,1720624338,finished,1720624273,1720624338,A100-SXM4-80GB,8,1,64,896,22,65
cdc2b4dc-7f05-4596-8050-8997dcc46962,geogpt-moe-0b5-step4-freeze-attn,1720624302,1720648391,finished,1720624367,1720648391,A100-SXM4-80GB,8,2,64,896,65,24024
20583d7c-7d49-4e35-afb5-32950f8edf07,geogpt-moe-0b5-start12-freeze-attn,1720624303,1720650794,finished,1720624346,1720650794,A100-SXM4-80GB,8,2,64,896,43,26448
d1888a02-6a06-454a-8fd1-ad13bd976476,marker-xiaodian,1720624422,1720624511,finished,1720624446,1720624511,A100-SXM4-80GB,8,1,64,896,24,65
11ed9cec-f888-4964-be7e-9f7604f1f348,llama3-8b-instruct-sft32k,1720624450,1720627385,finished,1720624514,1720627385,A100-SXM4-80GB,8,4,64,448,64,2871
dca192a0-9a81-45ee-9a3d-2b7060aa2bc9,marker-xiaodian,1720624596,1720624701,finished,1720624617,1720624701,A100-SXM4-80GB,8,1,64,896,21,84
17ad1f12-c79e-45bc-bb5d-9345a97bc724,marker-xiaodian,1720624785,1720624868,finished,1720624805,1720624868,A100-SXM4-80GB,8,1,64,896,20,63
e0613ee8-46cd-435b-8867-ea616f99f72c,marker-xiaodian,1720624952,1720625036,finished,1720624973,1720625036,A100-SXM4-80GB,8,1,64,896,21,63
e0a7d102-8d19-44d3-aa7c-59a520d46dd5,marker-xiaodian,1720625122,1720625206,finished,1720625142,1720625206,A100-SXM4-80GB,8,1,64,896,20,64
ae8cb0dd-426b-47b8-b5aa-a390620320f8,geo-05B-zero3,1720625278,1720626782,finished,1720625321,1720626782,A100-SXM4-80GB,8,2,64,896,43,1461
d0a11377-a886-4228-808b-f217285bda73,marker-xiaodian,1720625292,1720625376,finished,1720625313,1720625376,A100-SXM4-80GB,8,1,64,896,21,63
88026d55-6ad3-4237-926d-b8eb4b962e9e,marker-xiaodian,1720625461,1720625545,finished,1720625483,1720625545,A100-SXM4-80GB,8,1,64,896,22,62
9f114d15-5cc4-4c10-ad08-c91084e6a800,marker-xiaodian,1720625629,1720625712,finished,1720625649,1720625712,A100-SXM4-80GB,8,1,64,896,20,63
f22887c4-9a3d-481d-89e7-2e43a23b0b0f,marker-xiaodian,1720625796,1720625879,finished,1720625817,1720625879,A100-SXM4-80GB,8,1,64,896,21,62
1ebec0d3-8cee-4e88-97de-f7237cb864e2,marker-xiaodian,1720625963,1720626046,finished,1720625985,1720626046,A100-SXM4-80GB,8,1,64,896,22,61
b3186d4f-6d81-4ceb-b28e-9516f983bb4c,marker-xiaodian,1720626129,1720626211,finished,1720626150,1720626211,A100-SXM4-80GB,8,1,64,896,21,61
c562d888-94e1-4d49-8593-09fd72e4d4e0,marker-xiaodian,1720626294,1720626374,finished,1720626314,1720626374,A100-SXM4-80GB,8,1,64,896,20,60
8ef8d06d-8fce-4869-b0fb-35b86ee1a5ff,marker-xiaodian,1720626459,1720626560,finished,1720626479,1720626560,A100-SXM4-80GB,8,1,64,896,20,81
6d0b94e8-b828-4f68-a66b-b6f46ac595fa,llama3-8b-base-ntk21-83531-auto,1720626626,1720655676,finished,1720626647,1720655676,A100-SXM4-80GB,8,1,64,896,21,29029
05b861b2-832d-40c9-b927-f4ec753bf541,marker-xiaodian,1720626646,1720626731,finished,1720626667,1720626731,A100-SXM4-80GB,8,1,64,896,21,64
42b9f4d8-79b3-440d-9d2a-8ac26224ac0c,geo-05B-zero3,1720626782,1720627432,finished,1720626803,1720627432,A100-SXM4-80GB,8,1,64,896,21,629
04f908f7-ddd7-47ad-85e1-005350bb8243,marker-xiaodian,1720626816,1720626881,finished,1720626836,1720626881,A100-SXM4-80GB,8,1,64,896,20,45
6232c301-8c85-4fb8-b301-342a7286d8ab,marker-xiaodian,1720626965,1720627049,finished,1720626987,1720627049,A100-SXM4-80GB,8,1,64,896,22,62
4d9d3cdf-908d-4635-a453-cb41a8e518f6,marker-xiaodian,1720627132,1720627214,finished,1720627152,1720627214,A100-SXM4-80GB,8,1,64,896,20,62
4d3fea5c-e828-4270-a524-f4b2bbfda388,marker-xiaodian,1720627296,1720627381,finished,1720627316,1720627381,A100-SXM4-80GB,8,1,64,896,20,65
cd6347fa-d8e6-49aa-a3da-de970ab58a72,llama3-8b-instruct-sft32k,1720627385,1721195418,finished,1720628928,1721195418,A100-SXM4-80GB,8,4,64,448,1543,566490
95b829e1-dd7a-483d-b290-eed8bd5294eb,geo-05B-zero3,1720627432,1720690614,finished,1720627453,1720690614,A100-SXM4-80GB,8,1,64,896,21,63161
ef3bc6e2-f27d-4431-bca6-67d1a44ef267,marker-xiaodian,1720627466,1720627549,finished,1720627487,1720627549,A100-SXM4-80GB,8,1,64,896,21,62
5af5c08e-d0e3-47c0-8063-e5412cce5115,marker-xiaodian,1720627631,1720627713,finished,1720627652,1720627713,A100-SXM4-80GB,8,1,64,896,21,61
a70c6ae0-2e47-4cf9-90da-5111f46e67c4,marker-xiaodian,1720627796,1720627880,finished,1720627816,1720627880,A100-SXM4-80GB,8,1,64,896,20,64
4e8d522d-88a6-4cec-855d-4a9b01ec89e7,geogpt-tableqa-sft-qwen2-72b-0711-datav092,1720627824,1720685857,finished,1720627866,1720685857,A100-SXM4-80GB,8,4,64,896,42,57991
64b0b0b4-354e-40ae-8429-76d660f0e01c,marker-xiaodian,1720627964,1720628046,finished,1720627985,1720628046,A100-SXM4-80GB,8,1,64,896,21,61
3c918b42-d501-44b2-b091-28e94ba16e69,marker-xiaodian,1720628129,1720628210,finished,1720628150,1720628210,A100-SXM4-80GB,8,1,64,896,21,60
8377bf72-ab83-4fe5-bb49-b0e6dcd1ee45,marker-xiaodian,1720628293,1720628376,finished,1720628314,1720628376,A100-SXM4-80GB,8,1,64,896,21,62
07c81cbb-451f-4c5e-98e8-b2b279abd71f,marker-xiaodian,1720628456,1720628538,finished,1720628476,1720628538,A100-SXM4-80GB,8,1,64,896,20,62
6792a500-d0e1-4090-a2d6-6ea70f7b1bc2,llama-factory-long-sp-pt-test,1720628541,1720628867,finished,1720628562,1720628867,A100-SXM4-80GB,8,1,64,448,21,305
a1d593a3-6dd7-4c4b-a14a-cbcb251c8a3d,marker-xiaodian,1720628619,1720628700,finished,1720628640,1720628700,A100-SXM4-80GB,8,1,64,896,21,60
661ace5d-3f0f-4efd-aa98-8e72db511701,marker-xiaodian,1720628783,1720628864,finished,1720628803,1720628864,A100-SXM4-80GB,8,1,64,896,20,61
93525f4f-e06b-4cba-beea-c8e2190efe52,marker-xiaodian,1720628946,1720629027,finished,1720628966,1720629027,A100-SXM4-80GB,8,1,64,896,20,61
8bae4a8c-3b3c-4000-8511-170636290682,marker-xiaodian,1720629109,1720629191,finished,1720629130,1720629191,A100-SXM4-80GB,8,1,64,896,21,61
2c0d9593-c3ba-4ac1-b160-2fd18a6fdb55,marker-xiaodian,1720629274,1720629356,finished,1720629295,1720629356,A100-SXM4-80GB,8,1,64,896,21,61
660019ad-4882-44fa-ac6f-fefcff36f342,marker-xiaodian,1720629438,1720629520,finished,1720629458,1720629520,A100-SXM4-80GB,8,1,64,896,20,62
69e07314-3e82-49f3-bf34-436d54a589cb,marker-xiaodian,1720629601,1720629682,finished,1720629621,1720629682,A100-SXM4-80GB,8,1,64,896,20,61
a83dd15a-ce33-4898-8172-599cf7cf392a,marker-xiaodian,1720629763,1720629844,finished,1720629783,1720629844,A100-SXM4-80GB,8,1,64,896,20,61
1f7a6ced-92cd-45c1-aa8e-39fc58a88647,marker-xiaodian,1720629926,1720630006,finished,1720629946,1720630006,A100-SXM4-80GB,8,1,64,896,20,60
0dc3a4e5-874b-4f99-8a3f-d51f7da1c3e6,marker-xiaodian,1720630087,1720630167,finished,1720630107,1720630167,A100-SXM4-80GB,8,1,64,896,20,60
c93e9b24-8be4-4d2d-8256-b4aa3c86e50d,marker-xiaodian,1720630250,1720630332,finished,1720630271,1720630332,A100-SXM4-80GB,8,1,64,896,21,61
8f1a4fba-ceaa-4f59-a120-114b82045172,marker-xiaodian,1720630415,1720630496,finished,1720630435,1720630496,A100-SXM4-80GB,8,1,64,896,20,61
df339c63-5f78-4161-ba74-5b39c6f2fe98,marker-xiaodian,1720630579,1720630680,finished,1720630599,1720630680,A100-SXM4-80GB,8,1,64,896,20,81
e9a40670-3266-48ab-9042-2d30530baef1,marker-xiaodian,1720630762,1720630864,finished,1720630782,1720630864,A100-SXM4-80GB,8,1,64,896,20,82
da45f618-6a9f-4fc2-8b99-25ce2da0d6e5,marker-xiaodian,1720630946,1720631049,finished,1720630967,1720631049,A100-SXM4-80GB,8,1,64,896,21,82
4b56172c-97fd-459a-a466-fca053411b75,marker-xiaodian,1720631132,1720631214,finished,1720631152,1720631214,A100-SXM4-80GB,8,1,64,896,20,62
ecc07292-9af0-40b4-b6b9-ef7478cd8d25,marker-xiaodian,1720631297,1720631380,finished,1720631319,1720631380,A100-SXM4-80GB,8,1,64,896,22,61
f4e1dec3-fba9-4271-8653-2bbd35ec8bd7,geo-seesaw-sft-code-alpaca-ultra-eval-test,1720631305,1720836176,finished,1720631326,1720836176,A100-SXM4-80GB,8,1,64,896,21,204850
0f74b652-2d4f-4e9a-a1b0-33a4fea37549,marker-xiaodian,1720631461,1720631541,finished,1720631482,1720631541,A100-SXM4-80GB,8,1,64,896,21,59
a9386c68-8166-4ed2-a612-c96069452c38,marker-xiaodian,1720631623,1720631726,finished,1720631643,1720631726,A100-SXM4-80GB,8,1,64,896,20,83
69f4e452-d470-48c7-9f0f-b329ff846581,marker-xiaodian,1720631809,1720631891,finished,1720631830,1720631891,A100-SXM4-80GB,8,1,64,896,21,61
bb8f7560-8b80-4ceb-9451-d9468d459c4d,marker-xiaodian,1720631973,1720632054,finished,1720631993,1720632054,A100-SXM4-80GB,8,1,64,896,20,61
9250b00c-4701-4bb5-841f-8267f67792aa,marker-xiaodian,1720632136,1720632217,finished,1720632157,1720632217,A100-SXM4-80GB,8,1,64,896,21,60
87411036-477d-4f7c-9380-5f1c27e9364c,marker-xiaodian,1720632299,1720632380,finished,1720632319,1720632380,A100-SXM4-80GB,8,1,64,896,20,61
b7e3112c-dec0-4d7e-9b3d-a38390b6fe53,marker-xiaodian,1720632462,1720632545,finished,1720632483,1720632545,A100-SXM4-80GB,8,1,64,896,21,62
e50a1c83-814f-4093-9c43-695dd59da065,marker-xiaodian,1720632624,1720632725,finished,1720632645,1720632725,A100-SXM4-80GB,8,1,64,896,21,80
16700ddf-0d99-4c0b-9815-ce21b7ba0a8a,marker-xiaodian,1720632808,1720632909,finished,1720632827,1720632909,A100-SXM4-80GB,8,1,64,896,19,82
d4f6f9a1-f50f-4245-b3c8-c534dc6b94c7,marker-xiaodian,1720632992,1720633075,finished,1720633013,1720633075,A100-SXM4-80GB,8,1,64,896,21,62
be9d0975-7ba5-4b73-bdde-6bc83f41cad1,marker-xiaodian,1720633156,1720633256,finished,1720633176,1720633256,A100-SXM4-80GB,8,1,64,896,20,80
2c86ef20-dba3-44de-b878-6fbd18be4ce4,marker-xiaodian,1720633338,1720633419,finished,1720633358,1720633419,A100-SXM4-80GB,8,1,64,896,20,61
068ce17b-0083-4bcf-9474-818f26ea7b55,marker-xiaodian,1720633502,1720633604,finished,1720633522,1720633604,A100-SXM4-80GB,8,1,64,896,20,82
c67ab692-7f22-4fd8-8847-47054b9564c1,marker-xiaodian,1720633686,1720633767,finished,1720633706,1720633767,A100-SXM4-80GB,8,1,64,896,20,61
ffbb9b41-6716-4c6e-943a-5e8da231e15f,marker-xiaodian,1720633848,1720633930,finished,1720633868,1720633930,A100-SXM4-80GB,8,1,64,896,20,62
243683f1-e997-4445-82f5-d2cbd09367ee,marker-xiaodian,1720634012,1720634093,finished,1720634033,1720634093,A100-SXM4-80GB,8,1,64,896,21,60
599a09f3-d27d-4655-8d94-1b226b1b420e,marker-xiaodian,1720634176,1720634258,finished,1720634196,1720634258,A100-SXM4-80GB,8,1,64,896,20,62
4918c446-19dc-417c-a133-3afe364dfa63,marker-xiaodian,1720634340,1720634423,finished,1720634360,1720634423,A100-SXM4-80GB,8,1,64,896,20,63
4247b1dd-1d40-480e-bc64-08f81ef7b970,marker-xiaodian,1720634503,1720634583,finished,1720634523,1720634583,A100-SXM4-80GB,8,1,64,896,20,60
61c3af91-b315-4840-8df8-d4fa680cee16,marker-xiaodian,1720634665,1720634745,finished,1720634686,1720634745,A100-SXM4-80GB,8,1,64,896,21,59
8aa47762-a9b9-4907-ac3f-796ce8aa8b0e,marker-xiaodian,1720634827,1720634907,finished,1720634847,1720634907,A100-SXM4-80GB,8,1,64,896,20,60
2bf39991-9e11-43cf-bece-143485018d5f,marker-xiaodian,1720634989,1720635070,finished,1720635009,1720635070,A100-SXM4-80GB,8,1,64,896,20,61
28d55bb5-eddd-4d00-b693-757affa61fbe,marker-xiaodian,1720635151,1720635232,finished,1720635171,1720635232,A100-SXM4-80GB,8,1,64,896,20,61
203f67ee-f669-4d20-ba37-6b3234b2b629,marker-xiaodian,1720635315,1720635397,finished,1720635335,1720635397,A100-SXM4-80GB,8,1,64,896,20,62
e24d0e84-614a-4ac1-99c0-1c04b14ebb2e,marker-xiaodian,1720635478,1720635559,finished,1720635499,1720635559,A100-SXM4-80GB,8,1,64,896,21,60
5e37a9f3-fe5f-44de-bf32-a4c34f301b90,marker-xiaodian,1720635642,1720635724,finished,1720635663,1720635724,A100-SXM4-80GB,8,1,64,896,21,61
e04743e4-72fa-4800-be7a-8c1aade90953,marker-xiaodian,1720635807,1720635887,finished,1720635827,1720635887,A100-SXM4-80GB,8,1,64,896,20,60
b6752157-5053-4376-80bc-d9009476d8d2,marker-xiaodian,1720635969,1720636051,finished,1720635990,1720636051,A100-SXM4-80GB,8,1,64,896,21,61
47ffe8e6-7df5-4035-b422-29fe4ca60a70,marker-xiaodian,1720636131,1720636213,finished,1720636152,1720636213,A100-SXM4-80GB,8,1,64,896,21,61
d4d86879-747c-4798-9183-aa489cfa3253,marker-xiaodian,1720636294,1720636377,finished,1720636314,1720636377,A100-SXM4-80GB,8,1,64,896,20,63
0b11ed50-9c98-4b2c-82a8-6495a2012b7a,marker-xiaodian,1720636457,1720636539,finished,1720636478,1720636539,A100-SXM4-80GB,8,1,64,896,21,61
846eed57-097c-4d69-9792-b27c62916433,marker-xiaodian,1720636621,1720636722,finished,1720636641,1720636722,A100-SXM4-80GB,8,1,64,896,20,81
b4810ef7-bb66-4f37-847f-4f96622c941f,marker-xiaodian,1720636803,1720636885,finished,1720636824,1720636885,A100-SXM4-80GB,8,1,64,896,21,61
0f9b26f5-225c-48e0-8da7-934c86693f25,marker-xiaodian,1720636967,1720637068,finished,1720636987,1720637068,A100-SXM4-80GB,8,1,64,896,20,81
c3ebac23-c6b2-4513-ae1d-0d50cd52e490,marker-xiaodian,1720637151,1720637232,finished,1720637171,1720637232,A100-SXM4-80GB,8,1,64,896,20,61
b4e6e50e-f607-40e8-9795-6465db561750,marker-xiaodian,1720637312,1720637392,finished,1720637332,1720637392,A100-SXM4-80GB,8,1,64,896,20,60
4d495b6e-0c59-4e04-86e4-547d84540779,marker-xiaodian,1720637474,1720637554,finished,1720637493,1720637554,A100-SXM4-80GB,8,1,64,896,19,61
c53d9bb0-a6e8-4907-bc13-802c72144f35,marker-xiaodian,1720637637,1720637720,finished,1720637658,1720637720,A100-SXM4-80GB,8,1,64,896,21,62
5555179f-8230-4bad-89ee-ecb33c849e04,marker-xiaodian,1720637801,1720637882,finished,1720637821,1720637882,A100-SXM4-80GB,8,1,64,896,20,61
0b2b5d7e-0e4a-4659-8fd6-a0adc734c472,marker-xiaodian,1720637964,1720638046,finished,1720637984,1720638046,A100-SXM4-80GB,8,1,64,896,20,62
338de7fe-927c-47a7-9fe7-c66c8889a551,marker-xiaodian,1720638127,1720638208,finished,1720638148,1720638208,A100-SXM4-80GB,8,1,64,896,21,60
4b13cb59-f67d-4d6e-a54f-e4eeca31ec14,marker-xiaodian,1720638290,1720638372,finished,1720638310,1720638372,A100-SXM4-80GB,8,1,64,896,20,62
cb41f968-8c62-4b19-b98d-ad92abf8d858,marker-xiaodian,1720638452,1720638534,finished,1720638473,1720638534,A100-SXM4-80GB,8,1,64,896,21,61
e0dd4be7-2f2f-4923-b46c-a9be1f235252,marker-xiaodian,1720638615,1720638697,finished,1720638636,1720638697,A100-SXM4-80GB,8,1,64,896,21,61
6e4853d7-904b-4982-894a-da9c24171cc4,marker-xiaodian,1720638778,1720638877,finished,1720638798,1720638877,A100-SXM4-80GB,8,1,64,896,20,79
bbd4ca8c-15c1-438c-af36-7f82a672088a,marker-xiaodian,1720638957,1720639035,finished,1720638977,1720639035,A100-SXM4-80GB,8,1,64,896,20,58
1eb1a18d-6646-4e6e-870c-3df3396695bb,marker-xiaodian,1720639116,1720639215,finished,1720639136,1720639215,A100-SXM4-80GB,8,1,64,896,20,79
5ef4e676-a08d-430a-8d18-3ce9f4e93b64,marker-xiaodian,1720639295,1720639375,finished,1720639315,1720639375,A100-SXM4-80GB,8,1,64,896,20,60
54f9687e-889d-4769-b6c7-0a57be164acd,marker-xiaodian,1720639456,1720639537,finished,1720639476,1720639537,A100-SXM4-80GB,8,1,64,896,20,61
c3908dd5-4748-4fce-942e-852c659f143a,marker-xiaodian,1720639617,1720639715,finished,1720639637,1720639715,A100-SXM4-80GB,8,1,64,896,20,78
87fb7427-6b6a-40eb-b26e-a423b0d59b1d,marker-xiaodian,1720639796,1720639877,finished,1720639816,1720639877,A100-SXM4-80GB,8,1,64,896,20,61
13c0693f-2d5b-4d74-a12c-b9217dd611e0,marker-xiaodian,1720639955,1720640037,finished,1720639975,1720640037,A100-SXM4-80GB,8,1,64,896,20,62
599b79a9-49da-4092-b11b-853e2f27b353,marker-xiaodian,1720640117,1720640215,finished,1720640137,1720640215,A100-SXM4-80GB,8,1,64,896,20,78
b8e218a7-c5ba-4fb7-9ad6-c96dbfcecec1,marker-xiaodian,1720640294,1720640373,finished,1720640314,1720640373,A100-SXM4-80GB,8,1,64,896,20,59
5c918368-6317-4cf8-9456-e9998c1f98e4,marker-xiaodian,1720640454,1720640554,finished,1720640474,1720640554,A100-SXM4-80GB,8,1,64,896,20,80
7c4e9e07-5b3e-45c3-b6c2-0edf20d24ab1,marker-xiaodian,1720640633,1720640710,finished,1720640653,1720640710,A100-SXM4-80GB,8,1,64,896,20,57
5a09f72a-2188-4d56-90e3-6510f31e30f9,marker-xiaodian,1720640792,1720640873,finished,1720640812,1720640873,A100-SXM4-80GB,8,1,64,896,20,61
81985f07-2f50-425f-8f26-0e382c9c0a07,marker-xiaodian,1720640953,1720641033,finished,1720640973,1720641033,A100-SXM4-80GB,8,1,64,896,20,60
f909f461-256e-4995-8b9e-df1223ae8198,marker-xiaodian,1720641111,1720641211,finished,1720641131,1720641211,A100-SXM4-80GB,8,1,64,896,20,80
4a2d747e-5bf5-4401-a23e-21d6e202df2b,marker-xiaodian,1720641292,1720641373,finished,1720641312,1720641373,A100-SXM4-80GB,8,1,64,896,20,61
5eb8025b-2b09-4860-8d9b-51b06f6d1fa1,marker-xiaodian,1720641453,1720641535,finished,1720641473,1720641535,A100-SXM4-80GB,8,1,64,896,20,62
c31268c2-72fe-4000-88ff-ca437da331cf,marker-xiaodian,1720641616,1720641695,finished,1720641637,1720641695,A100-SXM4-80GB,8,1,64,896,21,58
33898b63-46cc-4dac-8330-50a9f0fafd33,marker-xiaodian,1720641777,1720641857,finished,1720641796,1720641857,A100-SXM4-80GB,8,1,64,896,19,61
31ad8ba6-40f6-490f-bb86-15d0ca59a8d0,marker-xiaodian,1720641936,1720642015,finished,1720641956,1720642015,A100-SXM4-80GB,8,1,64,896,20,59
2da419e0-76ba-4fb4-a9a7-94811828c684,marker-xiaodian,1720642093,1720642191,finished,1720642112,1720642191,A100-SXM4-80GB,8,1,64,896,19,79
aa58f0b8-9e34-42bd-bda4-1bdff6da15d9,marker-xiaodian,1720642271,1720642352,finished,1720642292,1720642352,A100-SXM4-80GB,8,1,64,896,21,60
12e65b04-aafe-45ca-94b6-867ef8fca79b,marker-xiaodian,1720642431,1720642531,finished,1720642450,1720642531,A100-SXM4-80GB,8,1,64,896,19,81
fda564b9-d8a0-457c-8fe0-4d0491f859d0,marker-xiaodian,1720642610,1720642692,finished,1720642631,1720642692,A100-SXM4-80GB,8,1,64,896,21,61
76366cc7-afae-4a15-88ff-4c42611cc4a1,marker-xiaodian,1720642773,1720642851,finished,1720642792,1720642851,A100-SXM4-80GB,8,1,64,896,19,59
a1216475-6e31-4a6c-b3ce-89d9a92f001e,marker-xiaodian,1720642931,1720643029,finished,1720642951,1720643029,A100-SXM4-80GB,8,1,64,896,20,78
99d85ed7-283d-465f-b9c9-972312eb2eea,marker-xiaodian,1720643107,1720643186,finished,1720643127,1720643186,A100-SXM4-80GB,8,1,64,896,20,59
7d2b8ef0-5bf6-424f-8de8-201a5afec979,marker-xiaodian,1720643267,1720643367,finished,1720643287,1720643367,A100-SXM4-80GB,8,1,64,896,20,80
49d001cf-2551-4179-aad1-b6f71987107a,marker-xiaodian,1720643447,1720643527,finished,1720643466,1720643527,A100-SXM4-80GB,8,1,64,896,19,61
cd20e7ed-ee19-4298-b091-b339c1d1b66a,marker-xiaodian,1720643607,1720643705,finished,1720643627,1720643705,A100-SXM4-80GB,8,1,64,896,20,78
a2647c7e-1afe-4831-abbc-70b224aa80ca,marker-xiaodian,1720643784,1720643864,finished,1720643803,1720643864,A100-SXM4-80GB,8,1,64,896,19,61
777bbdfd-ccc9-4ef2-9402-e746beac1a01,marker-xiaodian,1720643944,1720644025,finished,1720643965,1720644025,A100-SXM4-80GB,8,1,64,896,21,60
51ea6e72-42d5-40fe-adaf-832fcb17954f,marker-xiaodian,1720644104,1720644184,finished,1720644124,1720644184,A100-SXM4-80GB,8,1,64,896,20,60
4fd944d9-7d56-4615-bc0d-44fc1517e4d6,marker-xiaodian,1720644261,1720644356,finished,1720644281,1720644356,A100-SXM4-80GB,8,1,64,896,20,75
c99c48e5-13f5-47e7-990a-45a1cc84f30f,marker-xiaodian,1720644433,1720644531,finished,1720644453,1720644531,A100-SXM4-80GB,8,1,64,896,20,78
3af46231-69d0-48a6-b597-5ac32da510a6,marker-xiaodian,1720644609,1720644686,finished,1720644628,1720644686,A100-SXM4-80GB,8,1,64,896,19,58
0feb81b8-9057-4fd1-8f6c-b35d26cd6226,marker-xiaodian,1720644764,1720644841,finished,1720644783,1720644841,A100-SXM4-80GB,8,1,64,896,19,58
37bf4d1c-c7d4-4005-976c-a72e1d0cdd53,marker-xiaodian,1720644919,1720644997,finished,1720644939,1720644997,A100-SXM4-80GB,8,1,64,896,20,58
4a9ac483-2c90-41cc-a14b-e76cd9fa7fde,marker-xiaodian,1720645076,1720645175,finished,1720645095,1720645175,A100-SXM4-80GB,8,1,64,896,19,80
9b283201-e367-41fa-98d2-d019064e828b,marker-xiaodian,1720645254,1720645331,finished,1720645274,1720645331,A100-SXM4-80GB,8,1,64,896,20,57
9b3a4d21-fc82-409a-a0cc-f78b060967d3,marker-xiaodian,1720645408,1720645485,finished,1720645427,1720645485,A100-SXM4-80GB,8,1,64,896,19,58
315ff101-5623-4bf1-8ad5-5ba3d4049969,marker-xiaodian,1720645564,1720645643,finished,1720645583,1720645643,A100-SXM4-80GB,8,1,64,896,19,60
74002c97-2cd1-4a8d-b2e1-90ef957fecff,marker-xiaodian,1720645723,1720645802,finished,1720645742,1720645802,A100-SXM4-80GB,8,1,64,896,19,60
7411cd55-c942-4f6b-ba5b-86806fff3340,marker-xiaodian,1720645879,1720645958,finished,1720645899,1720645958,A100-SXM4-80GB,8,1,64,896,20,59
3e05d62a-f4d7-46e4-b29a-3d1a21b4b7e0,marker-xiaodian,1720646036,1720646115,finished,1720646056,1720646115,A100-SXM4-80GB,8,1,64,896,20,59
04bf2d4a-7a21-44e3-b0be-be1ad2b1eba6,marker-xiaodian,1720646193,1720646290,finished,1720646212,1720646290,A100-SXM4-80GB,8,1,64,896,19,78
d697f91b-f47a-4ea3-96f3-a0b550f15f31,marker-xiaodian,1720646368,1720646446,finished,1720646388,1720646446,A100-SXM4-80GB,8,1,64,896,20,58
fba1961a-28cc-4390-b949-849276010bf5,marker-xiaodian,1720646523,1720646602,finished,1720646543,1720646602,A100-SXM4-80GB,8,1,64,896,20,59
49a5778f-2c54-4c0d-9706-2334d4e1d88d,marker-xiaodian,1720646680,1720646757,finished,1720646699,1720646757,A100-SXM4-80GB,8,1,64,896,19,58
4e6ad20a-84d0-48bb-b792-a31d7edd489d,marker-xiaodian,1720646834,1720646912,finished,1720646852,1720646912,A100-SXM4-80GB,8,1,64,896,18,60
920a91dd-eb6c-42d4-8cd3-9d6cf372bf8a,marker-xiaodian,1720646989,1720647066,finished,1720647008,1720647066,A100-SXM4-80GB,8,1,64,896,19,58
5d1bade5-c39e-465f-9a3e-8b72ea7a9267,marker-xiaodian,1720647142,1720647238,finished,1720647161,1720647238,A100-SXM4-80GB,8,1,64,896,19,77
bfb6d1e3-5221-4fd9-a9e8-afaf6a620d94,marker-xiaodian,1720647315,1720647393,finished,1720647334,1720647393,A100-SXM4-80GB,8,1,64,896,19,59
c9d33081-a4c6-4953-a1e9-660c2e4a7ebb,marker-xiaodian,1720647469,1720647565,finished,1720647489,1720647565,A100-SXM4-80GB,8,1,64,896,20,76
93aa83dc-c170-43bf-940f-520fa0b70728,marker-xiaodian,1720647643,1720647740,finished,1720647663,1720647740,A100-SXM4-80GB,8,1,64,896,20,77
0fd097ff-e601-4307-84a1-c5df4babceee,marker-xiaodian,1720647817,1720647914,finished,1720647837,1720647914,A100-SXM4-80GB,8,1,64,896,20,77
21d9e17e-4ced-484d-a9ca-781998b218f3,marker-xiaodian,1720647992,1720648089,finished,1720648012,1720648089,A100-SXM4-80GB,8,1,64,896,20,77
7e783383-8508-4c54-aae0-542b29691858,marker-xiaodian,1720648168,1720648246,finished,1720648189,1720648246,A100-SXM4-80GB,8,1,64,896,21,57
cc90553c-d75f-4543-afe6-b5e5e77031b0,marker-xiaodian,1720648324,1720648404,finished,1720648344,1720648404,A100-SXM4-80GB,8,1,64,896,20,60
e8a4a24a-7b38-4d17-b6a2-1c6fc733bea0,marker-xiaodian,1720648484,1720648581,finished,1720648504,1720648581,A100-SXM4-80GB,8,1,64,896,20,77
7313ad3d-9d11-409b-b698-3920b22ee41b,marker-xiaodian,1720648660,1720648737,finished,1720648679,1720648737,A100-SXM4-80GB,8,1,64,896,19,58
e4731edd-9c20-4024-aaaf-f96e193f5b05,marker-xiaodian,1720648816,1720648894,finished,1720648836,1720648894,A100-SXM4-80GB,8,1,64,896,20,58
e73bbe4b-fcde-46f7-80b8-dfcfc201c008,marker-xiaodian,1720648974,1720649053,finished,1720648994,1720649053,A100-SXM4-80GB,8,1,64,896,20,59
2b9e20c5-cc64-46c6-a22c-79359ba28e4d,marker-xiaodian,1720649132,1720649211,finished,1720649151,1720649211,A100-SXM4-80GB,8,1,64,896,19,60
f3a91294-8de1-483e-aff8-e40ee214389e,marker-xiaodian,1720649289,1720649385,finished,1720649308,1720649385,A100-SXM4-80GB,8,1,64,896,19,77
8eec656e-66e4-4a05-9e11-85d02eee6d3f,marker-xiaodian,1720649462,1720649539,finished,1720649481,1720649539,A100-SXM4-80GB,8,1,64,896,19,58
bf461263-2727-4dcc-a2f7-6979a64568e9,marker-xiaodian,1720649616,1720649714,finished,1720649636,1720649714,A100-SXM4-80GB,8,1,64,896,20,78
341e534a-314a-4d5c-ae44-25af932078e9,marker-xiaodian,1720649792,1720649891,finished,1720649812,1720649891,A100-SXM4-80GB,8,1,64,896,20,79
4215603d-e507-49fd-98d4-301c366d8321,marker-xiaodian,1720649967,1720650044,finished,1720649986,1720650044,A100-SXM4-80GB,8,1,64,896,19,58
e9d64b23-2428-49e2-93af-0a52e820f2ab,marker-xiaodian,1720650121,1720650198,finished,1720650141,1720650198,A100-SXM4-80GB,8,1,64,896,20,57
ac5c37d5-1f27-420e-994e-8ba58ee8f9f3,marker-xiaodian,1720650275,1720650355,finished,1720650295,1720650355,A100-SXM4-80GB,8,1,64,896,20,60
0ae38e9b-0924-42c3-af80-922d666326a0,marker-xiaodian,1720650434,1720650511,finished,1720650453,1720650511,A100-SXM4-80GB,8,1,64,896,19,58
fe814e4e-19b9-4f4c-955a-ae66a8f9e69e,marker-xiaodian,1720650589,1720650688,finished,1720650609,1720650688,A100-SXM4-80GB,8,1,64,896,20,79
42fc24bb-ec4a-4035-ae99-3fb0b10cad39,marker-xiaodian,1720650767,1720650845,finished,1720650787,1720650845,A100-SXM4-80GB,8,1,64,896,20,58
c5a616bb-4353-42ed-90d4-49887946c11e,marker-xiaodian,1720650924,1720651003,finished,1720650944,1720651003,A100-SXM4-80GB,8,1,64,896,20,59
da70ec0a-864a-4607-a852-4925b8776e7d,marker-xiaodian,1720651080,1720651174,finished,1720651098,1720651174,A100-SXM4-80GB,8,1,64,896,18,76
b6f4f8c7-ed59-437c-9af7-af313d5c48de,marker-xiaodian,1720651252,1720651348,finished,1720651271,1720651348,A100-SXM4-80GB,8,1,64,896,19,77
3179021f-acb5-454e-85cc-ef7257f76a89,marker-xiaodian,1720651427,1720651522,finished,1720651446,1720651522,A100-SXM4-80GB,8,1,64,896,19,76
1c7feae3-fb92-4818-a12a-1a48d6771c8b,marker-xiaodian,1720651600,1720651696,finished,1720651619,1720651696,A100-SXM4-80GB,8,1,64,896,19,77
8b976ff2-6d24-4544-a921-0c12c23a4771,marker-xiaodian,1720651776,1720651855,finished,1720651796,1720651855,A100-SXM4-80GB,8,1,64,896,20,59
1eb976c8-c83c-41e7-8954-06a2e15e0c29,marker-xiaodian,1720651933,1720652011,finished,1720651952,1720652011,A100-SXM4-80GB,8,1,64,896,19,59
9ab6590a-b867-4c8a-a20c-6cdb46f094e4,marker-xiaodian,1720652090,1720652187,finished,1720652110,1720652187,A100-SXM4-80GB,8,1,64,896,20,77
681f0b91-8a25-4d0c-84a3-d507358eb7f0,marker-xiaodian,1720652264,1720652363,finished,1720652284,1720652363,A100-SXM4-80GB,8,1,64,896,20,79
75e45dd9-5602-43b9-87dc-0ab1a20c22b4,marker-xiaodian,1720652441,1720652518,finished,1720652461,1720652518,A100-SXM4-80GB,8,1,64,896,20,57
9b9354f3-4a8d-4ec7-bdbe-d39bdea22169,marker-xiaodian,1720652596,1720652675,finished,1720652615,1720652675,A100-SXM4-80GB,8,1,64,896,19,60
2693854a-7ebd-4ce5-a7b3-9a4a63b85304,marker-xiaodian,1720652754,1720652831,finished,1720652773,1720652831,A100-SXM4-80GB,8,1,64,896,19,58
31c17c8f-4067-49ea-ae0b-0885f9320501,marker-xiaodian,1720652909,1720653008,finished,1720652929,1720653008,A100-SXM4-80GB,8,1,64,896,20,79
7a9e2d13-a1f5-4d89-a13a-8ec472953311,marker-xiaodian,1720653086,1720653163,finished,1720653105,1720653163,A100-SXM4-80GB,8,1,64,896,19,58
6196047c-34ed-450e-acd4-0d84fd8ecb0f,marker-xiaodian,1720653240,1720653319,finished,1720653259,1720653319,A100-SXM4-80GB,8,1,64,896,19,60
55c6a2a3-7991-45d0-ae22-b7a4cefbc9c1,marker-xiaodian,1720653397,1720653478,finished,1720653417,1720653478,A100-SXM4-80GB,8,1,64,896,20,61
4ebb3e7e-64a4-4b7d-93ae-1c1d691cdbc3,marker-xiaodian,1720653557,1720653634,finished,1720653576,1720653634,A100-SXM4-80GB,8,1,64,896,19,58
f2cb3fd6-ad1d-422b-8c48-9909b5e3c409,marker-xiaodian,1720653713,1720653792,finished,1720653732,1720653792,A100-SXM4-80GB,8,1,64,896,19,60
ee6a7888-94a0-48a8-8e61-35cbaebd8b52,marker-xiaodian,1720653872,1720653950,finished,1720653891,1720653950,A100-SXM4-80GB,8,1,64,896,19,59
07a63829-a9ac-420f-b47f-2524244855a7,marker-xiaodian,1720654028,1720654105,finished,1720654047,1720654105,A100-SXM4-80GB,8,1,64,896,19,58
58853b3f-58b0-4f03-bc6b-f1e64256c193,marker-xiaodian,1720654185,1720654263,finished,1720654205,1720654263,A100-SXM4-80GB,8,1,64,896,20,58
3d5da6dd-ea23-4f79-9f7f-997f1e0825c6,marker-xiaodian,1720654342,1720654419,finished,1720654361,1720654419,A100-SXM4-80GB,8,1,64,896,19,58
efeebba7-edf5-4031-8810-4a680e57f042,marker-xiaodian,1720654497,1720654576,finished,1720654517,1720654576,A100-SXM4-80GB,8,1,64,896,20,59
26807921-f9cc-4402-8b7b-0e58182b9f37,marker-xiaodian,1720654653,1720654733,finished,1720654674,1720654733,A100-SXM4-80GB,8,1,64,896,21,59
ffd97995-b131-48b1-af5f-06324ee7deec,marker-xiaodian,1720654811,1720654891,finished,1720654832,1720654891,A100-SXM4-80GB,8,1,64,896,21,59
70838e7f-2c18-45ab-aab7-1b802aca0f31,marker-xiaodian,1720654970,1720655047,finished,1720654989,1720655047,A100-SXM4-80GB,8,1,64,896,19,58
4f86fd29-2e48-46a7-922b-e6803ad423db,marker-xiaodian,1720655127,1720655207,finished,1720655147,1720655207,A100-SXM4-80GB,8,1,64,896,20,60
dc28a610-0779-40a9-9ebc-27263fe9ef2f,marker-xiaodian,1720655286,1720655364,finished,1720655306,1720655364,A100-SXM4-80GB,8,1,64,896,20,58
b6b68f8c-cfa2-47e4-afd2-c720f01c9bd9,marker-xiaodian,1720655441,1720655539,finished,1720655461,1720655539,A100-SXM4-80GB,8,1,64,896,20,78
e776e727-940c-4bf5-a902-ed35a4398491,marker-xiaodian,1720655617,1720655713,finished,1720655637,1720655713,A100-SXM4-80GB,8,1,64,896,20,76
0d5d00bc-2382-4a14-bb82-418461e5af07,marker-xiaodian,1720655790,1720655885,finished,1720655809,1720655885,A100-SXM4-80GB,8,1,64,896,19,76
9c7de36f-3705-4241-aad2-5652eb3f6e47,marker-xiaodian,1720655963,1720656062,finished,1720655982,1720656062,A100-SXM4-80GB,8,1,64,896,19,80
9f3a7024-672e-4b20-b4f8-a5949e19ce1b,marker-xiaodian,1720656141,1720656219,finished,1720656161,1720656219,A100-SXM4-80GB,8,1,64,896,20,58
87a8e628-e80d-420c-8b3e-55ca713e99ca,marker-xiaodian,1720656298,1720656377,finished,1720656317,1720656377,A100-SXM4-80GB,8,1,64,896,19,60
744c0bda-d0f5-4409-9452-d833fb95417e,marker-xiaodian,1720656454,1720656550,finished,1720656474,1720656550,A100-SXM4-80GB,8,1,64,896,20,76
c45cde42-d979-4c4b-ad24-9d9eec5e3cf9,marker-xiaodian,1720656629,1720656725,finished,1720656648,1720656725,A100-SXM4-80GB,8,1,64,896,19,77
520a3762-7c88-44bb-8bab-90e7eb39f822,marker-xiaodian,1720656804,1720656902,finished,1720656822,1720656902,A100-SXM4-80GB,8,1,64,896,18,80
6eea4212-25c8-4c8b-87cc-fce1b1c652e4,marker-xiaodian,1720656981,1720657060,finished,1720657001,1720657060,A100-SXM4-80GB,8,1,64,896,20,59
7f80266c-105a-4ee3-9402-7e5d0ecca6b2,marker-xiaodian,1720657139,1720657216,finished,1720657158,1720657216,A100-SXM4-80GB,8,1,64,896,19,58
3e7452d5-57ae-4767-a1a9-68c3bd09cff6,marker-xiaodian,1720657295,1720657391,finished,1720657314,1720657391,A100-SXM4-80GB,8,1,64,896,19,77
f19f66dc-b53a-433a-a7e9-7c7db978a615,marker-xiaodian,1720657468,1720657565,finished,1720657487,1720657565,A100-SXM4-80GB,8,1,64,896,19,78
6ad3e8d6-fa2d-4ba0-b2c3-242fb12e0fc4,marker-xiaodian,1720657643,1720657739,finished,1720657662,1720657739,A100-SXM4-80GB,8,1,64,896,19,77
0aa00685-d91e-49f1-8a07-a2cb3b8ee533,marker-xiaodian,1720657815,1720657912,finished,1720657834,1720657912,A100-SXM4-80GB,8,1,64,896,19,78
0192690a-ddcf-4642-ad52-e93f038d44c6,marker-xiaodian,1720657990,1720658088,finished,1720658010,1720658088,A100-SXM4-80GB,8,1,64,896,20,78
5d2dbf50-68e4-4462-9ac8-61ab97ab3158,marker-xiaodian,1720658164,1720658264,finished,1720658184,1720658264,A100-SXM4-80GB,8,1,64,896,20,80
1a7281c9-07ac-4c99-b19f-443516f3c207,geo-base-offline-eval,1720658251,1720666041,finished,1720658271,1720666041,A100-SXM4-80GB,8,1,64,448,20,7770
02e95f66-281f-4054-aef5-ec97e9df3f0f,marker-xiaodian,1720658344,1720658424,finished,1720658364,1720658424,A100-SXM4-80GB,8,1,64,896,20,60
f86c83f6-a3bf-4333-8e57-249973a76f41,marker-xiaodian,1720658503,1720658580,finished,1720658522,1720658580,A100-SXM4-80GB,8,1,64,896,19,58
ba22e1c2-b80c-4cf6-ab23-ef1218e833c7,marker-xiaodian,1720658661,1720658739,finished,1720658681,1720658739,A100-SXM4-80GB,8,1,64,896,20,58
ec3bb868-a7cc-4730-8a54-7650682e9d52,marker-xiaodian,1720658816,1720658893,finished,1720658835,1720658893,A100-SXM4-80GB,8,1,64,896,19,58
74588838-5cc4-4fc3-9a4c-cbd4c328ec8a,marker-xiaodian,1720658970,1720659065,finished,1720658989,1720659065,A100-SXM4-80GB,8,1,64,896,19,76
b7981085-363c-41b3-b453-6be880aada7d,marker-xiaodian,1720659141,1720659217,finished,1720659160,1720659217,A100-SXM4-80GB,8,1,64,896,19,57
94baf77e-be6c-4895-906a-3816f80a148d,marker-xiaodian,1720659293,1720659369,finished,1720659312,1720659369,A100-SXM4-80GB,8,1,64,896,19,57
3f3110e7-f1f8-4179-bd3f-848e5dd7883e,marker-xiaodian,1720659446,1720659525,finished,1720659466,1720659525,A100-SXM4-80GB,8,1,64,896,20,59
4c6284e0-3e31-4958-b6d5-4a8fd2b18599,marker-xiaodian,1720659603,1720659701,finished,1720659623,1720659701,A100-SXM4-80GB,8,1,64,896,20,78
4ec5df56-8129-43fe-9220-796789fb8ccb,marker-xiaodian,1720659782,1720659859,finished,1720659801,1720659859,A100-SXM4-80GB,8,1,64,896,19,58
2578fbf6-689e-470e-8dd0-a64782106268,marker-xiaodian,1720659936,1720660014,finished,1720659956,1720660014,A100-SXM4-80GB,8,1,64,896,20,58
91798691-88b9-41fc-a11c-16896751fe8c,marker-xiaodian,1720660090,1720660170,finished,1720660111,1720660170,A100-SXM4-80GB,8,1,64,896,21,59
4a9c730d-1a22-438d-b74c-86d32ec6a804,marker-xiaodian,1720660247,1720660345,finished,1720660267,1720660345,A100-SXM4-80GB,8,1,64,896,20,78
229f8249-1d42-4820-98a0-d3d93fe82aef,marker-xiaodian,1720660422,1720660499,finished,1720660441,1720660499,A100-SXM4-80GB,8,1,64,896,19,58
db3a8cbb-0ad1-4294-a9bf-f47add821271,opencompass-eval-0710,1720660481,1720669525,finished,1720660501,1720669525,A100-SXM4-80GB,8,1,64,896,20,9024
5d65474f-6033-4115-80b0-11a1caf801b3,marker-xiaodian,1720660580,1720660658,finished,1720660599,1720660658,A100-SXM4-80GB,8,1,64,896,19,59
59610e9f-0b74-4d1b-ad39-f28d03778f1a,marker-xiaodian,1720660736,1720660838,finished,1720660756,1720660838,A100-SXM4-80GB,8,1,64,896,20,82
82f9611c-9331-43a2-bb73-1ce6d2760ad9,marker-xiaodian,1720660914,1720660992,finished,1720660933,1720660992,A100-SXM4-80GB,8,1,64,896,19,59
6a9017b4-ce7f-4ad3-8dd8-e4a1aa06ff14,marker-xiaodian,1720661075,1720661156,finished,1720661097,1720661156,A100-SXM4-80GB,8,1,64,896,22,59
d444dc68-5c95-4192-bb7e-a4979847792b,qwen1-14B,1720661101,1720661380,finished,1720661121,1720661380,A100-SXM4-80GB,8,1,64,896,20,259
776b9438-047a-4b32-8e79-ea06b6341173,marker-xiaodian,1720661234,1720661314,finished,1720661253,1720661314,A100-SXM4-80GB,8,1,64,896,19,61
d9056fd1-dbbb-44ee-836a-12f8c16254d9,marker-xiaodian,1720661395,1720661474,finished,1720661415,1720661474,A100-SXM4-80GB,8,1,64,896,20,59
41c83a84-2df3-4437-8eb6-00842cc78241,marker-xiaodian,1720661551,1720661628,finished,1720661570,1720661628,A100-SXM4-80GB,8,1,64,896,19,58
5e748d68-6766-481c-b5ff-8ccc226c8df2,geogpt-eval-base-1-8msft,1720661658,1720664557,finished,1720661679,1720664557,A100-SXM4-80GB,8,1,64,448,21,2878
a6a3bf3e-c6b0-4e58-85e2-7029ba977afd,geogpt-eval-base-1-8msft-c,1720661679,1720815857,finished,1720661700,1720815857,A100-SXM4-80GB,8,1,64,448,21,154157
70158137-9216-483e-a893-8c221cbff6bb,marker-xiaodian,1720661708,1720661786,finished,1720661728,1720661786,A100-SXM4-80GB,8,1,64,896,20,58
03f4289e-31fe-42a0-a93c-45bc13485900,qwen1-14B,1720661852,1720661931,finished,1720661873,1720661931,A100-SXM4-80GB,8,1,64,896,21,58
e44b0dd2-1ce8-4519-990e-f7651a322c04,marker-xiaodian,1720661868,1720661946,finished,1720661888,1720661946,A100-SXM4-80GB,8,1,64,896,20,58
a2d22a39-75e1-4172-8e8c-8e82972b8b3c,qwen1-14B,1720662011,1720662089,finished,1720662031,1720662089,A100-SXM4-80GB,8,1,64,896,20,58
1a3265df-8147-4967-b56b-70edaae4f616,marker-xiaodian,1720662027,1720662123,finished,1720662046,1720662123,A100-SXM4-80GB,8,1,64,896,19,77
e2865d4a-3d75-4df0-aa2e-40fd343d8586,qwen1-14B,1720662169,1720662248,finished,1720662189,1720662248,A100-SXM4-80GB,8,1,64,896,20,59
65efcef8-6306-4d18-9e4f-c893ae31ea74,marker-xiaodian,1720662204,1720662284,finished,1720662223,1720662284,A100-SXM4-80GB,8,1,64,896,19,61
64060186-bf79-4b5d-bdaf-8cc0747ca94d,train-clip-0711,1720662225,1720662329,finished,1720662245,1720662329,A100-SXM4-80GB,8,1,64,896,20,84
988ee78e-1604-49d3-a4bc-dabb70e3f620,train-clip-0711,1720662329,1720680285,finished,1720662350,1720680285,A100-SXM4-80GB,8,1,64,896,21,17935
b50e3862-bd3c-44eb-a544-57abb58ce08d,qwen1-14B,1720662332,1720662415,finished,1720662353,1720662415,A100-SXM4-80GB,8,1,64,896,21,62
10a738f0-742b-4c4f-a533-6d9c7139a0f0,marker-xiaodian,1720662368,1720662450,finished,1720662388,1720662450,A100-SXM4-80GB,8,1,64,896,20,62
b97b8e59-3acc-40a4-8ef4-7168c58a6f8b,citysora-modelv4-cele-ppm-65-512-from-200k256,1720662460,1720662678,finished,1720662519,1720662678,A100-SXM4-80GB,8,4,64,896,59,159
e06c2397-4dee-45c1-94d4-c891619d0673,qwen1-14B,1720662497,1720662577,finished,1720662517,1720662577,A100-SXM4-80GB,8,1,64,896,20,60
dbd74af2-1402-43b6-baa7-c147fa00120f,marker-xiaodian,1720662533,1720662611,finished,1720662553,1720662611,A100-SXM4-80GB,8,1,64,896,20,58
8d5428b9-72d3-4040-904a-f59ec0324aaa,qwen1-14B,1720662656,1720662737,finished,1720662675,1720662737,A100-SXM4-80GB,8,1,64,896,19,62
76cd664e-35d6-466c-aed0-1a56ecd61d35,marker-xiaodian,1720662691,1720662771,finished,1720662711,1720662771,A100-SXM4-80GB,8,1,64,896,20,60
d6a5422c-674d-418d-90ba-4a75e70f0405,citysora-modelv4-cele-ppm-65-512-from-200k256,1720662740,1720662940,finished,1720662800,1720662940,A100-SXM4-80GB,8,4,64,896,60,140
b8521ecd-bf81-4526-8ac4-0348cbdde5fb,qwen1-14B,1720662818,1720662897,finished,1720662839,1720662897,A100-SXM4-80GB,8,1,64,896,21,58
31aa604f-d1bc-4b0e-8538-b92f56db6059,marker-xiaodian,1720662854,1720662932,finished,1720662873,1720662932,A100-SXM4-80GB,8,1,64,896,19,59
04428626-a76a-4072-87e0-3440f4ad42d1,qwen1-14B,1720662976,1720663059,finished,1720662999,1720663059,A100-SXM4-80GB,8,1,64,896,23,60
20628ecf-eae4-4e0e-a306-8b80ecfc0816,citysora-modelv4-cele-ppm-65-512-from-200k256,1720663002,1720663170,finished,1720663042,1720663170,A100-SXM4-80GB,8,4,64,896,40,128
46213514-2a6a-442f-8296-857313f1ba13,marker-xiaodian,1720663014,1720663094,finished,1720663033,1720663094,A100-SXM4-80GB,8,1,64,896,19,61
e64abb2c-a8fe-4cec-bdf3-4de4da61b0c9,slimorca-geo-mtm1-mt-wild-14b,1720663083,1720750090,finished,1720663106,1720750090,A100-SXM4-80GB,8,1,64,448,23,86984
d4eaf960-860b-4c1a-ae7f-28b740f93f39,debug,1720663099,1720665756,finished,1720663123,1720665756,A100-SXM4-80GB,8,1,64,448,24,2633
aefb8f73-9ee7-48a5-aa44-3d1248a9daee,qwen1-14B,1720663123,1720663407,finished,1720663144,1720663407,A100-SXM4-80GB,8,1,64,896,21,263
b2624f45-d7c4-49bd-9707-42b9286d6d4e,marker-xiaodian,1720663183,1720663263,finished,1720663202,1720663263,A100-SXM4-80GB,8,1,64,896,19,61
4d2044a6-cbc8-4a82-8aec-e4855adb0c02,llama-multi,1720663187,1720663848,finished,1720663207,1720663848,A100-SXM4-80GB,8,1,64,448,20,641
b49bd873-c07a-4913-9d72-65a77a0f403b,marker-xiaodian,1720663341,1720663423,finished,1720663361,1720663423,A100-SXM4-80GB,8,1,64,896,20,62
feadf583-ebf1-4c8a-a99f-a1da49f12d06,citysora-modelv4-cele-ppm-65-512-from-200k256,1720663390,1720749553,finished,1720663430,1720749553,A100-SXM4-80GB,8,4,64,896,40,86123
56f08458-82a4-4964-8d7c-dc51768b1048,marker-xiaodian,1720663501,1720663598,finished,1720663521,1720663598,A100-SXM4-80GB,8,1,64,896,20,77
b660cd4d-5745-4806-a698-abe888dd060f,GeoGPT-0206-8582c-auto,1720663632,1720664540,finished,1720663653,1720664540,A100-SXM4-80GB,8,1,64,448,21,887
ca479757-ab0f-4974-9b1d-d10c57256b9d,marker-xiaodian,1720663678,1720663757,finished,1720663697,1720663757,A100-SXM4-80GB,8,1,64,896,19,60
d3e2080a-c78b-462d-8e8f-1766192519c8,Qwen2-72B-Instruct-0711-1-a3e59-auto,1720663775,1720680619,finished,1720663796,1720680619,A100-SXM4-80GB,8,1,64,448,21,16823
5b2397dc-e986-4374-9eb9-92b860349143,Qwen2-72B-Instruct-0711-2-f363c-auto,1720663776,1720680392,finished,1720663796,1720680392,A100-SXM4-80GB,8,1,64,448,20,16596
f8481231-1117-4494-8a3c-5187a0333541,Qwen2-72B-Instruct-0711-3-4fbe4-auto,1720663817,1720680574,finished,1720663838,1720680574,A100-SXM4-80GB,8,1,64,448,21,16736
c52ab97a-9095-48eb-b1df-a80d2244c46d,marker-xiaodian,1720663843,1720663925,finished,1720663863,1720663925,A100-SXM4-80GB,8,1,64,896,20,62
76e4597d-5f83-49d8-885c-d5b7131ba699,Qwen2-72B-Instruct-0711-4-bs1-dad28-auto,1720663878,1720695084,finished,1720663897,1720695084,A100-SXM4-80GB,8,1,64,448,19,31187
ae4fae93-db6b-49fc-8104-2ac54090c84d,llama-multi,1720663908,1720664066,finished,1720663930,1720664066,A100-SXM4-80GB,8,1,64,448,22,136
b234e532-8201-4c63-af4a-df7cde7a9d56,marker-xiaodian,1720664003,1720664081,finished,1720664023,1720664081,A100-SXM4-80GB,8,1,64,896,20,58
f00be08f-e745-4554-8281-25460f819c96,geogpt-ultrafuser-direct-eval,1720664109,1720725516,finished,1720664129,1720725516,A100-SXM4-80GB,8,1,64,448,20,61387
bf22be07-4966-49ef-a482-05ef7a04d02d,marker-xiaodian,1720664159,1720664243,finished,1720664182,1720664243,A100-SXM4-80GB,8,1,64,896,23,61
d6b7eb0c-e677-4d05-a1a0-70c0f75715d5,marker-xiaodian,1720664321,1720664402,finished,1720664342,1720664402,A100-SXM4-80GB,8,1,64,896,21,60
73f5ab96-9c7c-4b6e-92e7-c2678557e589,llama-multi,1720664327,1720664490,finished,1720664347,1720664490,A100-SXM4-80GB,8,1,64,448,20,143
98979bd5-c419-4dab-b526-dc33e2eb7850,marker-xiaodian,1720664485,1720664566,finished,1720664506,1720664566,A100-SXM4-80GB,8,1,64,896,21,60
7f7844e7-c425-49c2-b72c-77e8e0438ad7,marker-xiaodian,1720664650,1720664736,finished,1720664671,1720664736,A100-SXM4-80GB,8,1,64,896,21,65
322de791-9aeb-43d8-b18f-93ce966db1d1,test-xiaodianq,1720664736,1720695090,finished,1720664757,1720695090,A100-SXM4-80GB,8,1,64,896,21,30333
f13713d8-e6e3-4489-b816-a7b88a4ade7a,marker-xiaodian,1720664820,1720664902,finished,1720664840,1720664902,A100-SXM4-80GB,8,1,64,896,20,62
97132701-5f56-41b0-870f-57186db848ec,marker-xiaodian,1720664985,1720665067,finished,1720665006,1720665067,A100-SXM4-80GB,8,1,64,896,21,61
908f2193-61aa-4126-92ec-d4cdf4825a25,marker-xiaodian,1720665148,1720665235,finished,1720665170,1720665235,A100-SXM4-80GB,8,1,64,896,22,65
818f7fcf-bdba-41a5-b4a7-9a4756c5db75,qwen1-14B,1720665153,1720665473,finished,1720665175,1720665473,A100-SXM4-80GB,8,1,64,448,22,298
853f6aed-2509-4750-ba6b-f3e7d13d1dd5,Qwen2-72B-0711-1-f3023-auto,1720665229,1720695061,finished,1720665250,1720695061,A100-SXM4-80GB,8,1,64,448,21,29811
d533cf06-88c4-4101-aa4b-6018f6a1be98,marker-xiaodian,1720665317,1720665426,finished,1720665339,1720665426,A100-SXM4-80GB,8,1,64,896,22,87
45a13587-d048-46be-8599-f2a91bce0567,sfr-embedding-test,1720665321,1720668074,finished,1720665342,1720668074,A100-SXM4-80GB,8,1,64,448,21,2732
7f1abc91-ad3c-4a3b-b7a6-9f45d2a5d4ce,zjllm-sci-llama-3-7b,1720665381,1720678635,finished,1720665403,1720678635,A100-SXM4-80GB,8,1,64,448,22,13232
41ca9537-91d6-44ba-b1c8-08da525f931f,marker-xiaodian,1720665511,1720665619,finished,1720665533,1720665619,A100-SXM4-80GB,8,1,64,896,22,86
8c03fb80-be67-4462-ab6b-e67963944ab7,qwen1-14B,1720665538,1720665624,finished,1720665560,1720665624,A100-SXM4-80GB,8,1,64,448,22,64
34e52faa-80f0-43ab-b5c3-617947a7cb82,GeoGPT-1215-7173f-auto,1720665592,1720666393,finished,1720665613,1720666393,A100-SXM4-80GB,8,1,64,448,21,780
ef297718-3cc9-4d24-9b85-f93e2dbfa703,Qwen2-72B-0711-2-e9fb5-auto,1720665635,1720695106,finished,1720665655,1720695106,A100-SXM4-80GB,8,1,64,448,20,29451
8488793a-94bb-4378-a3a8-8b8621a7f6ce,geo-base-moe-growing,1720665671,1720702425,finished,1720665737,1720702425,A100-SXM4-80GB,8,2,64,448,66,36688
a48c649b-f337-451e-92e3-549dfc7b7e67,marker-xiaodian,1720665707,1720665795,finished,1720665729,1720665795,A100-SXM4-80GB,8,1,64,896,22,66
23188d64-83a0-4012-9025-96871cde9961,qwen1-14B,1720665712,1720665799,finished,1720665734,1720665799,A100-SXM4-80GB,8,1,64,448,22,65
aabd3cf2-537d-4165-b931-8c8d0f62fa25,GeoGPT-0630-rag-32595-auto,1720665796,1720667367,finished,1720665818,1720667367,A100-SXM4-80GB,8,1,64,896,22,1549
7b051b41-08e1-4e63-a1e0-0e63dd14f4d3,tqme-vllm-base,1720665809,1720666545,finished,1720665834,1720666545,A100-SXM4-80GB,8,1,64,448,25,711
3b15c875-339c-4eff-9974-ad73e01aa603,m8x7b-sft-1ep-wocpt-8b2a6-auto,1720665827,1720668103,finished,1720665851,1720668103,A100-SXM4-80GB,8,1,64,448,24,2252
3555d22b-d5bb-4003-a606-66c2b2600731,geogpt-qwen2-72b-lp84-s2-regate16,1720665854,1720666000,finished,1720665923,1720666000,A100-SXM4-80GB,8,16,64,448,69,77
48c025e0-a82b-4f79-9051-3988494c0656,mistral-longtext-ml1wt-v4-2d0a3-auto,1720665883,1720671102,finished,1720665905,1720671102,A100-SXM4-80GB,8,1,64,448,22,5197
8aeed328-1185-469a-a81b-c98657ed3789,marker-xiaodian,1720665888,1720665989,finished,1720665910,1720665989,A100-SXM4-80GB,8,1,64,896,22,79
41736589-6017-49e5-85bd-0061dedad211,qwen1-14B,1720665893,1720665970,finished,1720665915,1720665970,A100-SXM4-80GB,8,1,64,448,22,55
52830544-1d96-4007-a70c-bedccb92a80c,geo-mod-05b-test,1720665946,1720667895,finished,1720665973,1720667895,A100-SXM4-80GB,8,1,64,448,27,1922
ac00d9d6-c47a-4b7f-b0d2-21d36ebb1b0d,mistral-CS-mosaic-v4-6db67-auto,1720665957,1720669263,finished,1720665983,1720669263,A100-SXM4-80GB,8,1,64,448,26,3280
88e367e4-e97e-4d29-a2f1-6697af5c80b3,mistral-base-sft3epo-v4-59241-auto,1720665960,1720671352,finished,1720665983,1720671352,A100-SXM4-80GB,8,1,64,448,23,5369
3fa65b7a-2460-41fd-9ca0-d7b1ac66d5fc,geogpt-qwen2-72b-lp84-s2-regate16,1720666000,1720666412,finished,1720666068,1720666412,A100-SXM4-80GB,8,32,64,448,68,344
9fa38824-9718-4e63-bc28-113e8bb376f8,qwen1-14B,1720666039,1720666332,finished,1720666061,1720666332,A100-SXM4-80GB,8,1,64,448,22,271
5c729229-2a17-4b0e-82f3-4cda836bcf2c,geo-base-offline-eval,1720666042,1720675647,finished,1720672011,1720675647,A100-SXM4-80GB,8,1,64,448,5969,3636
9cce956f-0833-4941-9e02-4226276ac319,marker-xiaodian,1720666090,1720666178,finished,1720666111,1720666178,A100-SXM4-80GB,8,1,64,896,21,67
77ee3957-a785-4813-811e-79ead68d77f1,Qwen2-7B-Instruct-33b99-auto,1720666144,1720667807,finished,1720666166,1720667807,A100-SXM4-80GB,8,1,64,448,22,1641
3b6bd6f5-d1ac-4011-9756-186f5ff91d0d,marker-xiaodian,1720666262,1720666349,finished,1720666284,1720666349,A100-SXM4-80GB,8,1,64,896,22,65
648e1ae8-90f6-4749-a4a1-975e8e509f34,qwen1-14B,1720666428,1720666558,finished,1720666451,1720666558,A100-SXM4-80GB,8,1,64,448,23,107
bb9fd1f7-e0fb-42f1-922f-29aca17833bb,geogpt-qwen2-72b-lp84-s2-regate16,1720666436,1720666727,finished,1720666504,1720666727,A100-SXM4-80GB,8,32,64,448,68,223
62487b6f-722b-4f4c-8598-8b77711cd47b,marker-xiaodian,1720666447,1720666529,finished,1720666469,1720666529,A100-SXM4-80GB,8,1,64,896,22,60
62ecbb95-d622-41ca-8d90-dad75d7934b5,debug,1720666495,1720666629,finished,1720666533,1720666629,A100-SXM4-80GB,8,1,64,448,38,96
f9f736d0-a1ce-40ae-824b-b076640825a6,tqme-vllm-base,1720666545,1720667152,finished,1720666569,1720667152,A100-SXM4-80GB,8,1,64,448,24,583
cfda1816-520b-40f6-a69c-3a65b54f6fe9,llama3-70b-lp84-23bcpt-09ep-2a498-auto,1720666612,1720695058,finished,1720666636,1720695058,A100-SXM4-80GB,8,1,64,448,24,28422
2b5cf56a-4fea-4639-829d-ae31ad8a8a62,marker-xiaodian,1720666624,1720666691,finished,1720666647,1720666691,A100-SXM4-80GB,8,1,64,896,23,44
bfb1991b-0d37-4c49-9a32-adfb3bef6c7b,qwen1-14B,1720666651,1720666743,finished,1720666674,1720666743,A100-SXM4-80GB,8,1,64,448,23,69
c9293c59-f8f6-487f-bdec-9cbfebdf9c78,debug,1720666743,1720666832,finished,1720666765,1720666832,A100-SXM4-80GB,8,1,64,448,22,67
7d9ede68-9994-4c0b-bfd7-bec0d42ce6a6,marker-xiaodian,1720666783,1720666872,finished,1720666805,1720666872,A100-SXM4-80GB,8,1,64,896,22,67
52ceb2cb-dc7b-412f-be8a-26fff5cfb177,marker-xiaodian,1720666960,1720667047,finished,1720666982,1720667047,A100-SXM4-80GB,8,1,64,896,22,65
ea499c60-8f3d-449f-a3ed-8b375c38c95a,marker-xiaodian,1720667136,1720667216,finished,1720667160,1720667216,A100-SXM4-80GB,8,1,64,896,24,56
f63afdf3-fd9c-4ec5-942a-4d656415dca9,tqme-vllm-base,1720667152,1720670965,finished,1720667183,1720670965,A100-SXM4-80GB,8,1,64,448,31,3782
2314296a-4ff2-4399-a844-6508119aab89,geogpt-qwen2-72b-lp84-s2-regate16,1720667204,1720667473,finished,1720667250,1720667473,A100-SXM4-80GB,8,32,64,448,46,223
973fc496-1751-4b57-a50f-b0e4b4a31ca5,marker-xiaodian,1720667321,1720667413,finished,1720667342,1720667413,A100-SXM4-80GB,8,1,64,896,21,71
83cbef16-82e3-4429-b85b-caedd175fca6,llama-multi,1720667394,1720667586,finished,1720667418,1720667586,A100-SXM4-80GB,8,1,64,448,24,168
5189a5fd-c9d8-4e74-9507-fe98fddbcce6,marker-xiaodian,1720667506,1720667603,finished,1720667530,1720667603,A100-SXM4-80GB,8,1,64,896,24,73
90623493-2b41-4a52-975a-4fa01a9bdeaf,GeoGPT-0630-rag-32595-auto,1720667507,1720668746,finished,1720667532,1720668746,A100-SXM4-80GB,8,1,64,896,25,1214
3ca42954-5aa6-40dd-b52f-8626357f71e9,geogpt-qwen2-72b-lp84-s2-regate16,1720667570,1720708292,finished,1720667615,1720708292,A100-SXM4-80GB,8,32,64,448,45,40677
9a97929a-3750-43c3-9ef3-6ee34ce3625c,marker-xiaodian,1720667703,1720667797,finished,1720667730,1720667797,A100-SXM4-80GB,8,1,64,896,27,67
31ce4d91-40f9-4541-b2cc-7160a75b512c,sql-spider-qy-0703,1720667736,1720668215,finished,1720667759,1720668215,A100-SXM4-80GB,8,1,64,448,23,456
9aa30da2-90e2-4ce8-8b24-707709edcbb8,marker-xiaodian,1720667888,1720667978,finished,1720667911,1720667978,A100-SXM4-80GB,8,1,64,896,23,67
3483f2df-1f5b-406b-9267-b3460f8bde39,geo-mod-05b-test,1720667895,1720669162,finished,1720667962,1720669162,A100-SXM4-80GB,8,4,64,448,67,1200
8c479985-9da0-45c4-8f86-952f319be582,Qwen2-7B-Instruct-72641-auto,1720668011,1720677818,finished,1720668035,1720677818,A100-SXM4-80GB,8,1,64,448,24,9783
0e61cd1d-c8c5-4216-b155-587f83411af4,marker-xiaodian,1720668071,1720668161,finished,1720668094,1720668161,A100-SXM4-80GB,8,1,64,896,23,67
8b34af9f-362b-4158-bd83-34fcc3ea66e4,sfr-embedding-test,1720668075,1721198233,finished,1720668097,1721198233,A100-SXM4-80GB,8,2,64,448,22,530136
a08d9738-1ced-4f81-b797-8580b1ed20b6,qwen1-14B,1720668212,1720668549,finished,1720668236,1720668549,A100-SXM4-80GB,8,1,64,448,24,313
b44c57b3-4ec8-4056-a383-4008b831d124,sql-spider-qy-0703,1720668216,1720668774,finished,1720668238,1720668774,A100-SXM4-80GB,8,1,64,448,22,536
c6d4af2f-41f8-4785-8ae3-7f84b7f567c1,marker-xiaodian,1720668254,1720668341,finished,1720668276,1720668341,A100-SXM4-80GB,8,1,64,896,22,65
98d92d48-d582-4d06-89cf-499f567a0952,llama2-long-CS-ml1wtoken-6d638-auto,1720668381,1720676874,finished,1720668404,1720676874,A100-SXM4-80GB,8,1,64,448,23,8470
84e20f6c-eb28-4784-892d-7382d21d4b74,llama2-mosaic-CS-basel-0f2dc-auto,1720668429,1720669701,finished,1720668451,1720669701,A100-SXM4-80GB,8,1,64,448,22,1250
77604be7-1250-40c6-9f17-5cde64bd5ebe,marker-xiaodian,1720668435,1720668523,finished,1720668456,1720668523,A100-SXM4-80GB,8,1,64,896,21,67
a7f0b689-1c14-450a-a59e-0b79e1bb4402,geogpt-2b,1720668512,1720668958,finished,1720668534,1720668958,A100-SXM4-80GB,8,1,64,448,22,424
38010fd2-9347-42e9-9b44-c5c55b02b61b,marker-xiaodian,1720668610,1720668699,finished,1720668632,1720668699,A100-SXM4-80GB,8,1,64,896,22,67
841c7bdd-92b8-409d-8b33-952eae266413,qwen1-14B,1720668637,1720668973,finished,1720668659,1720668973,A100-SXM4-80GB,8,1,64,448,22,314
5bbaa5e2-f628-408e-ab67-22fd32246aa8,geogpt-sft-80wc-magpie-qwen2-half-mc-zh-llama3-8b,1720668686,1720761910,finished,1720668730,1720761910,A100-SXM4-80GB,8,4,64,448,44,93180
bcd8bb88-0859-43f8-a8f1-e50f5e5ac9d9,marker-xiaodian,1720668789,1720668877,finished,1720668811,1720668877,A100-SXM4-80GB,8,1,64,896,22,66
24f122cf-b2d1-45d0-870c-bafd9e57cabb,sql-spider-qy-0703,1720668907,1720669462,finished,1720668929,1720669462,A100-SXM4-80GB,8,1,64,448,22,533
60ae2406-fc31-4d79-9665-f9303ebd8355,marker-xiaodian,1720668969,1720669060,finished,1720668990,1720669060,A100-SXM4-80GB,8,1,64,896,21,70
5aa43bc4-c901-43f9-99c7-7b472740c1c0,geogpt-sft-qwen2-72b-datav081-ep1,1720669043,1720717097,finished,1720669067,1720717097,A100-SXM4-80GB,8,1,64,448,24,48030
69ff845b-fb7f-4362-beb7-b076eb8026cc,qwen1-14B,1720669065,1720669205,finished,1720669090,1720669205,A100-SXM4-80GB,8,1,64,448,25,115
90a654ba-5b1a-449c-8022-c4f0ff6a49c2,qwen7b-tcpt-lr-2e5-hw-sft-e2-88c8d-auto,1720669080,1720669171,finished,1720669103,1720669171,A100-SXM4-80GB,8,1,64,448,23,68
e052c3b9-8ad8-4ee1-9f7e-e9b3fa4a46cc,marker-xiaodian,1720669154,1720669246,finished,1720669179,1720669246,A100-SXM4-80GB,8,1,64,896,25,67
778881a2-240d-4ad1-a8f1-912ec3501fe9,qwen7b-tcpt-lr-8e5-hw-sft-e1-fc699-auto,1720669173,1720670663,finished,1720669195,1720670663,A100-SXM4-80GB,8,1,64,448,22,1468
c5421cc9-f816-4cfd-b75e-4a8568cf6d81,qwen7b-tcpt-lr-2e5-hw-sft-e1-c8b04-auto,1720669266,1720670736,finished,1720669288,1720670736,A100-SXM4-80GB,8,1,64,448,22,1448
45a0cb35-6205-434c-ae00-a4a91f099407,qwen1-14B,1720669298,1720669437,finished,1720669322,1720669437,A100-SXM4-80GB,8,1,64,448,24,115
6a746156-f42c-456e-9548-4e318044b4c9,marker-xiaodian,1720669340,1720669432,finished,1720669363,1720669432,A100-SXM4-80GB,8,1,64,896,23,69
0b56b2df-0ba0-4d69-b35e-b97c1129d71b,geogpt-2b,1720669352,1720669883,finished,1720669418,1720669883,A100-SXM4-80GB,8,4,64,448,66,465
8286d91a-55cd-4986-ab70-7e933b2cf7c1,qwen7b-tcpt-lr-2e5-hw-sft-e1-41f85-auto,1720669424,1720670737,finished,1720669450,1720670737,A100-SXM4-80GB,8,1,64,448,26,1287
008fd980-3ed9-4a01-bd59-4c60b6b1b0a7,qwen7b-tcpt-lr-8e5-hw-sft-e1-1462e-auto,1720669426,1720670711,finished,1720669450,1720670711,A100-SXM4-80GB,8,1,64,448,24,1261
46889e9d-267f-4f4a-8615-cc92777cc8b5,marker-xiaodian,1720669524,1720669614,finished,1720669547,1720669614,A100-SXM4-80GB,8,1,64,896,23,67
7070dda4-b338-4a2b-aa6b-4735e599c211,qwen1-14B,1720669528,1720669852,finished,1720669551,1720669852,A100-SXM4-80GB,8,1,64,448,23,301
ebbf861f-d2b0-49a0-9f39-bd12dad169a9,geogpt-7b-50bcpt-zero3,1720669602,1720670780,finished,1720669672,1720670780,A100-SXM4-80GB,8,4,64,448,70,1108
cb357285-5bef-4e5b-8b91-e2e4205a93d4,marker-xiaodian,1720669708,1720669801,finished,1720669730,1720669801,A100-SXM4-80GB,8,1,64,896,22,71
53ac9f57-7de4-4bed-90f0-40b19842b81c,Llama3-8B-Instruct-a4f9f-auto,1720669747,1720672250,finished,1720669772,1720672250,A100-SXM4-40GB,4,1,32,320,25,2478
a8ecfbfd-b136-4eaf-a0be-b792fc604c10,llama2-mosaic-3epo-basel-d9cb3-auto,1720669750,1720670761,finished,1720669773,1720670761,A100-SXM4-80GB,8,1,64,448,23,988
5cbd6bd8-0008-478a-b99f-c03e999537ca,marker-xiaodian,1720669893,1720669963,finished,1720669917,1720669963,A100-SXM4-80GB,8,1,64,896,24,46
216b0568-2e13-48a9-b4ba-cabc7f9428d1,qwen1-14B,1720669944,1720670058,finished,1720669967,1720670058,A100-SXM4-80GB,8,1,64,448,23,91
dd50c659-340b-4ff8-a57c-f8e3fc1d7655,marker-xiaodian,1720670053,1720670149,finished,1720670077,1720670149,A100-SXM4-80GB,8,1,64,896,24,72
f1cdd81c-1efd-4793-b8b3-27a152d31a2c,qwen1-14B,1720670154,1720670296,finished,1720670177,1720670296,A100-SXM4-80GB,8,1,64,448,23,119
d0110826-858f-48f6-ad77-6ef88b55a5ed,marker-xiaodian,1720670245,1720670339,finished,1720670268,1720670339,A100-SXM4-80GB,8,1,64,896,23,71
8c640ab7-52fb-4208-a8dc-e5aa91db2b1f,qwen1-14B,1720670369,1720670487,finished,1720670393,1720670487,A100-SXM4-80GB,8,1,64,448,24,94
0d28152f-6aaf-4949-ba28-ed76fdd0bfd6,marker-xiaodian,1720670435,1720670505,finished,1720670459,1720670505,A100-SXM4-80GB,8,1,64,896,24,46
e9eee478-0420-4281-aa41-624e50d61d89,qwen1-14B,1720670557,1720670675,finished,1720670580,1720670675,A100-SXM4-80GB,8,1,64,448,23,95
fc7ed5e9-c6dc-41cc-babd-b82bf250b543,marker-xiaodian,1720670600,1720670694,finished,1720670623,1720670694,A100-SXM4-80GB,8,1,64,896,23,71
582d52a8-9807-4d0d-8d91-59ed8d5ecaae,qwen1-14B,1720670772,1720670908,finished,1720670795,1720670908,A100-SXM4-80GB,8,1,64,448,23,113
aba7e3e2-0111-464f-912c-0a8b8d2c4aa0,marker-xiaodian,1720670791,1720670881,finished,1720670814,1720670881,A100-SXM4-80GB,8,1,64,896,23,67
f4d375ff-dada-440a-9ec4-0b7801ea668b,marker-xiaodian,1720670973,1720671063,finished,1720670995,1720671063,A100-SXM4-80GB,8,1,64,896,22,68
77a75930-2873-4d5a-bc8d-2da8895498bc,qwen1-14B,1720671000,1720671135,finished,1720671023,1720671135,A100-SXM4-80GB,8,1,64,448,23,112
ef83bf20-4a34-498c-95ab-615fb8bd24e3,marker-xiaodian,1720671153,1720671247,finished,1720671176,1720671247,A100-SXM4-80GB,8,1,64,896,23,71
872c8526-8f4a-4dfd-9fdc-7c09eef72dff,geogpt-dairui-model-merge-exp-2,1720671161,1720673121,finished,1720671184,1720673121,A100-SXM4-80GB,8,1,64,896,23,1937
77c9b4b1-2954-4472-920f-72da8b5f6c63,geogpt-dairui-eval-code-2,1720671185,1720672128,finished,1720671209,1720672128,A100-SXM4-80GB,8,1,64,448,24,919
ea2e4992-79d5-4fee-ac7c-59a0aae40457,qwen1-14B,1720671229,1720671363,finished,1720671252,1720671363,A100-SXM4-80GB,8,1,64,448,23,111
d176591e-1f84-484b-aed8-2023603e12b7,marker-xiaodian,1720671335,1720671426,finished,1720671358,1720671426,A100-SXM4-80GB,8,1,64,896,23,68
f95c2355-3903-41f0-88b8-5a85c459ad7a,qwen7b-tcpt-lr-8e5-hw-sft-e1-fc699-auto,1720671397,1720671998,finished,1720671421,1720671998,A100-SXM4-80GB,8,1,64,448,24,577
e8b4bc3f-0329-480e-bbc3-d383ff87737e,qwen1-14B,1720671453,1720671587,finished,1720671477,1720671587,A100-SXM4-80GB,8,1,64,448,24,110
3514ff47-75e4-4dfa-9ccf-128763e9a326,marker-xiaodian,1720671517,1720671606,finished,1720671539,1720671606,A100-SXM4-80GB,8,1,64,896,22,67
0f664a44-6bc5-4c78-a121-18e493ca2566,qwen1-14B,1720671655,1720671787,finished,1720671678,1720671787,A100-SXM4-80GB,8,1,64,448,23,109
95a91353-aec1-4898-bae2-d2f9c341047c,marker-xiaodian,1720671696,1720671804,finished,1720671717,1720671804,A100-SXM4-80GB,8,1,64,896,21,87
a9780f7f-a72b-42a2-a06d-994578e827c9,qwen1-14B,1720671876,1720672008,finished,1720671898,1720672008,A100-SXM4-80GB,8,1,64,448,22,110
ad926f38-d168-4a52-9faa-ee2af6b3e128,marker-xiaodian,1720671894,1720671982,finished,1720671915,1720671982,A100-SXM4-80GB,8,1,64,896,21,67
3575a494-26ca-4fcb-8346-7efe7b9d9a22,marker-xiaodian,1720672072,1720672166,finished,1720672097,1720672166,A100-SXM4-80GB,8,1,64,896,25,69
1a57a2d5-6c6c-4336-8af7-35cb1025e5b2,qwen1-14B,1720672077,1720672218,finished,1720672102,1720672218,A100-SXM4-80GB,8,1,64,448,25,116
28bd8344-ff17-4919-a6f1-b34e6ce5e39a,geogpt-dairui-eval-code-2,1720672128,1720672424,finished,1720672151,1720672424,A100-SXM4-80GB,8,1,64,448,23,273
8f727dc7-1b1f-425e-83e0-d9e632e49a4a,marker-xiaodian,1720672257,1720672348,finished,1720672280,1720672348,A100-SXM4-80GB,8,1,64,896,23,68
de82708f-93be-438f-83c7-66312c6e59de,qwen1-14B,1720672307,1720672443,finished,1720672329,1720672443,A100-SXM4-80GB,8,1,64,448,22,114
05b3265a-dcaf-4728-9474-7e36c9804744,geogpt-dairui-eval-code-2,1720672424,1720672807,finished,1720672446,1720672807,A100-SXM4-80GB,8,1,64,448,22,361
c1c48038-39c6-4df5-9b72-394fa6e3acaf,marker-xiaodian,1720672438,1720672528,finished,1720672461,1720672528,A100-SXM4-80GB,8,1,64,896,23,67
9e9cb9b5-83ce-454d-b7b6-867bf61d12b2,qwen1-14B,1720672533,1720672668,finished,1720672556,1720672668,A100-SXM4-80GB,8,1,64,448,23,112
49f762ce-13e9-46b0-8e91-b7eed0680fc5,marker-xiaodian,1720672617,1720672706,finished,1720672641,1720672706,A100-SXM4-80GB,8,1,64,896,24,65
3a6893d8-f191-4f95-af6e-0a2140c1ef70,qwen1-14B,1720672757,1720672893,finished,1720672779,1720672893,A100-SXM4-80GB,8,1,64,448,22,114
c0a22d8c-958d-49c8-a73d-c0f90b8d66a2,marker-xiaodian,1720672799,1720672888,finished,1720672821,1720672888,A100-SXM4-80GB,8,1,64,896,22,67
44783c68-a2db-417e-815a-dc3fb151f919,geogpt-dairui-eval-code-2,1720672807,1720673299,finished,1720672830,1720673299,A100-SXM4-80GB,8,1,64,448,23,469
5450fd9e-102a-43cf-a8cd-3396c515430e,qwen1-14B,1720672961,1720673071,finished,1720672983,1720673071,A100-SXM4-80GB,8,1,64,448,22,88
515cbfc7-2c5f-4d84-b334-a8e41216bae6,marker-xiaodian,1720672978,1720673067,finished,1720673001,1720673067,A100-SXM4-80GB,8,1,64,896,23,66
6bdcce46-af16-40ff-ac5d-9ea4613e77e8,geogpt-dairui-model-merge-exp-2,1720673121,1720673478,finished,1720673143,1720673478,A100-SXM4-80GB,8,1,64,896,22,335
2b29794d-f186-4309-9238-70e2d3c63478,marker-xiaodian,1720673158,1720673247,finished,1720673180,1720673247,A100-SXM4-80GB,8,1,64,896,22,67
f89be655-c491-427d-a3d1-e71f68d68277,qwen1-14B,1720673162,1720673296,finished,1720673185,1720673296,A100-SXM4-80GB,8,1,64,448,23,111
579afd0c-6b10-451a-a0e6-2c95923ceabf,marker-xiaodian,1720673335,1720673423,finished,1720673358,1720673423,A100-SXM4-80GB,8,1,64,896,23,65
206b3385-2219-4bdd-bf21-cfe2804f8e1a,qwen1-14B,1720673385,1720673520,finished,1720673407,1720673520,A100-SXM4-80GB,8,1,64,448,22,113
b69c8c29-1499-4b1c-9fc3-e94ca34c2220,geogpt-dairui-model-merge-exp-2,1720673478,1720673942,finished,1720673501,1720673942,A100-SXM4-80GB,8,1,64,896,23,441
0e7fcac1-d255-4f81-b1da-fc35af95e6f6,geogpt-dairui-eval-code-2,1720673478,1720674076,finished,1720673501,1720674076,A100-SXM4-80GB,8,1,64,448,23,575
3f50ef85-5b5f-44fd-aecb-2c19864036f6,marker-xiaodian,1720673515,1720673607,finished,1720673538,1720673607,A100-SXM4-80GB,8,1,64,896,23,69
54992fc3-bb87-4491-82c4-6eb3051da335,qwen1-14B,1720673612,1720673763,finished,1720673634,1720673763,A100-SXM4-80GB,8,1,64,448,22,129
52837657-795c-495f-9060-26846d942ce9,marker-xiaodian,1720673694,1720673781,finished,1720673715,1720673781,A100-SXM4-80GB,8,1,64,896,21,66
9e66afb6-2b1a-4587-ab7c-3ec6431cc515,qwen1-14B,1720673852,1720673983,finished,1720673874,1720673983,A100-SXM4-80GB,8,1,64,448,22,109
f3109d66-ce7d-4518-84e1-d54ae50917b1,marker-xiaodian,1720673869,1720673956,finished,1720673891,1720673956,A100-SXM4-80GB,8,1,64,896,22,65
29ea03d1-721e-4d20-9162-9fc6c5ee9f7a,marker-xiaodian,1720674045,1720674134,finished,1720674069,1720674134,A100-SXM4-80GB,8,1,64,896,24,65
d6732418-c13d-4032-8f65-755616ff7e6f,qwen7b-tcpt-lr-2e5-hw-sft-e1-c8b04-auto,1720674063,1720674655,finished,1720674085,1720674655,A100-SXM4-80GB,8,1,64,448,22,570
e4763a24-19c2-499c-b9a1-5f04eda39a6f,qwen1-14B,1720674073,1720674204,finished,1720674095,1720674204,A100-SXM4-80GB,8,1,64,448,22,109
4c03086f-cd01-43ad-a0d8-7e4bf2564999,marker-xiaodian,1720674220,1720674308,finished,1720674242,1720674308,A100-SXM4-80GB,8,1,64,896,22,66
ef6f9087-d42d-4029-bd76-c817bb493c7a,qwen1-14B,1720674270,1720674401,finished,1720674291,1720674401,A100-SXM4-80GB,8,1,64,448,21,110
40f807b7-7e7a-459c-bd65-d8c59f140c5d,marker-xiaodian,1720674396,1720674506,finished,1720674418,1720674506,A100-SXM4-80GB,8,1,64,896,22,88
508f3864-4dd2-4170-bd33-ac7d844da25d,qwen1-14B,1720674488,1720674621,finished,1720674511,1720674621,A100-SXM4-80GB,8,1,64,448,23,110
6a6d019e-5d26-4229-8a8d-d33e98e7577f,marker-xiaodian,1720674593,1720674685,finished,1720674616,1720674685,A100-SXM4-80GB,8,1,64,896,23,69
a55c657c-84c5-43aa-8361-753fc218464b,llama3-longtext-CS-4mosaic-a00aa-auto,1720674657,1720679751,finished,1720674680,1720679751,A100-SXM4-80GB,8,1,64,448,23,5071
ba993f23-8409-47fc-a0d6-b4ee9017d859,qwen1-14B,1720674713,1720674850,finished,1720674735,1720674850,A100-SXM4-80GB,8,1,64,448,22,115
ea2df27c-3296-4004-9417-a9fb5d7f923d,marker-xiaodian,1720674774,1720674868,finished,1720674798,1720674868,A100-SXM4-80GB,8,1,64,896,24,70
279da4a1-f67c-4ffc-8a8d-e050cd25bb4f,geogpt-moe-0b5-start12-freeze-attn-tag1,1720674783,1720701305,finished,1720674854,1720701305,A100-SXM4-80GB,8,2,64,896,71,26451
c300ba23-bab0-454d-be37-ffd4968139c8,geogpt-moe-0b5-step4-freeze-attn-tag1,1720674807,1720698995,finished,1720674875,1720698995,A100-SXM4-80GB,8,2,64,896,68,24120
f4a3039b-98d7-4af4-b906-16d902d3587d,llama3-CS-4mosaic-58020-auto,1720674840,1720676532,finished,1720674863,1720676532,A100-SXM4-80GB,8,1,64,448,23,1669
916e56f4-7118-48cc-b7cf-ba5edc740a40,llama3-noCSmosaic-3epo-614b6-auto,1720674910,1720676510,finished,1720674932,1720676510,A100-SXM4-80GB,8,1,64,448,22,1578
46b30ecf-aa7e-4512-a5cf-0e52287d3d35,qwen1-14B,1720674920,1720675054,finished,1720674942,1720675054,A100-SXM4-80GB,8,1,64,448,22,112
4e1b56b8-8e35-43af-b09d-77270590daf9,marker-xiaodian,1720674961,1720675049,finished,1720674983,1720675049,A100-SXM4-80GB,8,1,64,896,22,66
4fb78cbb-5e56-4a9f-b399-c0c427c59c4b,marker-xiaodian,1720675141,1720675209,finished,1720675163,1720675209,A100-SXM4-80GB,8,1,64,896,22,46
0769f206-c54e-4c3c-a769-ad93b06106a2,qwen1-14B,1720675146,1720675280,finished,1720675168,1720675280,A100-SXM4-80GB,8,1,64,448,22,112
c93e86a7-15f7-41e9-8b36-2439f1f586e1,marker-xiaodian,1720675298,1720675367,finished,1720675319,1720675367,A100-SXM4-80GB,8,1,64,896,21,48
47b8f49e-a81c-4c10-860b-e6dd6a58dd8e,qwen1-14B,1720675348,1720675483,finished,1720675372,1720675483,A100-SXM4-80GB,8,1,64,448,24,111
655b0d1b-11e2-449f-8dc2-b8b5c0c6744a,marker-xiaodian,1720675456,1720675524,finished,1720675478,1720675524,A100-SXM4-80GB,8,1,64,896,22,46
b37d4e7f-0eee-4431-869b-f001c483f0b9,qwen1-14B,1720675575,1720675690,finished,1720675599,1720675690,A100-SXM4-80GB,8,1,64,448,24,91
fe50c990-f797-4e2d-9bbb-35c308dfd24b,marker-xiaodian,1720675616,1720675707,finished,1720675640,1720675707,A100-SXM4-80GB,8,1,64,896,24,67
e80a1513-43d3-4fca-becd-e42866c3c995,geo-base-offline-eval,1720675647,1720679329,finished,1720675669,1720679329,A100-SXM4-80GB,8,1,64,448,22,3660
31eecae6-756e-41dd-a0fd-18aadacdb1f9,qwen1-14B,1720675782,1720675917,finished,1720675805,1720675917,A100-SXM4-80GB,8,1,64,448,23,112
43f3623c-e75b-44bb-9d3f-8934ab6e9fd9,marker-xiaodian,1720675800,1720675890,finished,1720675824,1720675890,A100-SXM4-80GB,8,1,64,896,24,66
c4a02ded-b17d-49dc-b434-2b1ae1e8a559,marker-xiaodian,1720675982,1720676074,finished,1720676006,1720676074,A100-SXM4-80GB,8,1,64,896,24,68
bcbc8903-6c35-4e6d-9b43-edc50af7f825,qwen1-14B,1720676010,1720676146,finished,1720676033,1720676146,A100-SXM4-80GB,8,1,64,448,23,113
8d474e9c-ceea-40a2-9182-15979e74b3fb,marker-xiaodian,1720676164,1720676234,finished,1720676188,1720676234,A100-SXM4-80GB,8,1,64,896,24,46
15e076be-dbd1-487b-bb6d-af298e272652,geogpt-sft-80wc-magpie-qwen2-mpyc-llama3-8b,1720676174,1720757106,finished,1720676245,1720757106,A100-SXM4-80GB,8,4,64,448,71,80861
3babf06c-1a36-4a6d-b7d0-16218ad295ed,qwen1-14B,1720676239,1720676382,finished,1720676264,1720676382,A100-SXM4-80GB,8,1,64,448,25,118
7659d432-1738-498c-9898-87a39b58e3e4,geogpt-dairui-eval-code-2,1720676293,1720676768,finished,1720676316,1720676768,A100-SXM4-80GB,8,1,64,448,23,452
05e6b747-43a6-4421-9d1b-8ce7c096d54f,geogpt-dairui-model-merge-exp-2,1720676316,1720676790,finished,1720676340,1720676790,A100-SXM4-80GB,8,1,64,896,24,450
0c893bd8-675e-44a4-a688-c6c6e150f037,marker-xiaodian,1720676332,1720676423,finished,1720676355,1720676423,A100-SXM4-80GB,8,1,64,896,23,68
335ecc95-5c24-4041-8683-5fedc27b8157,qwen1-14B,1720676451,1720676787,finished,1720676475,1720676787,A100-SXM4-80GB,8,1,64,448,24,312
1187d56b-7c63-4a02-9dce-29d82f067782,marker-xiaodian,1720676515,1720676605,finished,1720676538,1720676605,A100-SXM4-80GB,8,1,64,896,23,67
ad5915e5-4dd5-495d-8d86-4f368c9891d6,sfr-ft-3,1720676653,1720943704,finished,1720676675,1720943704,A100-SXM4-80GB,8,1,64,448,22,267029
2372f2ec-1603-4a40-b13f-df44a1416a10,marker-xiaodian,1720676694,1720676782,finished,1720676716,1720676782,A100-SXM4-80GB,8,1,64,896,22,66
7a9be5a3-dd94-4357-b12a-b21c6048848a,geogpt-dairui-model-merge-exp-2,1720676841,1720677241,finished,1720676865,1720677241,A100-SXM4-80GB,8,1,64,896,24,376
ca835a6f-c13a-4975-bbef-bf0dbe0fe237,geogpt-dairui-eval-code-2,1720676841,1720677241,finished,1720676865,1720677241,A100-SXM4-80GB,8,1,64,448,24,376
53bc3c60-7c98-4ba2-ad9e-5619a66f2912,llama3-8b-cpt-32k-1-5b-lora-8a4d1-auto,1720676857,1720695045,finished,1720676882,1720695045,A100-SXM4-80GB,8,1,64,896,25,18163
213c260b-0145-413b-b08f-b6b3a2e71d56,marker-xiaodian,1720676880,1720676970,finished,1720676904,1720676970,A100-SXM4-80GB,8,1,64,896,24,66
599b8412-9cdb-4180-a25a-e167bd85fa06,llama3-8b-cpt-80k-1-5b-lora-57ce9-auto,1720676882,1720695045,finished,1720676906,1720695045,A100-SXM4-80GB,8,1,64,896,24,18139
335d39ce-52ed-41e5-a3b8-d11d0054c919,qwen1-14B,1720676885,1720677260,finished,1720676909,1720677260,A100-SXM4-80GB,8,1,64,448,24,351
40f854d4-14ac-4c99-97c4-619d2c13c27d,marker-xiaodian,1720677056,1720677143,finished,1720677078,1720677143,A100-SXM4-80GB,8,1,64,896,22,65
f901c151-d123-4d5c-a1ce-c6568c320920,marker-xiaodian,1720677233,1720677323,finished,1720677256,1720677323,A100-SXM4-80GB,8,1,64,896,23,67
c80d3c15-4dc8-4f3a-9932-9c402c90b290,geogpt-dairui-eval-code-2,1720677241,1720677792,finished,1720677264,1720677792,A100-SXM4-80GB,8,1,64,448,23,528
e089557f-4adf-40ed-8bdd-b9e878db7d62,geogpt-dairui-model-merge-exp-2,1720677241,1720677792,finished,1720677264,1720677792,A100-SXM4-80GB,8,1,64,896,23,528
b4486594-9fa9-4b9e-9a29-7ced0fa04f8e,qwen1-14B,1720677328,1720677461,finished,1720677351,1720677461,A100-SXM4-80GB,8,1,64,448,23,110
f5679342-4eba-4c3f-99b7-e7dbd33d55b1,qwen7b-tcpt-lr-2e5-hw-sft-e1-c8b04-auto,1720677386,1720677962,finished,1720677408,1720677962,A100-SXM4-80GB,8,1,64,448,22,554
f53a2d1b-ddb6-4d52-8b3d-639c8f0f5e24,marker-xiaodian,1720677413,1720677504,finished,1720677435,1720677504,A100-SXM4-80GB,8,1,64,896,22,69
61deb02e-7a84-4f47-8fcd-985d6b07b05c,opencompass-eval-0711,1720677482,1720684993,finished,1720677505,1720684993,A100-SXM4-80GB,8,1,64,896,23,7488
d90fdccd-8a0e-43a4-9fc9-3290130ab615,opencompass-eval-0711,1720677551,1720687082,finished,1720677576,1720687082,A100-SXM4-80GB,8,1,64,896,25,9506
be953b49-fe80-4909-b9fd-a27773fd5e76,qwen1-14B,1720677555,1720677882,finished,1720677580,1720677882,A100-SXM4-80GB,8,1,64,448,25,302
01dbd51d-21e7-4029-b776-d5aea213c322,opencompass-eval-0711,1720677576,1720687327,finished,1720677600,1720687327,A100-SXM4-80GB,8,1,64,896,24,9727
a2b4ac0e-b4fd-4fc0-a1f6-1de31fef0622,marker-xiaodian,1720677598,1720677808,finished,1720677622,1720677808,A100-SXM4-80GB,8,1,64,896,24,186
360d09ed-f26b-4c95-b8a2-8939ba23389d,geogpt-dairui-model-merge-exp-2,1720677792,1720683258,finished,1720677816,1720683258,A100-SXM4-80GB,8,1,64,896,24,5442
fed4be53-48e6-4fd1-b329-95db88df3e9b,geogpt-dairui-eval-code-2,1720677793,1720683215,finished,1720677816,1720683215,A100-SXM4-80GB,8,1,64,448,23,5399
bfd426a2-c1be-451f-8237-88b28a03552e,Qwen2-7B-Instruct-f5971-auto,1720677864,1720678875,finished,1720677886,1720678875,A100-SXM4-80GB,8,1,64,448,22,989
e717439d-ca59-44b7-b84f-91c92e1d55e2,marker-xiaodian,1720677899,1720677990,finished,1720677923,1720677990,A100-SXM4-80GB,8,1,64,896,24,67
30d32dcc-da87-469e-aa05-4cbf5ebd8bee,qwen1-14B,1720677973,1720678107,finished,1720677995,1720678107,A100-SXM4-80GB,8,1,64,448,22,112
4c2d840d-9b01-4611-bfb7-588e6b2e4c25,marker-xiaodian,1720678079,1720678171,finished,1720678102,1720678171,A100-SXM4-80GB,8,1,64,896,23,69
534e37b2-a931-4564-910a-4ac52495c445,qwen7b-tcpt-lr-8e5-hw-sft-e1-fc699-auto,1720678165,1720678723,finished,1720678187,1720678723,A100-SXM4-80GB,8,1,64,448,22,536
953b3eb4-7690-496d-baac-ef237f0cf599,qwen1-14B,1720678197,1720678329,finished,1720678219,1720678329,A100-SXM4-80GB,8,1,64,448,22,110
b1ee5f54-bfdc-42be-98a3-a8012af8358c,marker-xiaodian,1720678259,1720678368,finished,1720678303,1720678368,A100-SXM4-80GB,8,1,64,896,44,65
0b6f5c06-3b46-42c3-961e-f2b7478fd5ce,qwen1-14B,1720678417,1720678548,finished,1720678439,1720678548,A100-SXM4-80GB,8,1,64,448,22,109
13ac5e03-be3e-4791-8bfe-c934690409e5,marker-xiaodian,1720678457,1720678589,finished,1720678522,1720678589,A100-SXM4-80GB,8,1,64,896,65,67
98fe9da9-bafd-4594-8291-c3ef4192fcfb,qwen1-14B,1720678640,1720678777,finished,1720678663,1720678777,A100-SXM4-80GB,8,1,64,448,23,114
a9b82cb1-ed10-4c4c-961a-8e6a96be6892,llama3-nocs-4mosaic-1ep-864ca-auto,1720678677,1720680751,finished,1720678724,1720680751,A100-SXM4-80GB,8,1,64,448,47,2027
87a6ea42-5984-4d6f-b1a6-2e6ef66a7870,marker-xiaodian,1720678684,1720678956,finished,1720678706,1720678956,A100-SXM4-80GB,8,1,64,896,22,250
61af47b4-90d2-414e-9bd8-6c0c8fd9f4e1,m8x7b-sft-1ep-wocpt-fb421-auto,1720678830,1720691418,finished,1720678853,1720691418,A100-SXM4-80GB,8,1,64,448,23,12565
bac69e9b-641a-4c28-85f9-a2fa7b6aad8f,qwen1-14B,1720678848,1720679206,finished,1720678893,1720679206,A100-SXM4-80GB,8,1,64,448,45,313
d62204e5-7af4-498e-ae27-6b531a0ccd94,m8x7b-10bcpt-1ep-auxloss-f1980-auto,1720678941,1720695053,finished,1720679187,1720695053,A100-SXM4-80GB,8,1,64,448,246,15866
79a3af70-465d-4b6c-b752-478ccf89aa3c,tcpt-2e5-hw-sft-66668-auto,1720678950,1720679150,finished,1720678973,1720679150,A100-SXM4-80GB,8,1,64,448,23,177
2bad6e4b-0a23-49a9-91d4-49a67992f36f,marker-xiaodian,1720679044,1720679248,finished,1720679178,1720679248,A100-SXM4-80GB,8,1,64,896,134,70
c750e7eb-4ece-4b11-8bdb-03c132715adb,dpo-train,1720679099,1720679287,finished,1720679168,1720679287,A100-SXM4-80GB,4,1,32,448,69,119
9d364ccc-7714-4dd4-9c9e-ba22005c9df5,geogpt-cpt-test-dairui,1720679119,1720679580,finished,1720679164,1720679580,A100-SXM4-80GB,8,1,64,896,45,416
1cec6730-65da-481a-b56c-c09b775f2817,mistral-long-maxl3w-52016-auto,1720679220,1720683929,finished,1720679243,1720683929,A100-SXM4-80GB,8,1,64,448,23,4686
e0e0b727-8a0a-49cf-9f7f-d762dc4a0409,qwen1-14B,1720679302,1720679483,finished,1720679349,1720679483,A100-SXM4-80GB,8,1,64,448,47,134
9802f5d3-33c2-4d0c-8aa1-fbea09994b88,marker-xiaodian,1720679344,1720679687,finished,1720679367,1720679687,A100-SXM4-80GB,8,1,64,896,23,320
6357650a-60d5-46d3-b166-149e1af0a742,qwen1-5-14b-134bcpt-0-2ep-9f7a8-auto,1720679384,1720680300,finished,1720679565,1720680300,A100-SXM4-80GB,8,1,64,448,181,735
b1411ce7-2f06-43dd-8f29-225d2b2c950c,qwen1-14B,1720679577,1720679808,finished,1720679692,1720679808,A100-SXM4-80GB,8,1,64,448,115,116
d7df0593-58cb-46c4-a4ca-f974273d98ae,geogpt-cpt-test-dairui,1720679580,1720680106,finished,1720679788,1720680106,A100-SXM4-80GB,8,1,64,896,208,318
cfba641f-54e3-4ad1-9a57-0a36e5a8f200,debug,1720679692,1720679808,finished,1720679716,1720679808,A100-SXM4-80GB,8,1,64,448,24,92
80ea46c1-c877-496d-9a09-eb2f06381ccc,llama-multi,1720679763,1720680335,finished,1720679785,1720680335,A100-SXM4-80GB,8,1,64,448,22,550
c45f5740-d748-4079-8bb4-c51ace8587d4,marker-xiaodian,1720679780,1720680167,finished,1720679803,1720680167,A100-SXM4-80GB,8,1,64,896,23,364
a6fa698b-5960-48b9-88ad-b919e1987fc3,qwen1-14B,1720679899,1720680288,finished,1720680172,1720680288,A100-SXM4-80GB,8,1,64,448,273,116
ccde0639-fdaa-4a34-ad97-547cafd95845,marker-xiaodian,1720680259,1720680354,finished,1720680283,1720680354,A100-SXM4-80GB,8,1,64,896,24,71
a295da88-b23d-400e-98e1-4b96f86bc91c,train-clip-0711,1720680285,1720746707,finished,1720680309,1720746707,A100-SXM4-80GB,8,1,64,896,24,66398
e71e0def-4d8c-4b12-819f-9e0d735903bc,marker-xiaodian,1720680446,1720680536,finished,1720680469,1720680536,A100-SXM4-80GB,8,1,64,896,23,67
1c75e29c-ed84-4186-bec3-0f901b5e2bd7,debug,1720680474,1720684167,finished,1720680497,1720684167,A100-SXM4-80GB,8,1,64,448,23,3670
dd80ec01-7f76-4651-802c-bde11eeb4457,train-0710,1720680560,1720695925,finished,1720680584,1720695925,A100-SXM4-80GB,8,1,64,896,24,15341
5764aba7-3616-4166-b2ce-e0e7e49c626c,marker-xiaodian,1720680626,1720680714,finished,1720680648,1720680714,A100-SXM4-80GB,8,1,64,896,22,66
b6a6eff5-c595-475e-b01b-38ed06caadc4,marker-xiaodian,1720680799,1720680885,finished,1720680821,1720680885,A100-SXM4-80GB,8,1,64,896,22,64
ac9ff01e-05c5-4cee-b704-525fff87442f,marker-xiaodian,1720680971,1720681057,finished,1720680992,1720681057,A100-SXM4-80GB,8,1,64,896,21,65
1c3a78c7-85ba-4955-ad77-17e7cf6da6c8,llama-multi,1720681127,1720681302,finished,1720681150,1720681302,A100-SXM4-80GB,8,1,64,448,23,152
f5114675-68bf-4adf-aef5-d9ac096a44ae,marker-xiaodian,1720681144,1720681232,finished,1720681167,1720681232,A100-SXM4-80GB,8,1,64,896,23,65
d1f8c388-5f2d-4a9b-bcb7-026c34960d6b,marker-xiaodian,1720681318,1720681403,finished,1720681340,1720681403,A100-SXM4-80GB,8,1,64,896,22,63
4605a417-0265-432e-b920-715a7119b4f6,geogpt-sft-qwen2-72b-datav08-ep1,1720681325,1720696803,finished,1720681347,1720696803,A100-SXM4-80GB,8,1,64,448,22,15456
91cfd438-ebce-4fb7-8770-025c5013367d,marker-xiaodian,1720681493,1720681583,finished,1720681515,1720681583,A100-SXM4-80GB,8,1,64,896,22,68
46a3975d-7503-4eb9-b928-975fff372628,marker-xiaodian,1720681670,1720681756,finished,1720681691,1720681756,A100-SXM4-80GB,8,1,64,896,21,65
f8b7c93d-5d61-4b88-9307-8e3fcacd4b81,geogpt-qwen2-chat-0612dpo-dare-ties-p17,1720681743,1720682405,finished,1720681766,1720682405,A100-SXM4-80GB,8,1,64,448,23,639
f358cfc6-867d-4390-986b-14df04d76c45,marker-xiaodian,1720681843,1720681932,finished,1720681866,1720681932,A100-SXM4-80GB,8,1,64,896,23,66
b9f67644-a5f3-4bee-a21a-300d4a45cb4f,llama2-7b-chat-04fb4-auto,1720681861,1720683155,finished,1720681882,1720683155,A100-SXM4-80GB,8,1,64,448,21,1273
c7621bc4-e82e-4eed-8f61-fc437b4e88f0,reranker-inference,1720681913,1720855007,finished,1720681935,1720855007,A100-SXM4-80GB,8,1,64,448,22,173072
40b87fe3-0982-4911-bbed-68e437af2430,marker-xiaodian,1720682021,1720682574,finished,1720682042,1720682574,A100-SXM4-80GB,8,1,64,896,21,532
7dc4cfac-7b20-42b4-918c-efa4d6e7c0ea,llama-multi,1720682114,1720682289,finished,1720682136,1720682289,A100-SXM4-80GB,8,1,64,448,22,153
52a707fd-b392-42ba-97b0-5ac2953d135d,qwen1-5-14b-10bcpt-1ep-99f97-auto,1720682437,1720683998,finished,1720682459,1720683998,A100-SXM4-80GB,8,1,64,448,22,1539
231e479a-039a-4872-8369-e801e5a818f8,marker-xiaodian,1720682663,1720682753,finished,1720682686,1720682753,A100-SXM4-80GB,8,1,64,896,23,67
e494d59e-f45c-4ac3-92b7-c472b95c4b53,Llama3-8B-Instruct-4d4b2-auto,1720682912,1720692195,finished,1720682933,1720692195,A100-SXM4-40GB,4,1,32,320,21,9262
ffe9e25a-0c73-4f1c-9752-badf36f60009,marker-xiaodian,1720682961,1720683050,finished,1720682984,1720683050,A100-SXM4-80GB,8,1,64,896,23,66
11a1ab49-0edf-4ae3-b5d4-37a68ea67a06,marker-xiaodian,1720683137,1720683250,finished,1720683160,1720683250,A100-SXM4-80GB,8,1,64,896,23,90
6a7dcbf4-d43f-432c-86bb-341e518e7671,geogpt-dairui-model-merge-exp-1,1720683169,1720726544,finished,1720683192,1720726544,A100-SXM4-80GB,8,1,64,896,23,43352
822c6557-c5b6-4797-8a50-ae0011843ad0,geogpt-dairui-model-merge-exp-2,1720683258,1720720815,finished,1720683280,1720720815,A100-SXM4-80GB,8,1,64,896,22,37535
8f010c74-97c1-4f75-98e5-87f65874ff5d,marker-xiaodian,1720683339,1720683428,finished,1720683362,1720683428,A100-SXM4-80GB,8,1,64,896,23,66
76dd2adc-8123-4c86-9d65-6cad34cc5d67,GeoGPT-0701-v2-3215c-auto,1720683489,1720686641,finished,1720683511,1720686641,A100-SXM4-80GB,8,1,64,448,22,3130
e04b1133-9c9c-49ef-ad77-fc7749247443,marker-xiaodian,1720683518,1720684072,finished,1720683539,1720684072,A100-SXM4-80GB,8,1,64,896,21,533
5991be4c-9b53-4dc9-bf57-f707ba294576,qwen7b-tcpt-lr-2e5-hw-sft-e1-f9d3d-auto,1720683930,1720684940,finished,1720683954,1720684940,A100-SXM4-80GB,8,1,64,448,24,986
d1fbd3f1-b487-49e6-9758-40895bbe20da,qwen7b-tcpt-lr-8e5-hw-sft-e1-89c18-auto,1720684001,1720684986,finished,1720684023,1720684986,A100-SXM4-80GB,8,1,64,448,22,963
0535be71-8427-401e-a7ca-b2db60283b23,geogpt-qwen2-chat-0612dpo-dare-ties-p57,1720684126,1720751301,finished,1720684149,1720751301,A100-SXM4-80GB,8,1,64,448,23,67152
955a7c3c-be07-4226-9e3f-f031bfee80ab,marker-xiaodian,1720684162,1720684458,finished,1720684184,1720684458,A100-SXM4-80GB,8,1,64,896,22,274
986ad8d4-75da-4663-9dc4-7e13ea67f521,llama-multi,1720684302,1720684463,finished,1720684326,1720684463,A100-SXM4-80GB,8,1,64,448,24,137
b80ece5f-b334-4888-99ff-918b4c98e476,debug,1720684325,1720691686,finished,1720684349,1720691686,A100-SXM4-80GB,8,1,64,448,24,7337
522bcc0f-fa36-4992-8168-7d921c43c740,marker-xiaodian,1720684548,1720685105,finished,1720684573,1720685105,A100-SXM4-80GB,8,1,64,896,25,532
99e668be-b212-42ca-807f-11b865d3be74,llama-multi,1720684578,1720684816,finished,1720684601,1720684816,A100-SXM4-80GB,8,1,64,448,23,215
abc7a5b4-9073-460a-b2cd-abc97596a089,qwen1-5-14b-10bcpt-1ep-d4270-auto,1720684614,1720685617,finished,1720684985,1720685617,A100-SXM4-80GB,8,1,64,448,371,632
596fc10f-9076-46c9-8f21-420b633f13c8,txchen-lm-eval2,1720684804,1720685506,finished,1720684963,1720685506,A100-SXM4-80GB,8,1,64,448,159,543
bc2a5fdf-0422-4906-819f-0b1722d8af09,geo-mod-05b-test,1720684818,1720688629,finished,1720685905,1720688629,A100-SXM4-80GB,8,4,64,448,1087,2724
18214c70-3920-46c6-b161-7d57b84c6ac8,llama-multi,1720684997,1720685401,finished,1720685021,1720685401,A100-SXM4-80GB,8,1,64,448,24,380
e6ba8dc9-b80c-48cd-bdbd-6f46b712d90c,marker-xiaodian,1720685194,1720685283,finished,1720685217,1720685283,A100-SXM4-80GB,8,1,64,896,23,66
25a17a75-6945-4606-89c9-023fe065414c,marker-xiaodian,1720685372,1720685463,finished,1720685396,1720685463,A100-SXM4-80GB,8,1,64,896,24,67
99e9a272-7328-455d-af2b-efd8460763a9,geogpt-dairui-eval-code-2,1720685496,1720687289,finished,1720685519,1720687289,A100-SXM4-80GB,8,1,64,448,23,1770
eb35c87e-5bee-4622-b20b-537de62ee0e3,txchen-lm-eval2,1720685506,1720685754,finished,1720685528,1720685754,A100-SXM4-80GB,8,1,64,448,22,226
a32dec29-8ce9-4e86-affe-f365037d9550,marker-xiaodian,1720685556,1720685624,finished,1720685579,1720685624,A100-SXM4-80GB,8,1,64,896,23,45
d328ff32-456b-4913-88cf-4e50ea61a5db,marker-xiaodian,1720685713,1720685805,finished,1720685737,1720685805,A100-SXM4-80GB,8,1,64,896,24,68
242df7b4-7f83-4792-ba86-dbf6cd64d27f,txchen-lm-eval2,1720685755,1720686006,finished,1720685778,1720686006,A100-SXM4-80GB,8,1,64,448,23,228
72baebb8-29e2-416b-8dc2-bd67f1e7db9d,llama-multi,1720685766,1720685948,finished,1720685788,1720685948,A100-SXM4-80GB,8,1,64,448,22,160
121d1a8b-1fca-4826-83a1-31b1a268b54b,marker-xiaodian,1720685897,1720685989,finished,1720685921,1720685989,A100-SXM4-80GB,8,1,64,896,24,68
e6c281c2-a6cb-4b12-bbae-025ff54cca11,txchen-lm-eval2,1720686006,1720686144,finished,1720686029,1720686144,A100-SXM4-80GB,8,1,64,448,23,115
5304afae-99a9-45be-bf39-2e6b67ab9f9d,marker-xiaodian,1720686080,1720686171,finished,1720686105,1720686171,A100-SXM4-80GB,8,1,64,896,25,66
3d9febca-2b15-4797-9488-85bcfa4ee9a1,qwen1-5-14b-chat-3ba63-auto,1720686098,1720686801,finished,1720686120,1720686801,A100-SXM4-80GB,8,1,64,448,22,681
652b2e7f-890d-4525-b864-1a9e593eebe1,txchen-lm-eval2,1720686235,1720686506,finished,1720686258,1720686506,A100-SXM4-80GB,8,1,64,448,23,248
b3e23b00-0125-4f1d-b0b1-cd8801644597,marker-xiaodian,1720686263,1720686352,finished,1720686286,1720686352,A100-SXM4-80GB,8,1,64,896,23,66
8ac77dc9-c337-4358-9246-93245d12e5a9,marker-xiaodian,1720686440,1720686536,finished,1720686463,1720686536,A100-SXM4-80GB,8,1,64,896,23,73
17f6f060-b60d-4708-be4e-7bc281438988,txchen-lm-eval2,1720686506,1720686873,finished,1720686530,1720686873,A100-SXM4-80GB,8,1,64,448,24,343
afe77a33-80d5-4c77-8a39-e03a390b0f09,marker-xiaodian,1720686626,1720686716,finished,1720686648,1720686716,A100-SXM4-80GB,8,1,64,896,22,68
74997d7b-c40d-475c-8024-0cdef8e13772,marker-xiaodian,1720686808,1720686901,finished,1720686832,1720686901,A100-SXM4-80GB,8,1,64,896,24,69
b8d49df5-02cd-4bfb-a4e7-63628626f6c2,llama-multi,1720686837,1720687041,finished,1720686861,1720687041,A100-SXM4-80GB,8,1,64,448,24,180
5ac70bff-32db-4679-b925-2c742e31a564,txchen-lm-eval2,1720686873,1720686963,finished,1720686895,1720686963,A100-SXM4-80GB,8,1,64,448,22,68
f1a29cd9-0745-4168-9f20-01b9bb32f630,marker-xiaodian,1720686989,1720687080,finished,1720687012,1720687080,A100-SXM4-80GB,8,1,64,896,23,68
064f5108-afaa-48f3-a8cd-b535335ef64a,txchen-lm-eval2,1720687030,1720687141,finished,1720687053,1720687141,A100-SXM4-80GB,8,1,64,448,23,88
a1ae56c2-85f4-4382-87fd-3dbe3e4c04ad,marker-xiaodian,1720687169,1720687259,finished,1720687190,1720687259,A100-SXM4-80GB,8,1,64,896,21,69
5e7a63dc-30c4-4260-8ec6-13cb555b75b2,txchen-lm-eval2,1720687230,1720687366,finished,1720687254,1720687366,A100-SXM4-80GB,8,1,64,448,24,112
5f090310-257f-4de1-aecb-d8a343b790cb,geogpt-dairui-eval-code-2,1720687289,1720689880,finished,1720687312,1720689880,A100-SXM4-80GB,8,1,64,448,23,2568
b7df1a6f-873c-425c-adce-4d67896d7b4c,marker-xiaodian,1720687347,1720687439,finished,1720687371,1720687439,A100-SXM4-80GB,8,1,64,896,24,68
b80f6e0b-7680-400b-a75a-f3bda585ee6c,llama-multi,1720687467,1720687644,finished,1720687488,1720687644,A100-SXM4-80GB,8,1,64,448,21,156
7c1d8e29-4fee-4304-946f-552a13719ccc,marker-xiaodian,1720687527,1720687616,finished,1720687549,1720687616,A100-SXM4-80GB,8,1,64,896,22,67
d74c297f-234c-4a0f-b7ed-3bd31993973e,marker-xiaodian,1720687706,1720687795,finished,1720687728,1720687795,A100-SXM4-80GB,8,1,64,896,22,67
15b1aca7-a3cb-4518-9c27-963301fe945b,xizeliang-llama3-8b-sft-oasst2,1720687879,1720687967,finished,1720687901,1720687967,A100-SXM4-80GB,8,1,64,896,22,66
557614f2-0192-4e0e-b1b7-ebf391f21aef,marker-xiaodian,1720687884,1720687973,finished,1720687907,1720687973,A100-SXM4-80GB,8,1,64,896,23,66
6bf8022f-15c6-49a2-a6de-136f3774985e,marker-xiaodian,1720688062,1720688154,finished,1720688087,1720688154,A100-SXM4-80GB,8,1,64,896,25,67
4b317c47-5e88-4f64-9ad8-6a64bc838a72,sparsity-9-dp-q72b-chat-24963-auto,1720688073,1720695054,finished,1720688097,1720695054,A100-SXM4-80GB,8,1,64,448,24,6957
d4ea6ed3-b7bc-4c75-89a5-4b939e0150cd,sparsity-8-dp-q72b-chat-60680-auto,1720688075,1720695054,finished,1720688097,1720695054,A100-SXM4-80GB,8,1,64,448,22,6957
9316c3e2-ba4a-42a6-8d24-ac8e9bd829bc,txchen-lm-eval2,1720688171,1720688303,finished,1720688193,1720688303,A100-SXM4-80GB,8,1,64,448,22,110
47d06ebf-8425-45fe-91f3-db6d40dfb7e2,marker-xiaodian,1720688242,1720688330,finished,1720688264,1720688330,A100-SXM4-80GB,8,1,64,896,22,66
f25dd58e-2cbd-45a0-bb05-d1a8df649b96,txchen-lm-eval2,1720688414,1720688730,finished,1720688437,1720688730,A100-SXM4-80GB,8,1,64,448,23,293
14188e4f-a84f-4ac0-b3d2-a1a3862eec6e,marker-xiaodian,1720688420,1720688510,finished,1720688443,1720688510,A100-SXM4-80GB,8,1,64,896,23,67
50f960c0-8eb4-4349-a21e-a166ef77a40b,marker-xiaodian,1720688599,1720688689,finished,1720688621,1720688689,A100-SXM4-80GB,8,1,64,896,22,68
749a0b5f-fd3d-4805-b101-6db634ce1efe,txchen-lm-eval2,1720688730,1720688917,finished,1720688753,1720688917,A100-SXM4-80GB,8,1,64,448,23,164
dca9c8a1-6fd0-4288-876f-28476b4dc57c,marker-xiaodian,1720688782,1720688873,finished,1720688805,1720688873,A100-SXM4-80GB,8,1,64,896,23,68
3ad55993-2822-4bd9-95ad-c0c4e6fb2d1e,txchen-train-task2,1720688822,1720688940,finished,1720688845,1720688940,A100-SXM4-80GB,8,1,64,448,23,95
5848f036-91aa-4271-9ae4-7ad85384517b,txchen-lm-eval2,1720688917,1720690989,finished,1720688940,1720690989,A100-SXM4-80GB,8,1,64,448,23,2049
c9d9c54d-66a8-4ffe-b455-6b35bed5063e,marker-xiaodian,1720688968,1720689060,finished,1720688991,1720689060,A100-SXM4-80GB,8,1,64,896,23,69
02acda31-d28f-4934-840c-ea20f119e4ff,llama-multi,1720689066,1720689227,finished,1720689088,1720689227,A100-SXM4-80GB,8,1,64,448,22,139
dda87efd-bece-4573-ba08-4f2f25add2a2,marker-xiaodian,1720689152,1720689244,finished,1720689175,1720689244,A100-SXM4-80GB,8,1,64,896,23,69
dfe97e53-cefa-40d1-84f4-4edb2a9964e3,marker-xiaodian,1720689337,1720689428,finished,1720689360,1720689428,A100-SXM4-80GB,8,1,64,896,23,68
c9d441e7-ef0c-4d72-ab88-5a8c33491eb6,llama-multi,1720689480,1720689665,finished,1720689503,1720689665,A100-SXM4-80GB,8,1,64,448,23,162
3c213608-95a5-44bd-9cde-5e0749659c55,marker-xiaodian,1720689521,1720689613,finished,1720689543,1720689613,A100-SXM4-80GB,8,1,64,896,22,70
affecd02-10d5-466f-9518-9a322b7edc46,marker-xiaodian,1720689706,1720689796,finished,1720689729,1720689796,A100-SXM4-80GB,8,1,64,896,23,67
ba7a0011-830a-4942-b371-419a98db3aa1,slimorca-geo-mtm1-funcfil2-14b,1720689807,1720776859,finished,1720689833,1720776859,A100-SXM4-80GB,8,1,64,448,26,87026
51a2b37e-1d9a-4b05-bcdc-adf0023f1066,geogpt-dairui-eval-code-2,1720689880,1720691531,finished,1720689948,1720691531,A100-SXM4-80GB,8,2,64,448,68,1583
24c612ba-814f-4f34-aa94-cb580db80912,marker-xiaodian,1720689894,1720689985,finished,1720689917,1720689985,A100-SXM4-80GB,8,1,64,896,23,68
6d801f9f-acba-4770-a16d-8cf6f487157b,llama-factory-zj-test,1720690014,1720690540,finished,1720690084,1720690540,A100-SXM4-80GB,8,2,64,896,70,456
34cae822-c194-44dc-a1cd-555a5cbc6930,marker-xiaodian,1720690081,1720690172,finished,1720690104,1720690172,A100-SXM4-80GB,8,1,64,896,23,68
71e1bafd-7467-4d39-81a1-b50e41c5b88d,marker-xiaodian,1720690263,1720690354,finished,1720690286,1720690354,A100-SXM4-80GB,8,1,64,896,23,68
6501cc46-0470-4674-ae1b-529e897f8c7b,marker-xiaodian,1720690445,1720690559,finished,1720690467,1720690559,A100-SXM4-80GB,8,1,64,896,22,92
c213f7dc-5c2f-498a-a2c5-bd1cc3331eaf,marker-xiaodian,1720690650,1720690741,finished,1720690672,1720690741,A100-SXM4-80GB,8,1,64,896,22,69
5ff96344-c679-435d-8112-c43a2611ffcf,marker-xiaodian,1720690831,1720690924,finished,1720690853,1720690924,A100-SXM4-80GB,8,1,64,896,22,71
681e7a9a-c87a-46f9-a0fe-de1b0ebfd61b,llama-factory-zj-test,1720690928,1720693501,finished,1720690999,1720693501,A100-SXM4-80GB,8,2,64,896,71,2502
205c535e-49e4-4c9c-9d6f-e1c062116415,txchen-lm-eval2,1720690989,1720691494,finished,1720691013,1720691494,A100-SXM4-80GB,8,1,64,448,24,481
0dfef3c7-985d-4dc5-9f71-a3ab620c3a41,marker-xiaodian,1720691019,1720691109,finished,1720691041,1720691109,A100-SXM4-80GB,8,1,64,896,22,68
1f32423a-5f54-4ef7-8849-78bd29340032,marker-xiaodian,1720691201,1720691292,finished,1720691224,1720691292,A100-SXM4-80GB,8,1,64,896,23,68
d26f2593-75af-40b6-937a-4af6b5b3ef7d,marker-xiaodian,1720691385,1720691477,finished,1720691408,1720691477,A100-SXM4-80GB,8,1,64,896,23,69
b8e82e3f-6404-43b8-af6f-72af0c9efdea,marker-xiaodian,1720691569,1720691658,finished,1720691592,1720691658,A100-SXM4-80GB,8,1,64,896,23,66
4ee1e1c9-de25-4ded-a01d-6625275b66df,marker-xiaodian,1720691749,1720691818,finished,1720691771,1720691818,A100-SXM4-80GB,8,1,64,896,22,47
56da2831-9de0-4691-9b40-905e6860e24d,geogpt-dairui-eval-code-2,1720691803,1720693040,finished,1720691827,1720693040,A100-SXM4-80GB,8,1,64,448,24,1213
d618bc5b-ebe7-49bb-81e7-77a90c66feea,marker-xiaodian,1720691906,1720691996,finished,1720691929,1720691996,A100-SXM4-80GB,8,1,64,896,23,67
2df5fa7f-1797-4851-9699-04926184c8f0,marker-xiaodian,1720692090,1720692179,finished,1720692112,1720692179,A100-SXM4-80GB,8,1,64,896,22,67
637b5f05-f4f5-4c87-92bd-087de3459a62,marker-xiaodian,1720692269,1720692357,finished,1720692291,1720692357,A100-SXM4-80GB,8,1,64,896,22,66
7a5f1f5b-02fd-4675-8dd3-c40813787d38,marker-xiaodian,1720692446,1720692535,finished,1720692468,1720692535,A100-SXM4-80GB,8,1,64,896,22,67
ff7e2c67-12cd-4e49-834a-88c6133ab2ad,marker-xiaodian,1720692627,1720692716,finished,1720692649,1720692716,A100-SXM4-80GB,8,1,64,896,22,67
c67936a8-3678-4518-a7e2-837d0c605059,marker-xiaodian,1720692806,1720692895,finished,1720692829,1720692895,A100-SXM4-80GB,8,1,64,896,23,66
46782f24-f4e6-4b82-9f0a-a7bb5019b279,marker-xiaodian,1720692984,1720693076,finished,1720693007,1720693076,A100-SXM4-80GB,8,1,64,896,23,69
0cbad25b-e4bd-4f2a-a1df-fc17f419a39b,geogpt-dairui-eval-code-2,1720693040,1720696757,finished,1720693062,1720696757,A100-SXM4-80GB,8,1,64,448,22,3695
9a9bac36-ca9a-46b2-a0ff-ce4ccaa7f3d9,marker-xiaodian,1720693164,1720693252,finished,1720693186,1720693252,A100-SXM4-80GB,8,1,64,896,22,66
ae5e9036-0ad7-46a0-86f7-98b0c55d334f,marker-xiaodian,1720693342,1720693453,finished,1720693365,1720693453,A100-SXM4-80GB,8,1,64,896,23,88
9f258dae-5253-48ad-9d41-d49c66652a91,marker-xiaodian,1720693542,1720693633,finished,1720693564,1720693633,A100-SXM4-80GB,8,1,64,896,22,69
e5dc6272-d6cb-4129-9d1f-5a9163bffe41,marker-xiaodian,1720693724,1720693835,finished,1720693746,1720693835,A100-SXM4-80GB,8,1,64,896,22,89
935f2545-06ad-4512-899b-d4f346fb680d,marker-xiaodian,1720693924,1720694014,finished,1720693947,1720694014,A100-SXM4-80GB,8,1,64,896,23,67
670577ea-40c9-4ed2-b310-1f35ec19c951,llama-factory-zj-test,1720694018,1720695047,finished,1720694063,1720695047,A100-SXM4-80GB,8,4,64,896,45,984
ab4583c6-fd57-449b-bf6a-1b0f37e93fa2,geogpt-dairui-eval-code-3,1720694070,1720694296,finished,1720694138,1720694296,A100-SXM4-80GB,8,4,64,896,68,158
0481469c-d8ac-4bdc-907c-89f8f3c2a1f0,marker-xiaodian,1720694108,1720694198,finished,1720694130,1720694198,A100-SXM4-80GB,8,1,64,896,22,68
789c02a5-5074-49aa-87ea-22dc13cf596c,marker-xiaodian,1720694287,1720694375,finished,1720694309,1720694375,A100-SXM4-80GB,8,1,64,896,22,66
ff7e0872-81a1-4edd-a1ca-5f573bfdc92e,marker-xiaodian,1720694463,1720694554,finished,1720694485,1720694554,A100-SXM4-80GB,8,1,64,896,22,69
b369c5a9-c4d2-44dd-8bf7-0e8f3368e14a,geo-seesaw-qwen05b-single-task,1720694538,1720694629,finished,1720694563,1720694629,A100-SXM4-80GB,8,1,64,896,25,66
32f71f5f-259f-4497-b67f-48fc5989ab72,marker-xiaodian,1720694644,1720694734,finished,1720694668,1720694734,A100-SXM4-80GB,8,1,64,896,24,66
ca015711-2d25-490e-b463-b0a14997fecf,geo-seesaw-qwen05b-single-task,1720694676,1720694832,finished,1720694698,1720694832,A100-SXM4-80GB,8,1,64,896,22,134
e54e3c85-f350-4b2f-9f3c-ad173803cf5d,marker-xiaodian,1720694824,1720694923,finished,1720694846,1720694923,A100-SXM4-80GB,8,1,64,896,22,77
c1d31fb4-77e7-4e16-8b3e-8ee831b9ce64,llama-factory-long-sp-pt-test,1720694879,1720747284,finished,1720746968,1720747284,A100-SXM4-80GB,8,1,64,448,52089,316
b093aa70-10d9-4b4c-a81d-acaca7a5c367,geo-base-offline-eval,1720694894,1720755204,finished,1720750215,1720755204,A100-SXM4-80GB,8,1,64,448,55321,4989
0b570170-4cb6-465d-8567-f31e68d04d43,geo-seesaw-qwen05b-single-task-02,1720694898,1720696071,finished,1720694932,1720696071,A100-SXM4-80GB,8,1,64,896,34,1139
4ef3b0dc-13be-409a-ad86-d7f9d37cda9c,mixtral-8x22b-sft,1720694902,1720709737,finished,1720707614,1720709737,A100-SXM4-80GB,8,64,64,896,12712,2123
0adb0f78-8164-4401-84c3-1544fae1909f,marker-xiaodian,1720694923,1720695020,finished,1720694946,1720695020,A100-SXM4-80GB,8,1,64,896,23,74
272a1e6a-30fb-4892-816a-81deba868d17,geogpt-moe-qwen15-alpaca-sft,1720694925,1720754689,finished,1720694971,1720754689,A100-SXM4-80GB,8,2,64,448,46,59718
8d1d7821-5a7f-4275-9e72-f40a51267430,test-xiaodianq,1720695090,1721695210,finished,1720695112,1721695210,A100-SXM4-80GB,8,1,64,896,22,1000098
a6b4ffc9-84e2-49ac-9211-7747bac94be4,sparsity-8-dp-q72b-chat-60680-auto,1720695148,1720704272,finished,1720695171,1720704272,A100-SXM4-80GB,8,1,64,448,23,9101
c250232b-2796-4cb1-87d2-2dded3a9f049,llama3-8b-cpt-32k-1-5b-lora-8a4d1-auto,1720695162,1720721970,finished,1720695189,1720721970,A100-SXM4-80GB,8,1,64,896,27,26781
32c8da00-6aad-447f-8073-92acbefcd326,llama-factory-zj-test,1720695164,1720695782,finished,1720695219,1720695782,A100-SXM4-80GB,8,4,64,896,55,563
382e604f-6921-4f61-83fc-58d9785612dd,m8x7b-10bcpt-1ep-auxloss-f1980-auto,1720695173,1720721432,finished,1720695199,1720721432,A100-SXM4-80GB,8,1,64,448,26,26233
757b9eab-773c-4c46-bb56-ab5c5fd7a144,sparsity-9-dp-q72b-chat-24963-auto,1720695175,1720700763,finished,1720695199,1720700763,A100-SXM4-80GB,8,1,64,448,24,5564
5820e81f-bd6e-44a8-9390-88abd9990613,llama3-70b-lp84-23bcpt-09ep-2a498-auto,1720695179,1720720574,finished,1720695202,1720720574,A100-SXM4-80GB,8,1,64,448,23,25372
e0347f38-778d-4e68-af79-0db7e7fe3247,llama3-8b-cpt-80k-1-5b-lora-57ce9-auto,1720695190,1720724341,finished,1720695217,1720724341,A100-SXM4-80GB,8,1,64,896,27,29124
8e4995ac-288a-43a6-a2e1-a0a744eef91d,Qwen2-72B-0711-1-f3023-auto,1720695207,1720718187,finished,1720695233,1720718187,A100-SXM4-80GB,8,1,64,448,26,22954
985f98de-ea73-46f9-991f-11e4f117deb8,Qwen2-72B-Instruct-0711-4-bs1-dad28-auto,1720695208,1720754830,finished,1720695233,1720754830,A100-SXM4-80GB,8,1,64,448,25,59597
5396db03-9538-4a6e-882c-7be826dbcb39,Qwen2-72B-0711-2-e9fb5-auto,1720695234,1720718031,finished,1720695256,1720718031,A100-SXM4-80GB,8,1,64,448,22,22775
d63dd992-e169-47c3-809e-e2df5a0e8411,sparsity-0-18-dp-q72b-chat-e8118-auto,1720695357,1720713892,finished,1720695378,1720713892,A100-SXM4-80GB,8,1,64,448,21,18514
3a8d442c-d92f-4b02-aa05-c4a55114efb3,llama-factory-zj-test,1720695783,1720696632,finished,1720695854,1720696632,A100-SXM4-80GB,8,4,64,896,71,778
113ba62b-0b8e-4851-8a93-c62c025fe5ea,train-0710,1720695925,1720696558,finished,1720695948,1720696558,A100-SXM4-80GB,8,1,64,896,23,610
aac0fcd4-692c-47ac-b104-d12415da5f61,sql-spider-qy-0703,1720695930,1720696328,finished,1720695953,1720696328,A100-SXM4-80GB,8,1,64,448,23,375
26f075ff-ebc3-4737-a777-acb90b3f71e2,geogpt-dairui-eval-code-3,1720696143,1720696828,finished,1720696213,1720696828,A100-SXM4-80GB,8,4,64,896,70,615
25b97e8c-2c76-4796-a5c0-a8c04ea61f09,sql-spider-qy-0703,1720696444,1720747797,finished,1720696468,1720747797,A100-SXM4-80GB,8,1,64,448,24,51329
dd74ecf0-ce58-4bd9-b877-08a93d17630c,xizeliang-llama3-8b-sft-oasst2,1720696527,1720696671,finished,1720696550,1720696671,A100-SXM4-80GB,8,1,64,896,23,121
0cdaa800-0103-430c-bc76-41a062b33f6c,llama-factory-zj-test,1720696632,1720697432,finished,1720696702,1720697432,A100-SXM4-80GB,8,4,64,896,70,730
cc0084b1-9222-4e18-a877-d2a136033549,geogpt-dairui-eval-code-2,1720696757,1720696896,finished,1720696780,1720696896,A100-SXM4-80GB,8,1,64,448,23,116
9239ac98-58cd-4fba-a691-f2dd3e1b03ab,train-0710,1720696960,1720746815,finished,1720696982,1720746815,A100-SXM4-80GB,8,1,64,896,22,49833
d25aeace-0dc4-4095-856f-d386842d6e72,xizeliang-llama3-8b-sft-oasst2,1720697023,1720697118,finished,1720697046,1720697118,A100-SXM4-80GB,8,1,64,896,23,72
61ff6b60-5bd1-40ca-99d7-8e98a4073d24,geogpt-dairui-eval-code-2,1720697083,1720697246,finished,1720697107,1720697246,A100-SXM4-80GB,8,1,64,448,24,139
1a0343a5-c6ff-449f-a809-70818a2c5b8f,xizeliang-llama3-8b-sft-oasst2,1720697255,1720697398,finished,1720697279,1720697398,A100-SXM4-80GB,8,1,64,896,24,119
905f9f28-5023-4efb-8e10-3929ce52c2bf,geo-05B-hit-5,1720697315,1720707407,finished,1720697340,1720707407,A100-SXM4-80GB,8,1,64,448,25,10067
ef876994-7433-4ae3-be71-4ab6c0528d10,geogpt-dairui-eval-code-2,1720697365,1720697846,finished,1720697388,1720697846,A100-SXM4-80GB,8,1,64,448,23,458
e377f7cf-4a37-46b9-8aaf-459bc9f93142,llama-factory-zj-test,1720697432,1720701949,finished,1720697501,1720701949,A100-SXM4-80GB,8,4,64,896,69,4448
51635406-c773-486a-9c15-65ec61023ae8,geo-05B-hit20,1720697645,1720707686,finished,1720697670,1720707686,A100-SXM4-80GB,8,1,64,448,25,10016
e82bb263-ce70-4612-a1f9-2073bfab4d44,geo-05B-hit10,1720697670,1720707776,finished,1720697694,1720707776,A100-SXM4-80GB,8,1,64,448,24,10082
4bda0435-6aa5-46a0-8f06-4b0cbaf1d447,geo-05B-hit-all-5,1720697721,1720697822,finished,1720697747,1720697822,A100-SXM4-80GB,8,1,64,448,26,75
ceb2178f-f087-44dc-8b2a-9f67719d8d71,geo-05B-hit-all10,1720697722,1720707731,finished,1720697747,1720707731,A100-SXM4-80GB,8,1,64,448,25,9984
b970b4d9-152b-499a-b1dc-c1a9ff06077d,geo-05B-hit-all-20,1720697749,1720707846,finished,1720697772,1720707846,A100-SXM4-80GB,8,1,64,448,23,10074
c5cf8008-c5d1-4b5b-bb66-0edead6552c2,xizeliang-llama3-8b-sft-oasst2,1720697808,1720697950,finished,1720697832,1720697950,A100-SXM4-80GB,8,1,64,896,24,118
299f3ffb-3185-4ae1-a4a0-4fc370dbb9b1,geogpt-dairui-eval-code-2,1720697846,1720697986,finished,1720697870,1720697986,A100-SXM4-80GB,8,1,64,448,24,116
5f222862-3939-4a0d-bc50-b65dce5a5ac6,geo-llamapro-1-5B,1720698080,1720698644,finished,1720698149,1720698644,A100-SXM4-80GB,8,4,64,448,69,495
6555c980-68e5-419f-a403-595e50b58474,geogpt-dairui-eval-code-2,1720698200,1720755412,finished,1720698226,1720755412,A100-SXM4-80GB,8,1,64,448,26,57186
1190487d-5be7-4efb-964e-4cd79dfa288d,geo-05B-hit-all-5,1720698201,1720708495,finished,1720698227,1720708495,A100-SXM4-80GB,8,1,64,448,26,10268
9c4e2d6d-3a49-42b6-81a6-67f7ea88c8ae,xizeliang-llama3-8b-sft-oasst2,1720698237,1720698376,finished,1720698261,1720698376,A100-SXM4-80GB,8,1,64,896,24,115
f357b09d-0836-489a-b9b3-d191c8dd0e7f,geo-llamapro-1-5B,1720698644,1720699155,finished,1720698713,1720699155,A100-SXM4-80GB,8,4,64,448,69,442
abb595fc-cc4e-41aa-9989-5b9095727a1c,geo-05B-hit-first,1720698761,1720708608,finished,1720698784,1720708608,A100-SXM4-80GB,8,1,64,448,23,9824
4f5de20c-f386-4350-a1c4-ac657fee2043,xizeliang-llama3-8b-sft-oasst2,1720698819,1720702412,finished,1720698843,1720702412,A100-SXM4-80GB,8,1,64,896,24,3569
8a00c50c-be4a-40c1-8bd6-fa4dcadd3f95,cft-mt-lr1e-5-14b,1720700508,1720700989,finished,1720700531,1720700989,A100-SXM4-80GB,8,1,64,448,23,458
1aae4172-b206-4585-b468-2591d0d43eb4,cft-mt-lr1e-5-14b,1720701308,1720755690,finished,1720701331,1720755690,A100-SXM4-80GB,8,1,64,448,23,54359
7366dee5-d081-4705-84b7-a57bc2d8b908,dpo-train,1720701543,1720701680,finished,1720701566,1720701680,A100-SXM4-80GB,4,1,32,448,23,114
662f103a-6aef-41d6-a399-7c8d7b49c159,geogpt-lxz-60wc-class-based-llama3-8b,1720701746,1720702262,finished,1720701816,1720702262,A100-SXM4-80GB,8,4,64,448,70,446
fd57215c-5579-40c3-84ad-ea994ae515cf,qwen1-14B,1720701787,1720702069,finished,1720701812,1720702069,A100-SXM4-80GB,8,1,64,896,25,257
c24a91d6-f5e7-47ac-a4c2-017d0563d1f6,llama-factory-zj-test,1720701949,1720702756,finished,1720702020,1720702756,A100-SXM4-80GB,8,4,64,896,71,736
8651ee0b-1e98-4254-aea3-e07596fabc32,debug,1720702046,1720702327,finished,1720702069,1720702327,A100-SXM4-80GB,8,1,64,448,23,258
dd58da3a-d4df-4d5b-8721-5dfad04aa472,qwen1-14B,1720702141,1720702423,finished,1720702164,1720702423,A100-SXM4-80GB,8,1,64,896,23,259
e27ca450-0c66-4880-a5ad-bbb202d5dbcb,dpo-train,1720702242,1720702504,finished,1720702265,1720702504,A100-SXM4-80GB,4,1,32,448,23,239
80dce6c9-9964-4f42-b2dc-f0a9d744805b,xizeliang-llama3-8b-sft-oasst2,1720702412,1720713877,finished,1720702436,1720713877,A100-SXM4-80GB,8,1,64,896,24,11441
03935852-e32b-47e8-aa37-ff302a082648,geo-base-moe-growing,1720702426,1721648381,finished,1720702473,1721648381,A100-SXM4-80GB,8,2,64,448,47,945908
9a6729f9-8e44-4639-982c-13a3c77ab69c,qwen1-14B,1720702495,1720702592,finished,1720702519,1720702592,A100-SXM4-80GB,8,1,64,896,24,73
ad6bc245-e18c-45fd-a0f8-73d6cd7ab333,debug,1720702544,1720702637,finished,1720702568,1720702637,A100-SXM4-80GB,8,1,64,448,24,69
09aeefca-29b4-423f-9b84-06b41d81591e,qwen1-14B,1720702662,1720702758,finished,1720702685,1720702758,A100-SXM4-80GB,8,1,64,896,23,73
8b526889-8744-41b8-8100-ed42191c9e46,debug,1720702735,1720704707,finished,1720702758,1720704707,A100-SXM4-80GB,8,1,64,448,23,1949
8a9812ed-c8ff-4f3c-8ab3-7814c3b0a4d7,llama-factory-zj-test,1720702756,1720703905,finished,1720702804,1720703905,A100-SXM4-80GB,8,4,64,896,48,1101
261c40a8-d800-4fe1-911e-d7192c2acad3,qwen1-14B,1720702832,1720702924,finished,1720702855,1720702924,A100-SXM4-80GB,8,1,64,896,23,69
c9f3c230-1a63-46ba-9f70-b5ac2d339508,qwen1-14B,1720702993,1720703086,finished,1720703017,1720703086,A100-SXM4-80GB,8,1,64,896,24,69
d455cd24-ce62-4004-bae7-c3d827e536a4,train-mg-4diff-1,1720703018,1720755434,finished,1720750249,1720755434,A100-SXM4-80GB,8,1,64,448,47231,5185
e6661da8-c431-4b87-95b0-1580430f2bb0,train-mg-4same-1,1720703109,1720755434,finished,1720750249,1720755434,A100-SXM4-80GB,8,1,64,896,47140,5185
5ef95591-9024-4bf5-ad3d-fbb0bd062472,qwen1-14B,1720703181,1720703273,finished,1720703205,1720703273,A100-SXM4-80GB,8,1,64,896,24,68
379cda52-cc9e-4e75-b0f7-44532c35dcd1,qwen1-14B,1720703344,1720703438,finished,1720703367,1720703438,A100-SXM4-80GB,8,1,64,896,23,71
06b1d4a4-ccd4-4490-959e-8ed68127eb34,qwen1-14B,1720703509,1720703601,finished,1720703532,1720703601,A100-SXM4-80GB,8,1,64,896,23,69
f6c5bdc0-4e87-4d97-a41b-5ef9680719a5,mixtral-v1-0-0711-dpo,1720703680,1720704346,finished,1720703916,1720704346,A100-SXM4-80GB,8,16,64,448,236,430
5d3b8c85-7304-415d-90a6-3a1fd06f484f,qwen1-14B,1720703695,1720703788,finished,1720703719,1720703788,A100-SXM4-80GB,8,1,64,896,24,69
aa4f0394-3f4d-4b0b-9401-d473a31ae58c,qwen1-14B,1720703860,1720703958,finished,1720703883,1720703958,A100-SXM4-80GB,8,1,64,896,23,75
67b276d6-1df5-4eed-a2b5-65fad994ea20,llama-factory-zj-test,1720703905,1720704844,finished,1720703981,1720704844,A100-SXM4-80GB,8,4,64,896,76,863
d1bc8e87-7ceb-4011-ae44-afc37a96d566,qwen1-14B,1720704031,1720704430,finished,1720704359,1720704430,A100-SXM4-80GB,8,1,64,896,328,71
c3d8d23a-6c4a-4009-8100-4fe1ca8446a3,qwen1-14B,1720704522,1720704614,finished,1720704545,1720704614,A100-SXM4-80GB,8,1,64,896,23,69
94375d88-71d4-4597-ae9f-f9007353b0f8,qwen1-14B,1720704684,1720704775,finished,1720704707,1720704775,A100-SXM4-80GB,8,1,64,896,23,68
7f47d465-952b-4598-b62f-0030d0c53b7c,llama-factory-zj-test,1720704844,1720707771,finished,1720704913,1720707771,A100-SXM4-80GB,8,4,64,896,69,2858
003505a6-fa0a-4968-b3d0-019f78b24aa6,qwen1-14B,1720704845,1720704938,finished,1720704869,1720704938,A100-SXM4-80GB,8,1,64,896,24,69
1fa05a17-fc63-4998-8891-689281a6955f,qwen1-14B,1720705007,1720705100,finished,1720705031,1720705100,A100-SXM4-80GB,8,1,64,896,24,69
b01bbb27-6cae-4cd5-9b7b-ad4a2d5d327f,qwen1-14B,1720705170,1720705264,finished,1720705193,1720705264,A100-SXM4-80GB,8,1,64,896,23,71
3f622388-731a-495b-9bf7-6fd2b7df0c82,geogpt-prompt-tuning-tg-train-all,1720705207,1720847343,finished,1720705229,1720847343,A100-SXM4-80GB,8,1,64,448,22,142114
eabf870f-2b87-49f7-8296-94ee04f888b7,qwen1-14B,1720705356,1720705447,finished,1720705380,1720705447,A100-SXM4-80GB,8,1,64,896,24,67
d69c3f8b-c969-4892-874d-16aec0effcd3,qwen1-14B,1720705539,1720705630,finished,1720705562,1720705630,A100-SXM4-80GB,8,1,64,896,23,68
22f73295-4cf1-4269-ba34-9fb6a80c0534,qwen1-14B,1720705725,1720705817,finished,1720705749,1720705817,A100-SXM4-80GB,8,1,64,896,24,68
ee0d6e5e-0402-44da-8091-c6628be6adc1,qwen1-14B,1720705886,1720705977,finished,1720705910,1720705977,A100-SXM4-80GB,8,1,64,896,24,67
5c42b214-1e7a-436a-bc5f-bd525eae6ddf,qwen1-14B,1720706046,1720706140,finished,1720706069,1720706140,A100-SXM4-80GB,8,1,64,896,23,71
aa183115-7676-42e7-b430-7f1b93425aeb,geogpt-llama3-70b-lp84-22bcpt,1720706148,1720750296,finished,1720709741,1720750296,A100-SXM4-80GB,8,64,64,448,3593,40555
a04b8337-6225-414b-8a44-960f91cb76b6,qwen1-14B,1720706233,1720706326,finished,1720706256,1720706326,A100-SXM4-80GB,8,1,64,896,23,70
0cca6d05-4fe4-406e-a40e-311d41724036,qwen1-14B,1720706394,1720706486,finished,1720706418,1720706486,A100-SXM4-80GB,8,1,64,896,24,68
08c38d76-39e4-4c2d-ac43-2307f589028d,qwen1-14B,1720706557,1720706649,finished,1720706581,1720706649,A100-SXM4-80GB,8,1,64,896,24,68
a195f0fb-ec05-4fa2-9dd3-810607dc1f1c,qwen1-14B,1720706742,1720706831,finished,1720706765,1720706831,A100-SXM4-80GB,8,1,64,896,23,66
a7d19ba6-5976-41ba-96b1-b143777a0798,qwen1-14B,1720706900,1720706992,finished,1720706923,1720706992,A100-SXM4-80GB,8,1,64,896,23,69
c3028d8b-ebaa-47db-8047-3665bb96807c,qwen1-14B,1720707062,1720707153,finished,1720707085,1720707153,A100-SXM4-80GB,8,1,64,896,23,68
53d0be03-15d9-4c2a-aa1d-2f14622f58ec,qwen1-14B,1720707221,1720707312,finished,1720707245,1720707312,A100-SXM4-80GB,8,1,64,896,24,67
7b57c74a-8557-494c-95e5-fc5928789d42,qwen1-14B,1720707380,1720707471,finished,1720707403,1720707471,A100-SXM4-80GB,8,1,64,896,23,68
142c1798-1c5c-4f03-92d9-0e29dc1aabb2,qwen1-14B,1720707541,1720707750,finished,1720707565,1720707750,A100-SXM4-80GB,8,1,64,896,24,185
e976dcfa-5e7e-441b-b89c-b632a5a9be93,qwen1-14B,1720707843,1720707937,finished,1720707867,1720707937,A100-SXM4-80GB,8,1,64,896,24,70
8e66ba28-bd0c-48ca-8d86-e2c5f280d9a8,llama3-70b-lp840-23bcpt-sft-ef7a4-auto,1720707922,1720726397,finished,1720707945,1720726397,A100-SXM4-80GB,8,1,64,448,23,18452
6589924e-81bf-4943-b5c9-fece31278f04,llama3-70b-lp84-23bcpt-sft-b3699-auto,1720707968,1720708107,finished,1720707993,1720708107,A100-SXM4-80GB,8,1,64,448,25,114
aa3a3f52-126e-48fd-9da6-825ee9a65137,qwen1-14B,1720708007,1720708098,finished,1720708031,1720708098,A100-SXM4-80GB,8,1,64,896,24,67
0b8a31d5-89fb-4210-9521-8cca0c1cbe62,qwen1-14B,1720708167,1720708260,finished,1720708191,1720708260,A100-SXM4-80GB,8,1,64,896,24,69
96a89585-01f2-4d7c-8c1b-7bb5687ca9ec,llama3-70b-lp84-23bcpt-sft-b3699-auto,1720708177,1720711860,finished,1720708200,1720711860,A100-SXM4-80GB,8,1,64,448,23,3660
f907cf6c-a313-49dc-9c61-8618b693db1d,llama3-70b-lp84-sft,1720708292,1720881833,finished,1720708316,1720881833,A100-SXM4-80GB,8,1,64,448,24,173517
0e5e7d76-d256-4b0a-91cf-19d2d3eea5bc,qwen1-14B,1720708330,1720708421,finished,1720708353,1720708421,A100-SXM4-80GB,8,1,64,896,23,68
5923fd72-5124-439a-b845-1c72799c061f,qwen1-14B,1720708491,1720708583,finished,1720708515,1720708583,A100-SXM4-80GB,8,1,64,896,24,68
15243846-f639-49e8-b228-0b2422a46c19,qwen1-14B,1720708652,1720708744,finished,1720708675,1720708744,A100-SXM4-80GB,8,1,64,896,23,69
b44fb88f-4a61-44f3-9a94-5a0613e99d01,qwen1-14B,1720708812,1720708904,finished,1720708836,1720708904,A100-SXM4-80GB,8,1,64,896,24,68
44c107ea-0bb2-4fee-bfb9-6c270da80430,qwen1-14B,1720708974,1720709088,finished,1720708996,1720709088,A100-SXM4-80GB,8,1,64,896,22,92
1fc4381b-ab56-4095-9dc5-4e07902f4eee,qwen1-14B,1720709156,1720709248,finished,1720709180,1720709248,A100-SXM4-80GB,8,1,64,896,24,68
a5c9dd61-9bee-42bd-8c2c-4486a8271186,qwen1-14B,1720709317,1720709409,finished,1720709341,1720709409,A100-SXM4-80GB,8,1,64,896,24,68
deff3590-a22c-43f7-a2a5-aa1c0db8f947,qwen1-14B,1720709479,1720709571,finished,1720709502,1720709571,A100-SXM4-80GB,8,1,64,896,23,69
449bddb0-3f46-4629-acfd-0abe712c20d7,qwen1-14B,1720709641,1720709732,finished,1720709665,1720709732,A100-SXM4-80GB,8,1,64,896,24,67
821ff809-c37d-4b4f-91f4-45978ec64db3,qwen1-14B,1720709844,1720710007,finished,1720709868,1720710007,A100-SXM4-80GB,8,1,64,896,24,139
99f3a579-1d14-40ac-97fb-272821927a56,mixtral-8x22b-sft,1720709849,1720723617,finished,1720721499,1720723617,A100-SXM4-80GB,8,64,64,896,11650,2118
4d8a221b-6b4a-401e-b79b-012085a344c9,qwen1-14B,1720710100,1720710193,finished,1720710124,1720710193,A100-SXM4-80GB,8,1,64,896,24,69
f1596238-8774-4b32-a4ac-668bbce9f01e,qwen1-14B,1720710262,1720710353,finished,1720710286,1720710353,A100-SXM4-80GB,8,1,64,896,24,67
12ee1c8f-1d20-4359-8631-12ad4f00e2f9,qwen1-14B,1720710424,1720710515,finished,1720710448,1720710515,A100-SXM4-80GB,8,1,64,896,24,67
a5f3f893-ab7f-4404-a7d8-fadb6ffe32ed,qwen1-14B,1720710608,1720710700,finished,1720710631,1720710700,A100-SXM4-80GB,8,1,64,896,23,69
8eb561f4-ab7a-4080-a454-24e54cd96615,qwen1-14B,1720710791,1720710883,finished,1720710814,1720710883,A100-SXM4-80GB,8,1,64,896,23,69
951df514-44cc-402d-a1d5-22543ad0a4dd,qwen1-14B,1720710953,1720711045,finished,1720710975,1720711045,A100-SXM4-80GB,8,1,64,896,22,70
afa0c68b-a692-402d-a8c2-19bf413dd91f,qwen1-14B,1720711117,1720711210,finished,1720711140,1720711210,A100-SXM4-80GB,8,1,64,896,23,70
cef135c6-90ae-40d0-8ff5-8c5d594740d4,qwen1-14B,1720711301,1720711392,finished,1720711323,1720711392,A100-SXM4-80GB,8,1,64,896,22,69
f6b2641e-5347-4461-920e-524fe71ea488,qwen1-14B,1720711461,1720711552,finished,1720711484,1720711552,A100-SXM4-80GB,8,1,64,896,23,68
68144506-865c-47ad-84da-a27bb5de8dbd,qwen1-14B,1720711644,1720711735,finished,1720711667,1720711735,A100-SXM4-80GB,8,1,64,896,23,68
5c01f5fa-5306-4309-bd39-ebc992369b63,qwen1-14B,1720711805,1720711898,finished,1720711829,1720711898,A100-SXM4-80GB,8,1,64,896,24,69
2d6fa914-01f9-47c3-b878-9c31725a1e89,qwen1-14B,1720711968,1720712061,finished,1720711991,1720712061,A100-SXM4-80GB,8,1,64,896,23,70
fbc7a795-df96-4a07-aa1d-9a86e5523a5e,qwen1-14B,1720712130,1720712223,finished,1720712154,1720712223,A100-SXM4-80GB,8,1,64,896,24,69
8ff75739-4ce1-438d-9b08-c27975146b55,qwen1-14B,1720712315,1720712407,finished,1720712338,1720712407,A100-SXM4-80GB,8,1,64,896,23,69
52a92d2b-9e02-4b25-8440-e5f633c35d9e,qwen1-14B,1720712477,1720712568,finished,1720712500,1720712568,A100-SXM4-80GB,8,1,64,896,23,68
045f6d26-ec29-4cc5-8d85-2a037db98a85,qwen1-14B,1720712660,1720712752,finished,1720712683,1720712752,A100-SXM4-80GB,8,1,64,896,23,69
c5bd39fc-5874-4542-8c09-04074a7fdba4,qwen1-14B,1720712845,1720712937,finished,1720712868,1720712937,A100-SXM4-80GB,8,1,64,896,23,69
5c350e45-a9af-4ba9-8b7e-abc84ef3c23b,qwen1-14B,1720713007,1720713099,finished,1720713029,1720713099,A100-SXM4-80GB,8,1,64,896,22,70
16db26b9-fe33-4120-a163-4b64dba6958d,qwen1-14B,1720713192,1720713285,finished,1720713215,1720713285,A100-SXM4-80GB,8,1,64,896,23,70
5c0cb268-24a5-4c2f-805f-a103f7e4b4bf,qwen1-14B,1720713355,1720713447,finished,1720713378,1720713447,A100-SXM4-80GB,8,1,64,896,23,69
6100bd27-733d-4ae3-9e41-64b86518a765,qwen1-14B,1720713517,1720713608,finished,1720713540,1720713608,A100-SXM4-80GB,8,1,64,896,23,68
70608595-cc23-49b6-ba5e-a15ffe34fb44,qwen1-14B,1720713680,1720713773,finished,1720713705,1720713773,A100-SXM4-80GB,8,1,64,896,25,68
db60ca74-7389-49b7-9dd1-2651a6562113,qwen1-14B,1720713841,1720713933,finished,1720713865,1720713933,A100-SXM4-80GB,8,1,64,896,24,68
a2a87c87-4a8c-4bbe-9f29-c265d19acad3,qwen1-14B,1720714001,1720714093,finished,1720714024,1720714093,A100-SXM4-80GB,8,1,64,896,23,69
12400e73-935a-4527-b608-25c5f6325494,qwen1-14B,1720714162,1720714253,finished,1720714185,1720714253,A100-SXM4-80GB,8,1,64,896,23,68
a6140d1c-9dd8-4442-8dee-261a163ea283,qwen1-14B,1720714322,1720714435,finished,1720714345,1720714435,A100-SXM4-80GB,8,1,64,896,23,90
f17d264b-1caa-4642-bd41-7455b84466f2,qwen1-14B,1720714504,1720714595,finished,1720714528,1720714595,A100-SXM4-80GB,8,1,64,896,24,67
2cd256b6-6ba9-4688-9b3a-b7bf917d8171,qwen1-14B,1720714685,1720714777,finished,1720714709,1720714777,A100-SXM4-80GB,8,1,64,896,24,68
456ef48a-001e-4531-a15b-b06cc6092c90,qwen1-14B,1720714868,1720714959,finished,1720714891,1720714959,A100-SXM4-80GB,8,1,64,896,23,68
a4eff0d7-fcf3-485d-8f4f-d36488c048a0,qwen1-14B,1720715028,1720715118,finished,1720715051,1720715118,A100-SXM4-80GB,8,1,64,896,23,67
8b661de4-d061-45f9-ae5a-015653ea7fb7,qwen1-14B,1720715209,1720715299,finished,1720715231,1720715299,A100-SXM4-80GB,8,1,64,896,22,68
ba85821b-ae4e-4048-aee0-c8eb7592f121,qwen1-14B,1720715368,1720715459,finished,1720715391,1720715459,A100-SXM4-80GB,8,1,64,896,23,68
26cd5066-a68b-4648-a15b-35c5039c264f,qwen1-14B,1720715527,1720715617,finished,1720715549,1720715617,A100-SXM4-80GB,8,1,64,896,22,68
8a77a714-d663-4053-87bf-8407bd404a95,qwen1-14B,1720715686,1720715777,finished,1720715709,1720715777,A100-SXM4-80GB,8,1,64,896,23,68
0844212d-2ca6-4b7e-93e4-54fd55536d2f,qwen1-14B,1720715845,1720715958,finished,1720715868,1720715958,A100-SXM4-80GB,8,1,64,896,23,90
c2758730-4b64-469d-8b92-1b84b0c55ff1,qwen1-14B,1720716027,1720716119,finished,1720716050,1720716119,A100-SXM4-80GB,8,1,64,896,23,69
55a32f7e-f3e5-40cc-b384-72f5a4b39e77,qwen1-14B,1720716187,1720716277,finished,1720716209,1720716277,A100-SXM4-80GB,8,1,64,896,22,68
51f04759-ce6f-4c06-b740-6dfaed18fc44,qwen1-14B,1720716369,1720716459,finished,1720716392,1720716459,A100-SXM4-80GB,8,1,64,896,23,67
5bd62be2-350c-408a-aeb5-5285b15948d2,qwen1-14B,1720716550,1720716641,finished,1720716573,1720716641,A100-SXM4-80GB,8,1,64,896,23,68
c7d98657-4aec-470d-bfe7-e76eccc2e027,qwen1-14B,1720716709,1720716799,finished,1720716733,1720716799,A100-SXM4-80GB,8,1,64,896,24,66
c4ab8069-d5b4-4a26-893a-f235780b9c11,qwen1-14B,1720716890,1720716980,finished,1720716913,1720716980,A100-SXM4-80GB,8,1,64,896,23,67
e7813286-976b-4bff-92ad-859629bc0e71,qwen1-14B,1720717049,1720717140,finished,1720717072,1720717140,A100-SXM4-80GB,8,1,64,896,23,68
c2510b04-f118-408b-9f16-b87e6dcc19e4,qwen1-14B,1720717208,1720717298,finished,1720717230,1720717298,A100-SXM4-80GB,8,1,64,896,22,68
8623c269-0b0f-4204-bb89-35d8fd870ca0,qwen1-14B,1720717389,1720717500,finished,1720717411,1720717500,A100-SXM4-80GB,8,1,64,896,22,89
3fb8fcf8-49b3-497c-80d0-b4ec480a4fbe,qwen1-14B,1720717570,1720717660,finished,1720717592,1720717660,A100-SXM4-80GB,8,1,64,896,22,68
da9dea4e-c0f1-4234-9d13-bf26c90ff392,qwen1-14B,1720717729,1720717817,finished,1720717751,1720717817,A100-SXM4-80GB,8,1,64,896,22,66
f8a9ce90-8b15-424d-b0ea-88abf15e81b3,qwen1-14B,1720717883,1720717974,finished,1720717906,1720717974,A100-SXM4-80GB,8,1,64,896,23,68
4de7e69f-8e22-42d1-a55d-bc9bea1084fd,qwen1-14B,1720718042,1720718154,finished,1720718064,1720718154,A100-SXM4-80GB,8,1,64,896,22,90
f07f8662-5ff7-416f-b780-7925cdd89cfb,qwen1-14B,1720718244,1720718333,finished,1720718267,1720718333,A100-SXM4-80GB,8,1,64,896,23,66
2f7cc282-8fef-4349-98fb-1fa790c9b1c1,qwen1-14B,1720718400,1720718487,finished,1720718422,1720718487,A100-SXM4-80GB,8,1,64,896,22,65
044e9c08-f47f-48e4-8ffe-e14233a57395,qwen1-14B,1720718554,1720718643,finished,1720718577,1720718643,A100-SXM4-80GB,8,1,64,896,23,66
5b5cea04-7ce0-4775-a08d-952137c32a66,qwen1-14B,1720718709,1720718818,finished,1720718731,1720718818,A100-SXM4-80GB,8,1,64,896,22,87
95b948e8-5f8b-40da-a65c-4d79575124c9,qwen1-14B,1720718906,1720718993,finished,1720718929,1720718993,A100-SXM4-80GB,8,1,64,896,23,64
b06ba629-90d4-4642-9082-d2cd7b2f0888,qwen1-14B,1720719060,1720719149,finished,1720719083,1720719149,A100-SXM4-80GB,8,1,64,896,23,66
cfeb1bed-d08e-4930-bc6f-0f8868f47400,qwen1-14B,1720719236,1720719328,finished,1720719260,1720719328,A100-SXM4-80GB,8,1,64,896,24,68
84e03116-474c-4a88-9211-9fffc0b2128a,llama3-8b-cpt-80k-3b-1d5b4-auto,1720719324,1720749994,finished,1720719348,1720749994,A100-SXM4-80GB,8,1,64,896,24,30646
bdf1de5d-9909-40ca-9dde-e429e18b6dd0,qwen1-14B,1720719397,1720719484,finished,1720719419,1720719484,A100-SXM4-80GB,8,1,64,896,22,65
ed481f0f-8ced-4790-824c-d967ec580d23,qwen1-14B,1720719550,1720719638,finished,1720719572,1720719638,A100-SXM4-80GB,8,1,64,896,22,66
b34f3e5f-3e63-4260-acd0-69d8da501b66,qwen1-14B,1720719704,1720719791,finished,1720719727,1720719791,A100-SXM4-80GB,8,1,64,896,23,64
b90c3dc9-d430-46a4-baef-3f08e995b52d,qwen1-14B,1720719859,1720719947,finished,1720719881,1720719947,A100-SXM4-80GB,8,1,64,896,22,66
de5dccd5-8a1a-4d40-838b-1259a384473b,qwen1-14B,1720720036,1720720122,finished,1720720057,1720720122,A100-SXM4-80GB,8,1,64,896,21,65
d3934649-fdb6-4c85-b629-d4e52f2e0d40,qwen1-14B,1720720189,1720720277,finished,1720720212,1720720277,A100-SXM4-80GB,8,1,64,896,23,65
778304ee-1478-4bf4-a00d-cf00ea65182f,qwen1-14B,1720720343,1720720432,finished,1720720365,1720720432,A100-SXM4-80GB,8,1,64,896,22,67
26a33ccd-f2eb-4e84-800b-21dc16d71605,qwen1-14B,1720720500,1720720588,finished,1720720522,1720720588,A100-SXM4-80GB,8,1,64,896,22,66
c7d967af-d576-4111-b940-85fa2d829098,qwen1-14B,1720720655,1720720744,finished,1720720678,1720720744,A100-SXM4-80GB,8,1,64,896,23,66
07694284-3834-43ab-a183-1af82cf40ede,qwen1-14B,1720720810,1720720899,finished,1720720834,1720720899,A100-SXM4-80GB,8,1,64,896,24,65
7563fa27-8648-45af-90fa-ae9e90eda2de,qwen1-14B,1720720965,1720721053,finished,1720720988,1720721053,A100-SXM4-80GB,8,1,64,896,23,65
887264ac-392f-413c-ab36-ac8a3623805c,qwen1-14B,1720721141,1720721227,finished,1720721163,1720721227,A100-SXM4-80GB,8,1,64,896,22,64
0c1597cc-edaa-424b-a5ee-dc322bb834bb,qwen1-14B,1720721294,1720721382,finished,1720721315,1720721382,A100-SXM4-80GB,8,1,64,896,21,67
956c582e-c245-4388-8e5c-71e4144b89db,qwen1-14B,1720721472,1720721564,finished,1720721493,1720721564,A100-SXM4-80GB,8,1,64,896,21,71
b4b2a94d-49e6-43c1-ad3a-6a4c81e48b79,qwen1-14B,1720721630,1720722229,finished,1720721994,1720722229,A100-SXM4-80GB,8,1,64,896,364,235
a275b646-ba66-4012-a2bb-6022fb00f789,qwen1-14B,1720722293,1720722380,finished,1720722316,1720722380,A100-SXM4-80GB,8,1,64,896,23,64
cf44f56d-c299-471d-9889-498cd4669412,qwen1-14B,1720722465,1720722551,finished,1720722487,1720722551,A100-SXM4-80GB,8,1,64,896,22,64
e64dffbf-fc7c-40ce-8466-b3fadd1d927f,qwen1-14B,1720722615,1720722702,finished,1720722638,1720722702,A100-SXM4-80GB,8,1,64,896,23,64
62dfac44-602c-4fe7-aa9d-0be6e48da6f1,qwen1-14B,1720722768,1720722852,finished,1720722789,1720722852,A100-SXM4-80GB,8,1,64,896,21,63
6fe8df2b-a3a3-446e-b1ff-9b7cc6b5d2ba,qwen1-14B,1720722917,1720723026,finished,1720722940,1720723026,A100-SXM4-80GB,8,1,64,896,23,86
a7110062-e047-4104-86d3-6b72e016f788,qwen1-14B,1720723112,1720723198,finished,1720723134,1720723198,A100-SXM4-80GB,8,1,64,896,22,64
382dde34-da34-4cfe-8239-d81a1414dbf2,qwen1-14B,1720723263,1720723371,finished,1720723285,1720723371,A100-SXM4-80GB,8,1,64,896,22,86
14a0a5e5-5f24-412d-bc96-2d73b9bcb23f,qwen1-14B,1720723457,1720723545,finished,1720723479,1720723545,A100-SXM4-80GB,8,1,64,896,22,66
5510302a-1ecc-468b-a042-ee97ac50b5bf,qwen1-14B,1720723633,1720723736,finished,1720723655,1720723736,A100-SXM4-80GB,8,1,64,896,22,81
08b9085a-3704-4185-8c52-35c595c1bd70,mixtral-8x22b-sft,1720723697,1720725883,finished,1720723761,1720725883,A100-SXM4-80GB,8,64,64,896,64,2122
1b47a71e-a992-4b3a-973b-85675fa07c34,qwen1-14B,1720723829,1720724105,finished,1720723850,1720724105,A100-SXM4-80GB,8,1,64,896,21,255
daf8c879-9eb3-43fa-a318-0e026f4d536a,qwen1-14B,1720724171,1720724257,finished,1720724193,1720724257,A100-SXM4-80GB,8,1,64,896,22,64
4462591c-07ac-4a9a-a251-6363db1c497e,qwen1-14B,1720724344,1720724431,finished,1720724366,1720724431,A100-SXM4-80GB,8,1,64,896,22,65
e99b4b35-393c-4497-b17f-3e71160d94b3,qwen1-14B,1720724495,1720724582,finished,1720724517,1720724582,A100-SXM4-80GB,8,1,64,896,22,65
eb473f71-f74d-40ce-b203-11d639bf594f,qwen1-14B,1720724649,1720724734,finished,1720724670,1720724734,A100-SXM4-80GB,8,1,64,896,21,64
f0b87f91-933d-4204-b180-92ea86547094,qwen1-14B,1720724800,1720724886,finished,1720724822,1720724886,A100-SXM4-80GB,8,1,64,896,22,64
a62c0a2b-385b-4e19-ab12-9d8d08503811,qwen1-14B,1720724974,1720725060,finished,1720724996,1720725060,A100-SXM4-80GB,8,1,64,896,22,64
c41a68de-1379-4162-830e-d36eab780c21,qwen1-14B,1720725126,1720725211,finished,1720725148,1720725211,A100-SXM4-80GB,8,1,64,896,22,63
534ba56d-aaa9-475e-920c-7e4966b77e31,qwen1-14B,1720725297,1720725382,finished,1720725318,1720725382,A100-SXM4-80GB,8,1,64,896,21,64
46a69a5f-6ecf-425b-b07e-73f9893886df,qwen1-14B,1720725449,1720725533,finished,1720725470,1720725533,A100-SXM4-80GB,8,1,64,896,21,63
c97374a0-11bd-44a2-9c33-c4e6745b1e36,qwen1-14B,1720725597,1720725682,finished,1720725618,1720725682,A100-SXM4-80GB,8,1,64,896,21,64
b408a8c8-38cb-4f3d-a3a8-9feaf6999189,qwen1-14B,1720725748,1720725834,finished,1720725770,1720725834,A100-SXM4-80GB,8,1,64,896,22,64
51e55197-2706-41ae-8c6e-f0106715a437,qwen1-14B,1720725899,1720726001,finished,1720725921,1720726001,A100-SXM4-80GB,8,1,64,896,22,80
3abe88ce-5fe1-40f3-9707-5fd9bd67407a,mixtral-8x22b-sft,1720725962,1720728138,finished,1720726026,1720728138,A100-SXM4-80GB,8,64,64,896,64,2112
4ff51af6-8cfa-4fe3-a91e-529451e6dacf,qwen1-14B,1720726093,1720726368,finished,1720726115,1720726368,A100-SXM4-80GB,8,1,64,896,22,253
547fac7d-6de9-4c4c-b3a2-cf326cf056f7,qwen1-14B,1720726454,1720726541,finished,1720726477,1720726541,A100-SXM4-80GB,8,1,64,896,23,64
5bbfbe55-4cc2-44e6-8ad8-430e1922b970,qwen1-14B,1720726605,1720726691,finished,1720726628,1720726691,A100-SXM4-80GB,8,1,64,896,23,63
9fcab7d1-dbd2-4789-b691-48c645094c24,qwen1-14B,1720726756,1720726842,finished,1720726778,1720726842,A100-SXM4-80GB,8,1,64,896,22,64
9b065233-f1e6-4acf-a856-0eef0be15e9d,qwen1-14B,1720726907,1720726991,finished,1720726929,1720726991,A100-SXM4-80GB,8,1,64,896,22,62
29d49e37-c216-4cbf-a329-83c94ca88a89,qwen1-14B,1720727055,1720727140,finished,1720727077,1720727140,A100-SXM4-80GB,8,1,64,896,22,63
f2b2c1e1-e83a-4e64-a918-9f8b123fc590,qwen1-14B,1720727207,1720727314,finished,1720727229,1720727314,A100-SXM4-80GB,8,1,64,896,22,85
2ddce792-89b1-4aa7-aceb-d81379eb85e0,qwen1-14B,1720727379,1720727463,finished,1720727401,1720727463,A100-SXM4-80GB,8,1,64,896,22,62
48fce437-cc37-46b4-857c-a2d58bf491e9,qwen1-14B,1720727528,1720727614,finished,1720727550,1720727614,A100-SXM4-80GB,8,1,64,896,22,64
2ad713d6-6fce-4688-a33c-ede2d0892ae3,qwen1-14B,1720727700,1720727787,finished,1720727722,1720727787,A100-SXM4-80GB,8,1,64,896,22,65
a6f4880c-44ca-4ebf-946f-901169ae79f3,qwen1-14B,1720727874,1720727962,finished,1720727897,1720727962,A100-SXM4-80GB,8,1,64,896,23,65
9e5554ec-e75f-444f-819b-ba0369b65b02,qwen1-14B,1720728027,1720728112,finished,1720728049,1720728112,A100-SXM4-80GB,8,1,64,896,22,63
8e5b170c-a431-4917-b9b7-3cfb57a59f92,qwen1-14B,1720728177,1720728278,finished,1720728214,1720728278,A100-SXM4-80GB,8,1,64,896,37,64
a514f5a1-7de8-4fc3-ac9b-418019d6abcf,mixtral-8x22b-sft,1720728218,1720730412,finished,1720728283,1720730412,A100-SXM4-80GB,8,64,64,896,65,2129
aff50b5c-756f-4ba8-923a-c19a444c5663,qwen1-14B,1720728391,1720728476,finished,1720728413,1720728476,A100-SXM4-80GB,8,1,64,896,22,63
23a3ba7e-f7db-4b86-9546-681b6e751923,qwen1-14B,1720728542,1720728627,finished,1720728564,1720728627,A100-SXM4-80GB,8,1,64,896,22,63
ab819ebe-7840-4283-a7f6-c18621f3c9fc,qwen1-14B,1720728692,1720728779,finished,1720728714,1720728779,A100-SXM4-80GB,8,1,64,896,22,65
725a19c9-73c0-4fdf-92b2-8157dfb82b72,qwen1-14B,1720728843,1720728928,finished,1720728865,1720728928,A100-SXM4-80GB,8,1,64,896,22,63
692299d3-b1be-4b45-85a0-44598d3d9c72,qwen1-14B,1720728993,1720729078,finished,1720729015,1720729078,A100-SXM4-80GB,8,1,64,896,22,63
05bfa030-563c-43aa-aa98-caf4dc7ce9ac,qwen1-14B,1720729144,1720729230,finished,1720729165,1720729230,A100-SXM4-80GB,8,1,64,896,21,65
6704f74f-5180-441a-948a-f79be3eb515d,qwen1-14B,1720729296,1720729381,finished,1720729317,1720729381,A100-SXM4-80GB,8,1,64,896,21,64
40a206f4-30cf-4cd5-b884-64a229b47e5b,qwen1-14B,1720729467,1720729552,finished,1720729489,1720729552,A100-SXM4-80GB,8,1,64,896,22,63
0e943dad-5b36-45d5-9338-4c223bd07e08,qwen1-14B,1720729637,1720729742,finished,1720729659,1720729742,A100-SXM4-80GB,8,1,64,896,22,83
7a2a18bb-cd77-4264-8941-ce840011efb4,qwen1-14B,1720729806,1720729891,finished,1720729827,1720729891,A100-SXM4-80GB,8,1,64,896,21,64
9adaf120-c6ef-4607-a0ce-0141d62c776f,qwen1-14B,1720729957,1720730044,finished,1720729979,1720730044,A100-SXM4-80GB,8,1,64,896,22,65
bb34b3ce-c91b-4a31-8956-acde7f409857,qwen1-14B,1720730110,1720730195,finished,1720730131,1720730195,A100-SXM4-80GB,8,1,64,896,21,64
4d768013-2ca1-4187-b1ac-9df2b66dd32f,qwen1-14B,1720730259,1720730342,finished,1720730280,1720730342,A100-SXM4-80GB,8,1,64,896,21,62
96b862a2-8c9b-47c2-ad51-a97710e1ed02,qwen1-14B,1720730407,1720730509,finished,1720730429,1720730509,A100-SXM4-80GB,8,1,64,896,22,80
ff18f157-7a91-4ff6-9d8c-b81a5db3caaf,mixtral-8x22b-sft,1720730492,1720732662,finished,1720730558,1720732662,A100-SXM4-80GB,8,64,64,896,66,2104
c78720d5-7fa9-4d3b-95a7-dc940bfe013e,qwen1-14B,1720730602,1720730708,finished,1720730623,1720730708,A100-SXM4-80GB,8,1,64,896,21,85
5658e44a-45cb-4d69-a2c5-324f65233c00,qwen1-14B,1720730773,1720730857,finished,1720730795,1720730857,A100-SXM4-80GB,8,1,64,896,22,62
9db70086-0b94-4412-a88b-0c41f360f8bf,qwen1-14B,1720730922,1720731007,finished,1720730943,1720731007,A100-SXM4-80GB,8,1,64,896,21,64
0701443e-1df8-44f6-b7f7-e2cd691780f5,qwen1-14B,1720731071,1720731155,finished,1720731092,1720731155,A100-SXM4-80GB,8,1,64,896,21,63
e3317c8e-198e-40f8-abef-92ff7a2d8d93,qwen1-14B,1720731221,1720731305,finished,1720731243,1720731305,A100-SXM4-80GB,8,1,64,896,22,62
2fa1e537-318d-4fa5-8c82-e11298a2d0ee,qwen1-14B,1720731371,1720731456,finished,1720731392,1720731456,A100-SXM4-80GB,8,1,64,896,21,64
08e43686-ac02-4b3b-9f4c-59d4807a549f,qwen1-14B,1720731520,1720731605,finished,1720731541,1720731605,A100-SXM4-80GB,8,1,64,896,21,64
81744877-0563-4f97-b65d-d7a87909240e,qwen1-14B,1720731670,1720731756,finished,1720731692,1720731756,A100-SXM4-80GB,8,1,64,896,22,64
262e5344-1889-4575-aaeb-91254a10057e,qwen1-14B,1720731821,1720731907,finished,1720731842,1720731907,A100-SXM4-80GB,8,1,64,896,21,65
d9c3f3cc-f76c-467a-acab-795f14e6308d,qwen1-14B,1720731972,1720732058,finished,1720731993,1720732058,A100-SXM4-80GB,8,1,64,896,21,65
f847b02f-fd35-4ed1-9208-b48d93f73a2e,qwen1-14B,1720732122,1720732207,finished,1720732144,1720732207,A100-SXM4-80GB,8,1,64,896,22,63
1ac2601b-7c26-470e-85d0-f27faf9119cd,qwen1-14B,1720732270,1720732356,finished,1720732292,1720732356,A100-SXM4-80GB,8,1,64,896,22,64
e791afbc-f2e8-43b3-b802-2cd969ee475f,qwen1-14B,1720732422,1720732507,finished,1720732443,1720732507,A100-SXM4-80GB,8,1,64,896,21,64
45b8cb87-87d9-4c73-90e2-b31e8547565a,qwen1-14B,1720732594,1720732679,finished,1720732615,1720732679,A100-SXM4-80GB,8,1,64,896,21,64
8191d674-ebff-456f-a5bc-b060422f5576,mixtral-8x22b-sft,1720732742,1720734893,finished,1720732788,1720734893,A100-SXM4-80GB,8,64,64,896,46,2105
e0d4ecd8-f456-4dbb-b5b4-cc616529f823,qwen1-14B,1720732760,1720732852,finished,1720732782,1720732852,A100-SXM4-80GB,8,1,64,896,22,70
b502c28d-605f-4a3b-8c98-586b14183648,qwen1-14B,1720732917,1720733002,finished,1720732938,1720733002,A100-SXM4-80GB,8,1,64,896,21,64
6ab28c52-f972-47b4-9ad8-3492aab9b49d,qwen1-14B,1720733089,1720733175,finished,1720733112,1720733175,A100-SXM4-80GB,8,1,64,896,23,63
9f16470d-b5cb-4dfc-9b5d-64975ce13784,qwen1-14B,1720733239,1720733323,finished,1720733260,1720733323,A100-SXM4-80GB,8,1,64,896,21,63
18c5a1c9-b1b4-4566-8826-80df4657416d,qwen1-14B,1720733389,1720733475,finished,1720733411,1720733475,A100-SXM4-80GB,8,1,64,896,22,64
f4b9fd10-0032-4487-be4b-e30a1d017230,qwen1-14B,1720733539,1720733646,finished,1720733561,1720733646,A100-SXM4-80GB,8,1,64,896,22,85
e73c2cab-631e-4054-995a-6aa273834b99,qwen1-14B,1720733711,1720733797,finished,1720733733,1720733797,A100-SXM4-80GB,8,1,64,896,22,64
5d0a1657-df2a-4eff-80e2-74c93af05e3f,qwen1-14B,1720733883,1720733968,finished,1720733904,1720733968,A100-SXM4-80GB,8,1,64,896,21,64
18315e2a-bc21-4ddc-9f5e-763f03de1824,qwen1-14B,1720734032,1720734138,finished,1720734053,1720734138,A100-SXM4-80GB,8,1,64,896,21,85
5ddadf79-ce4c-4b6d-aea0-98e1400e4d18,qwen1-14B,1720734224,1720734309,finished,1720734247,1720734309,A100-SXM4-80GB,8,1,64,896,23,62
86cc5905-e29b-4549-b645-fb7becf3bf53,qwen1-14B,1720734394,1720734479,finished,1720734415,1720734479,A100-SXM4-80GB,8,1,64,896,21,64
24238b81-a1fe-41a6-93f4-7898547afb8a,qwen1-14B,1720734545,1720734652,finished,1720734568,1720734652,A100-SXM4-80GB,8,1,64,896,23,84
21c05be4-31f0-4644-9a8d-96ed8d7527e2,qwen1-14B,1720734738,1720734824,finished,1720734760,1720734824,A100-SXM4-80GB,8,1,64,896,22,64
1b363117-bb21-489b-815c-5212039e64a1,qwen1-14B,1720734888,1720735060,finished,1720734909,1720735060,A100-SXM4-80GB,8,1,64,896,21,151
2568e52d-0ddf-439d-8803-dbd7b6c3dc0c,mixtral-8x22b-sft,1720734972,1720737112,finished,1720735016,1720737112,A100-SXM4-80GB,8,64,64,896,44,2096
013605c0-6f6c-4363-8d56-26cc5387b9c3,qwen1-14B,1720735124,1720735210,finished,1720735146,1720735210,A100-SXM4-80GB,8,1,64,896,22,64
c488c54a-f550-4541-a4df-b012b1011ec7,qwen1-14B,1720735279,1720735365,finished,1720735300,1720735365,A100-SXM4-80GB,8,1,64,896,21,65
48ad7a74-3607-4c23-bb88-a986552b5669,qwen1-14B,1720735430,1720735515,finished,1720735451,1720735515,A100-SXM4-80GB,8,1,64,896,21,64
b83a8934-0596-45f4-9d34-aab004b58218,qwen1-14B,1720735580,1720735666,finished,1720735601,1720735666,A100-SXM4-80GB,8,1,64,896,21,65
de24844d-ec43-48c5-aa00-a050126ee271,qwen1-14B,1720735732,1720735818,finished,1720735754,1720735818,A100-SXM4-80GB,8,1,64,896,22,64
2e514ed7-8bda-4c9b-88aa-583337d0dd3e,qwen1-14B,1720735882,1720735969,finished,1720735905,1720735969,A100-SXM4-80GB,8,1,64,896,23,64
5fe33f86-e8c1-46bf-9810-61a2e9aae6ec,qwen1-14B,1720736035,1720736120,finished,1720736057,1720736120,A100-SXM4-80GB,8,1,64,896,22,63
6b8a09ea-f838-4325-8dea-bca276b43f1f,qwen1-14B,1720736206,1720736292,finished,1720736229,1720736292,A100-SXM4-80GB,8,1,64,896,23,63
e5507891-12bc-440d-b688-939c34a6d6e7,qwen1-14B,1720736357,1720736442,finished,1720736379,1720736442,A100-SXM4-80GB,8,1,64,896,22,63
16ca7425-d5bf-4d53-a86b-38422622e7e5,qwen1-14B,1720736506,1720736592,finished,1720736529,1720736592,A100-SXM4-80GB,8,1,64,896,23,63
aef1e38e-4db4-4d45-8bed-36681e43f21e,qwen1-14B,1720736679,1720736764,finished,1720736701,1720736764,A100-SXM4-80GB,8,1,64,896,22,63
82f1f044-7740-4933-9aad-429c61634b5d,qwen1-14B,1720736851,1720736936,finished,1720736872,1720736936,A100-SXM4-80GB,8,1,64,896,21,64
64db40a9-f7a2-408c-b6a4-0362f92449f5,qwen1-14B,1720737001,1720737086,finished,1720737022,1720737086,A100-SXM4-80GB,8,1,64,896,21,64
cc55b553-3fb7-4e62-91c2-8c8b90103eb1,qwen1-14B,1720737151,1720737252,finished,1720737188,1720737252,A100-SXM4-80GB,8,1,64,896,37,64
0b0d89ea-7e09-4560-9930-4fa2f4fdaf0b,mixtral-8x22b-sft,1720737192,1720739373,finished,1720737257,1720739373,A100-SXM4-80GB,8,64,64,896,65,2116
feee2e6d-c837-491b-bf50-f570fb600e1a,qwen1-14B,1720737345,1720737451,finished,1720737366,1720737451,A100-SXM4-80GB,8,1,64,896,21,85
c275768f-e1a4-4d78-8d1e-132c40e211c4,qwen1-14B,1720737538,1720737624,finished,1720737560,1720737624,A100-SXM4-80GB,8,1,64,896,22,64
e6426103-aaab-4d5a-840f-9951200031ae,qwen1-14B,1720737689,1720737774,finished,1720737711,1720737774,A100-SXM4-80GB,8,1,64,896,22,63
e03034ca-d2ca-4e38-8074-eec4dbb9ac20,qwen1-14B,1720737838,1720737925,finished,1720737860,1720737925,A100-SXM4-80GB,8,1,64,896,22,65
a1e9a2fc-5253-4b6c-aebf-c649de95360d,qwen1-14B,1720738011,1720738098,finished,1720738033,1720738098,A100-SXM4-80GB,8,1,64,896,22,65
db228363-4983-48b8-b5f9-7455745dedbe,qwen1-14B,1720738163,1720738249,finished,1720738184,1720738249,A100-SXM4-80GB,8,1,64,896,21,65
a9c86035-652a-49d6-829f-d6a5c8205f0e,qwen1-14B,1720738313,1720738420,finished,1720738335,1720738420,A100-SXM4-80GB,8,1,64,896,22,85
54aadfd6-8783-40f5-97b3-808c7c8f46bc,qwen1-14B,1720738485,1720738592,finished,1720738507,1720738592,A100-SXM4-80GB,8,1,64,896,22,85
72cf32e2-00d4-451c-a16b-9b122d31866d,qwen1-14B,1720738657,1720738742,finished,1720738679,1720738742,A100-SXM4-80GB,8,1,64,896,22,63
e8d3ccf0-9837-4e5e-974d-54b1bce268dd,qwen1-14B,1720738808,1720738893,finished,1720738830,1720738893,A100-SXM4-80GB,8,1,64,896,22,63
97a3eabf-f418-46b1-aa19-4868399d455c,qwen1-14B,1720738958,1720739045,finished,1720738981,1720739045,A100-SXM4-80GB,8,1,64,896,23,64
5e18b4c7-c9a6-46f2-bfa1-e504d11a792a,qwen1-14B,1720739132,1720739219,finished,1720739154,1720739219,A100-SXM4-80GB,8,1,64,896,22,65
c99d7fd2-c4e6-4c08-8cd1-9bacc1f0f13d,qwen1-14B,1720739283,1720739369,finished,1720739305,1720739369,A100-SXM4-80GB,8,1,64,896,22,64
a270ce62-cde6-4c45-910d-4a6ba3881f2c,qwen1-14B,1720739448,1720739562,finished,1720739471,1720739562,A100-SXM4-80GB,8,1,64,896,23,91
5f9abf91-f831-4295-9b8a-a1b71fdeaa78,mixtral-8x22b-sft,1720739453,1720741628,finished,1720739519,1720741628,A100-SXM4-80GB,8,64,64,896,66,2109
6e49bfad-9585-4b33-9e19-f7cb50aeb278,qwen1-14B,1720739628,1720739733,finished,1720739649,1720739733,A100-SXM4-80GB,8,1,64,896,21,84
104dd227-a7cb-4ad5-8d32-b57351bcc3ec,qwen1-14B,1720739820,1720739927,finished,1720739842,1720739927,A100-SXM4-80GB,8,1,64,896,22,85
0ef52517-4bc2-494a-a38d-db8a2873d29f,qwen1-14B,1720740014,1720740100,finished,1720740036,1720740100,A100-SXM4-80GB,8,1,64,896,22,64
0ff2e317-916e-4147-bdef-3f331c738df0,qwen1-14B,1720740165,1720740250,finished,1720740187,1720740250,A100-SXM4-80GB,8,1,64,896,22,63
70fa5705-0ba8-49da-b862-95c25f60dd7c,qwen1-14B,1720740337,1720740423,finished,1720740359,1720740423,A100-SXM4-80GB,8,1,64,896,22,64
2f8f4ca7-75df-4acd-a9b6-92a6e9fd8eb1,qwen1-14B,1720740488,1720740573,finished,1720740509,1720740573,A100-SXM4-80GB,8,1,64,896,21,64
ed1cc155-ce4f-4002-8622-61c358291052,qwen1-14B,1720740638,1720740725,finished,1720740660,1720740725,A100-SXM4-80GB,8,1,64,896,22,65
790e6b2a-c0ee-4db2-ace4-73bbdbce4c56,qwen1-14B,1720740788,1720740874,finished,1720740810,1720740874,A100-SXM4-80GB,8,1,64,896,22,64
15b25e05-6ba7-4718-8777-bab7aa2bfe57,qwen1-14B,1720740939,1720741025,finished,1720740961,1720741025,A100-SXM4-80GB,8,1,64,896,22,64
ea9d577c-9dfe-415f-8b35-d5abfb157c44,qwen1-14B,1720741089,1720741173,finished,1720741110,1720741173,A100-SXM4-80GB,8,1,64,896,21,63
0267bdd7-6174-47f3-95f1-5ead19b789a8,qwen1-14B,1720741237,1720741344,finished,1720741258,1720741344,A100-SXM4-80GB,8,1,64,896,21,86
561bf2f4-cd6a-4810-982b-a6d84e269ce7,qwen1-14B,1720741409,1720741493,finished,1720741430,1720741493,A100-SXM4-80GB,8,1,64,896,21,63
0a264a51-7ef8-42d2-971f-d09ae22e2e68,qwen1-14B,1720741579,1720741702,finished,1720741601,1720741702,A100-SXM4-80GB,8,1,64,896,22,101
b81002e8-1503-4883-8319-bcb89a458af1,mixtral-8x22b-sft,1720741706,1720743878,finished,1720741751,1720743878,A100-SXM4-80GB,8,64,64,896,45,2127
a09089cd-3386-415f-871f-ce7aaa903284,qwen1-14B,1720741816,1720741903,finished,1720741838,1720741903,A100-SXM4-80GB,8,1,64,896,22,65
dae3bae8-c338-4081-ae84-352f9f499bba,qwen1-14B,1720741968,1720742054,finished,1720741990,1720742054,A100-SXM4-80GB,8,1,64,896,22,64
96bc5ecc-37a5-4bf9-8285-33b09da98eb8,qwen1-14B,1720742140,1720742247,finished,1720742161,1720742247,A100-SXM4-80GB,8,1,64,896,21,86
b76af229-d9e7-4a02-b6bb-afdd7ccd9a6d,qwen1-14B,1720742311,1720742396,finished,1720742332,1720742396,A100-SXM4-80GB,8,1,64,896,21,64
5763ba0d-9bc7-45c2-86e0-57c2714a271e,qwen1-14B,1720742462,1720742548,finished,1720742484,1720742548,A100-SXM4-80GB,8,1,64,896,22,64
c765bee6-181a-4895-9788-539bda2128ec,qwen1-14B,1720742613,1720742719,finished,1720742634,1720742719,A100-SXM4-80GB,8,1,64,896,21,85
e220a889-c339-4b50-8ba6-d2d6cda23271,qwen1-14B,1720742784,1720742870,finished,1720742806,1720742870,A100-SXM4-80GB,8,1,64,896,22,64
09d07756-3391-4fa5-9a15-6160866a633f,qwen1-14B,1720742956,1720743041,finished,1720742978,1720743041,A100-SXM4-80GB,8,1,64,896,22,63
464fd9dc-9b7d-451f-9dfa-21b1c882db6c,qwen1-14B,1720743104,1720743189,finished,1720743126,1720743189,A100-SXM4-80GB,8,1,64,896,22,63
20636cf8-9341-4daa-ad56-b06e2ba7a71b,qwen1-14B,1720743253,1720743338,finished,1720743274,1720743338,A100-SXM4-80GB,8,1,64,896,21,64
00051b5a-2f86-4306-af92-a8a97bb4d2e1,qwen1-14B,1720743402,1720743508,finished,1720743423,1720743508,A100-SXM4-80GB,8,1,64,896,21,85
4ff92f09-f385-4774-aab8-1e458defff8b,qwen1-14B,1720743572,1720743658,finished,1720743594,1720743658,A100-SXM4-80GB,8,1,64,896,22,64
1c3ab1c1-051f-40b8-b2da-d6d827b8d286,qwen1-14B,1720743724,1720743809,finished,1720743746,1720743809,A100-SXM4-80GB,8,1,64,896,22,63
bd061dfd-3d99-4096-b2ad-70df597ba54a,qwen1-14B,1720743895,1720743997,finished,1720743917,1720743997,A100-SXM4-80GB,8,1,64,896,22,80
6688f1d4-88c3-4bce-ab87-4cabb44141cc,mixtral-8x22b-sft,1720743958,1720746130,finished,1720744023,1720746130,A100-SXM4-80GB,8,64,64,896,65,2107
6f2cc30d-a5aa-4cdb-a159-0ac58f956d76,qwen1-14B,1720744090,1720744176,finished,1720744112,1720744176,A100-SXM4-80GB,8,1,64,896,22,64
2d89f300-267c-4ce8-910b-93b32d4a8b3e,qwen1-14B,1720744240,1720744324,finished,1720744261,1720744324,A100-SXM4-80GB,8,1,64,896,21,63
5edb28aa-1522-4643-9431-75f9fd83b86f,qwen1-14B,1720744389,1720744476,finished,1720744411,1720744476,A100-SXM4-80GB,8,1,64,896,22,65
e5b10d5c-b8bb-40c2-8831-6208271f729c,qwen1-14B,1720744540,1720744646,finished,1720744562,1720744646,A100-SXM4-80GB,8,1,64,896,22,84
0b346b8b-c93e-4469-8ded-6b09967e67fa,qwen1-14B,1720744711,1720744797,finished,1720744733,1720744797,A100-SXM4-80GB,8,1,64,896,22,64
08e12bea-20e8-4b77-93cd-77591ad7a2f9,qwen1-14B,1720744883,1720744969,finished,1720744905,1720744969,A100-SXM4-80GB,8,1,64,896,22,64
f1753f74-723d-4358-ac80-1ad386661614,qwen1-14B,1720745033,1720745120,finished,1720745056,1720745120,A100-SXM4-80GB,8,1,64,896,23,64
924ced7d-3672-461d-a4e8-d53d54f712e1,qwen1-14B,1720745185,1720745270,finished,1720745206,1720745270,A100-SXM4-80GB,8,1,64,896,21,64
227d9bb6-7413-4e29-9b58-7b3ad9d789d1,qwen1-14B,1720745335,1720745421,finished,1720745357,1720745421,A100-SXM4-80GB,8,1,64,896,22,64
9d1244de-e14d-4642-a72d-671f8f4a44ec,qwen1-14B,1720745506,1720745592,finished,1720745528,1720745592,A100-SXM4-80GB,8,1,64,896,22,64
2052a868-51d5-46cb-9454-fe6ffee44bbc,qwen1-14B,1720745655,1720745741,finished,1720745677,1720745741,A100-SXM4-80GB,8,1,64,896,22,64
938e7aab-528d-42db-afc9-6372f11254a4,qwen1-14B,1720745806,1720745891,finished,1720745828,1720745891,A100-SXM4-80GB,8,1,64,896,22,63
52254519-ccdc-41a3-9bb3-56cea170916a,qwen1-14B,1720745976,1720746061,finished,1720745998,1720746061,A100-SXM4-80GB,8,1,64,896,22,63
b1ec9c18-3ad2-4384-8cee-25f78c382a03,qwen1-14B,1720746125,1720746268,finished,1720746147,1720746268,A100-SXM4-80GB,8,1,64,896,22,121
361f9681-8b52-4071-a1ac-a06ef67313a3,mixtral-8x22b-sft,1720746209,1720748395,finished,1720746272,1720748395,A100-SXM4-80GB,8,64,64,896,63,2123
3e5e7ab4-3f00-4730-89c3-482a488968bb,qwen1-14B,1720746360,1720746450,finished,1720746383,1720746450,A100-SXM4-80GB,8,1,64,896,23,67
f2f25d4d-fcb9-4229-87bd-b0c4c739a21e,qwen1-14B,1720746514,1720746601,finished,1720746536,1720746601,A100-SXM4-80GB,8,1,64,896,22,65
c1328574-42e4-43ab-8f45-0134b02770f4,qwen1-14B,1720746667,1720746751,finished,1720746689,1720746751,A100-SXM4-80GB,8,1,64,896,22,62
521d9428-10d0-4997-b342-957e360d5635,train-clip-0711,1720746707,1720780539,finished,1720746727,1720780539,A100-SXM4-80GB,8,1,64,896,20,33812
5544ed74-4c6c-4f30-b95b-e5fd8ff9cba4,train-0710,1720746815,1720754939,finished,1720746838,1720754939,A100-SXM4-80GB,8,1,64,896,23,8101
c682a6d5-79db-40b9-a87e-71b66cc66a14,qwen1-14B,1720746819,1720746905,finished,1720746841,1720746905,A100-SXM4-80GB,8,1,64,896,22,64
2c65f839-ddb5-4ef5-bc6e-d4116252f3ec,mixtral-v1-0-0711-dpo,1720746849,1720748931,finished,1720748419,1720748931,A100-SXM4-80GB,8,16,64,448,1570,512
6e689d58-4fdf-45a6-b9e6-25d39b92346a,qwen1-14B,1720746990,1720747073,finished,1720747011,1720747073,A100-SXM4-80GB,8,1,64,896,21,62
43fdb1b1-0a77-4a79-a8e9-581e79eec403,qwen1-14B,1720747135,1720747221,finished,1720747156,1720747221,A100-SXM4-80GB,8,1,64,896,21,65
3b8cc852-16c7-4c75-b6f8-5c24190ba53f,sql-spider-qy-0704-qwen,1720747180,1720751797,finished,1720747202,1720751797,A100-SXM4-80GB,8,1,64,448,22,4595
b3fc073c-2377-4473-8411-e3880cb57ae8,qwen1-14B,1720747286,1720747368,finished,1720747307,1720747368,A100-SXM4-80GB,8,1,64,896,21,61
512cc0df-6180-43a8-b976-c3efbd19f004,opencompass-eval-0712,1720747406,1720748622,finished,1720747430,1720748622,A100-SXM4-80GB,8,1,64,896,24,1192
33b08862-bc98-46a7-8179-dcaa3e6cdaf0,qwen1-14B,1720747433,1720747518,finished,1720747454,1720747518,A100-SXM4-80GB,8,1,64,896,21,64
b3ef488d-2e0f-4984-8e14-3ce892779af0,linux-env,1720747474,1720748836,finished,1720747496,1720748836,A100-SXM4-80GB,8,1,64,448,22,1340
4194c73c-bc13-4f74-a25d-d0a94e70d909,qwen1-14B,1720747602,1720747688,finished,1720747624,1720747688,A100-SXM4-80GB,8,1,64,896,22,64
aa42fac9-57ca-4817-9997-b31317e125b7,qwen1-14B,1720747751,1720747837,finished,1720747771,1720747837,A100-SXM4-80GB,8,1,64,896,20,66
7fecdcf6-913a-4eb6-88c7-419ec7e87314,llama-multi,1720747795,1720747964,finished,1720747816,1720747964,A100-SXM4-80GB,8,1,64,448,21,148
0521bc13-d4de-42a8-a588-65ad5ff6530d,llama3-8b-instruct-80k-qlora-4c697-auto,1720747854,1720754788,finished,1720747876,1720754788,A100-SXM4-80GB,8,1,64,896,22,6912
37241f4c-b39e-4ab4-b0fb-a7598a24b1d0,qwen1-14B,1720747922,1720748004,finished,1720747943,1720748004,A100-SXM4-80GB,8,1,64,896,21,61
626ab63d-4155-4b5e-92e7-0c43da1beac3,rag-reranker-online,1720748003,1720748130,finished,1720748024,1720748130,A100-SXM4-40GB,1,1,8,32,21,106
079398b4-ef9d-404f-bc13-687211c61a80,qwen1-14B,1720748088,1720748175,finished,1720748109,1720748175,A100-SXM4-80GB,8,1,64,896,21,66
7e7e8de9-0dc4-4996-9574-e620c45ee5ee,sql-spider-qy-llama,1720748134,1720749211,finished,1720748156,1720749211,A100-SXM4-80GB,8,1,64,448,22,1055
ef64f4a6-39e5-49be-810a-29e9e1293dc7,llama-multi,1720748154,1720748324,finished,1720748176,1720748324,A100-SXM4-80GB,8,1,64,448,22,148
a5d8b8fb-5083-4557-a23e-dff10ee93067,qwen1-14B,1720748261,1720748347,finished,1720748283,1720748347,A100-SXM4-80GB,8,1,64,896,22,64
e08072f9-db2e-4cc7-a37e-8da52d617417,geogpt-lxz-60wc-class-based-llama3-8b,1720748351,1720809686,finished,1720748416,1720809686,A100-SXM4-80GB,8,4,64,448,65,61270
52eeb442-4cce-45fc-a002-a33af4930423,qwen1-14B,1720748438,1720748540,finished,1720748475,1720748540,A100-SXM4-80GB,8,1,64,896,37,65
7988e7ee-d15d-42b8-bdfb-c16ed4f69936,llama-multi,1720748477,1720748627,finished,1720748498,1720748627,A100-SXM4-80GB,8,1,64,448,21,129
6cf018b0-1ce0-430c-8eba-a32562b03b80,mixtral-8x22b-sft,1720748481,1720751068,finished,1720748952,1720751068,A100-SXM4-80GB,8,64,64,896,471,2116
ade2d133-33fe-49c3-b82f-e23caefb488f,rag-reranker-online,1720748519,1720748731,finished,1720748540,1720748731,A100-SXM4-40GB,1,1,8,32,21,191
c66279f5-1a14-4de9-a474-a31e2d472a9e,qwen1-14B,1720748626,1720748711,finished,1720748648,1720748711,A100-SXM4-80GB,8,1,64,896,22,63
b77a2564-e03c-4dde-8ec3-816abadff6cd,llama3-70b-instruct-0d2b9-auto,1720748634,1720751610,finished,1720748656,1720751610,A100-SXM4-80GB,8,1,64,448,22,2954
8b795f2b-fbb8-4cce-bed4-9db4482be709,rag-reranker-online,1720748731,1720765177,finished,1720748752,1720765177,A100-SXM4-40GB,1,1,8,32,21,16425
87f25cdf-a12e-43ae-a2b0-8fc9122557df,qwen1-14B,1720748794,1720748899,finished,1720748816,1720748899,A100-SXM4-80GB,8,1,64,896,22,83
4e1088e5-89d6-4369-a8f3-b8265e63cff4,linux-env,1720748836,1720749418,finished,1720748857,1720749418,A100-SXM4-80GB,8,1,64,448,21,561
874c7c6f-a7d6-4acc-9f15-0c94e4425b99,qwen1-14B,1720748994,1720749101,finished,1720749016,1720749101,A100-SXM4-80GB,8,1,64,896,22,85
8343cfab-9b85-4ff4-8764-f7020eedd3c3,llama-multi,1720749123,1720749550,finished,1720749146,1720749550,A100-SXM4-80GB,8,1,64,448,23,404
e1793c36-fa08-473b-b258-9ae084bffda1,qwen1-14B,1720749167,1720749251,finished,1720749188,1720749251,A100-SXM4-80GB,8,1,64,896,21,63
a3bb43b2-8836-4a57-868c-4996b6a6efe6,qwen1-14B,1720749314,1720749398,finished,1720749335,1720749398,A100-SXM4-80GB,8,1,64,896,21,63
39234938-86e2-423f-b407-b16511eca21d,linux-env,1720749418,1720750767,finished,1720749439,1720750767,A100-SXM4-80GB,8,1,64,448,21,1328
16044d2e-5d86-4c35-af42-d4dc77ca33a3,qwen1-14B,1720749463,1720749550,finished,1720749484,1720749550,A100-SXM4-80GB,8,1,64,896,21,66
52f2773a-859e-4803-87e8-e9446433c654,citysora-modelv4-cele-ppm-65-512-from-200k256,1720749553,1720750290,finished,1720749618,1720750290,A100-SXM4-80GB,8,4,64,896,65,672
d0ad3f3d-ed50-4da1-beb1-2d1a72933f12,qwen1-14B,1720749615,1720749703,finished,1720749638,1720749703,A100-SXM4-80GB,8,1,64,896,23,65
1eeba996-9997-4fdb-baf2-52e23c7908ff,cft-mt-lr5e-6-14b,1720749643,1720836658,finished,1720749665,1720836658,A100-SXM4-80GB,8,1,64,448,22,86993
48779e04-e062-4836-a280-0308a5e731ff,qwen1-14B,1720749788,1720749871,finished,1720749809,1720749871,A100-SXM4-80GB,8,1,64,896,21,62
647a741f-7b45-43ae-b7c8-cb98a657b92d,qwen1-14B,1720749935,1720750019,finished,1720749957,1720750019,A100-SXM4-80GB,8,1,64,896,22,62
f9b3b1d2-7b2d-44b0-900d-39a6493b71ec,llama3-8b-cpt-80k-3b-1d5b4-auto,1720750037,1720754739,finished,1720750058,1720754739,A100-SXM4-80GB,8,1,64,896,21,4681
a2c30a49-127a-4e08-a6d7-63f080cf4535,qwen1-14B,1720750084,1720750170,finished,1720750107,1720750170,A100-SXM4-80GB,8,1,64,896,23,63
772813fc-a917-4cb4-8ba6-09832061bbd7,opencompass-eval-0712,1720750146,1720759487,finished,1720750166,1720759487,A100-SXM4-80GB,8,1,64,896,20,9321
f67f7971-9785-46b4-98a3-aeb899d78955,qwen1-14B,1720750249,1720750457,finished,1720750331,1720750457,A100-SXM4-80GB,8,1,64,896,82,126
495e31e7-3173-4fd5-b805-756d0c057f07,citysora-modelv4-cele-ppm-65-512-from-200k256,1720750290,1720842005,finished,1720750355,1720842005,A100-SXM4-80GB,8,4,64,896,65,91650
444038dc-0630-478c-a11a-46e6441ed84b,geogpt-llama3-lp84-sft,1720750465,1720790310,finished,1720750509,1720790310,A100-SXM4-80GB,8,32,64,448,44,39801
cea4bfeb-be6e-4d70-b4d4-d16e021100b7,qwen1-14B,1720750534,1720750619,finished,1720750556,1720750619,A100-SXM4-80GB,8,1,64,896,22,63
26a049ad-3f11-483d-b3a1-1cd307d91227,qwen1-14B,1720750682,1720750768,finished,1720750703,1720750768,A100-SXM4-80GB,8,1,64,896,21,65
76aaf269-6b78-453a-9286-2d62f64143b6,sql-spider-qy-llama,1720750748,1720751861,finished,1720750770,1720751861,A100-SXM4-80GB,8,1,64,448,22,1091
1927aec7-acd9-4cbb-be46-66e321327365,qwen1-14B,1720750832,1720750914,finished,1720750853,1720750914,A100-SXM4-80GB,8,1,64,896,21,61
ea0322ec-a34a-45e3-a02f-e784ae8148b1,qwen1-14B,1720750998,1720751085,finished,1720751019,1720751085,A100-SXM4-80GB,8,1,64,896,21,66
e2fc0c51-716c-480c-bd15-2183310633e8,llama-factory-long-dp-pt-test,1720751060,1720751383,finished,1720751083,1720751383,A100-SXM4-80GB,8,1,64,448,23,300
03267d3a-108d-439a-9b7a-54027e98fa9a,mixtral-8x22b-sft,1720751148,1720755007,finished,1720751211,1720755007,A100-SXM4-80GB,8,64,64,896,63,3796
afa385d8-70a5-42f1-8136-5391937474fa,qwen1-14B,1720751164,1720751277,finished,1720751185,1720751277,A100-SXM4-80GB,8,1,64,896,21,92
01a45913-7eed-467f-bb3e-e378185c53cf,qwen1-14B,1720751341,1720751433,finished,1720751363,1720751433,A100-SXM4-80GB,8,1,64,896,22,70
c43b4f6e-c70c-4656-88dc-9128e8f90366,geogpt-qwen2-chat-0612dpo-dare-ties-p57,1720751346,1720755319,finished,1720751388,1720755319,A100-SXM4-80GB,8,1,64,448,42,3931
b729181a-ef4d-4704-8181-06c0c0f37290,mixtral-v1-0-0711-dpo,1720751349,1720751611,finished,1720751412,1720751611,A100-SXM4-80GB,8,16,64,448,63,199
c77d51c5-44ce-4add-ab81-6b0b672f9e40,qwen2-72b-lp84-s2-regate2b-m-0365b-auto,1720751418,1720754852,finished,1720751441,1720754852,A100-SXM4-80GB,8,1,64,448,23,3411
f0c74c64-28d2-4129-96ec-4019a962f5ef,qwen2-72b-lp84-s2-regate2b-m-cd781-auto,1720751462,1720754369,finished,1720751927,1720754369,A100-SXM4-80GB,8,1,64,448,465,2442
07758b7a-dd7c-4cae-9133-bec1e70c6c03,qwen1-14B,1720751519,1720751710,finished,1720751647,1720751710,A100-SXM4-80GB,8,1,64,896,128,63
61b0f7aa-7abb-4910-a300-5168d41f27a4,llama3-70b-lp84-23bcpt-1-2ep-68c2d-auto,1720751611,1720754088,finished,1720751717,1720754088,A100-SXM4-80GB,8,1,64,448,106,2371
e54c2967-45f4-4dc0-902c-d2af65a5f3d6,llama3-70b-lp84-23bcpt-1-2ep-cd52a-auto,1720751633,1720754877,finished,1720751886,1720754877,A100-SXM4-80GB,8,1,64,448,253,2991
8b58c05c-a032-4ed0-9493-a25d139c547c,qwen1-14B,1720751772,1720751919,finished,1720751837,1720751919,A100-SXM4-80GB,8,1,64,896,65,82
be4caf38-1d20-487d-aed2-61c9b78350ac,llama-multi,1720751984,1720752130,finished,1720752006,1720752130,A100-SXM4-80GB,8,1,64,448,22,124
8056c2e5-c92e-4242-ae8e-f65ee3a9c034,qwen1-14B,1720752005,1720754186,finished,1720754124,1720754186,A100-SXM4-80GB,8,1,64,896,2119,62
7ebf2447-8fe4-4f3c-b082-734c1241a00d,llama-multi,1720752652,1720752800,finished,1720752674,1720752800,A100-SXM4-80GB,8,1,64,448,22,126
a63c8f62-1b57-4c8e-bfd7-f71551b3da87,geogpt-ultrafuser-direct-eval,1720752931,1720783151,finished,1720754279,1720783151,A100-SXM4-80GB,8,1,64,448,1348,28872
e0739d3b-3498-4606-be4f-35d520af9b8e,mixtral-v1-0-0711-dpo,1720752980,1720753113,finished,1720753021,1720753113,A100-SXM4-80GB,8,16,64,448,41,92
ed35d048-719d-4f6d-aff5-97febe2c2b18,qwen1-5-7b-chat-d14ed-auto,1720753280,1720754754,finished,1720754499,1720754754,A100-SXM4-80GB,8,1,64,448,1219,255
a1e219d1-4b09-49c3-b2fb-2559d401c8a3,tq-llm-chat-infer-1,1720753331,1720754262,finished,1720754197,1720754262,A100-SXM4-80GB,8,1,64,448,866,65
334d6b87-edd0-485d-b721-fad3b0b81af2,geo-05B-hit-5,1720753396,1720753716,finished,1720753424,1720753716,A100-SXM4-80GB,8,1,64,448,28,292
76443b67-61ed-4a7d-9792-3bdde1656616,citysora-modelv4-cele-ppm-cosmic-65-512,1720753396,1720753662,finished,1720753570,1720753662,A100-SXM4-80GB,8,4,64,896,174,92
faf8a4f2-a31f-414a-8e31-4645a3a8870e,geo-05B-hit20,1720753397,1720753479,finished,1720753425,1720753479,A100-SXM4-80GB,8,1,64,448,28,54
65911ffb-4ba6-4a0a-9469-f103e29d43f9,geo-05B-hit10,1720753397,1720753479,finished,1720753425,1720753479,A100-SXM4-80GB,8,1,64,448,28,54
27e4bec5-61f3-4827-9b9f-277871a5766d,geo-05B-hit-all-5,1720753398,1720753480,finished,1720753425,1720753480,A100-SXM4-80GB,8,1,64,448,27,55
2b764d5e-c500-4fc6-8ae5-dba4867d21e9,geo-05B-hit-all10,1720753399,1720753480,finished,1720753426,1720753480,A100-SXM4-80GB,8,1,64,448,27,54
7bb2f55e-5468-4c24-83fc-54980fd083a1,geo-05B-hit-1,1720753402,1720753743,finished,1720753427,1720753743,A100-SXM4-80GB,8,1,64,448,25,316
8f8a454d-aebe-4d0a-8ac4-115658f43917,geo-05B-hit-all-1,1720753403,1720753743,finished,1720753427,1720753743,A100-SXM4-80GB,8,1,64,448,24,316
49cd89e8-06e6-48ca-86ec-f34133df4b5a,geo-05B-hit-first,1720753594,1720753665,finished,1720753615,1720753665,A100-SXM4-80GB,8,1,64,448,21,50
80d72e02-1b2c-4ad4-8445-6ffce8e12f14,citysora-modelv4-cele-ppm-cosmic-65-512,1720753662,1721023317,finished,1720753714,1721023317,A100-SXM4-80GB,8,4,64,896,52,269603
1d728e86-e9c5-4db7-b8c1-dd1dcc79924c,geo-05B-hit10,1720753664,1720877469,finished,1720753687,1720877469,A100-SXM4-80GB,8,1,64,448,23,123782
b95c0787-e368-4cae-805d-916f94c19fb5,geo-05B-hit20,1720753689,1720877625,finished,1720753716,1720877625,A100-SXM4-80GB,8,1,64,448,27,123909
0bb374d1-f546-49f0-adf3-612ec1b1e0a0,geo-05B-hit-all10,1720753718,1720877272,finished,1720753741,1720877272,A100-SXM4-80GB,8,1,64,448,23,123531
2a4be4a2-25de-4752-8fa8-1a4d51d88127,geo-05B-hit-all-20,1720753742,1720877450,finished,1720753766,1720877450,A100-SXM4-80GB,8,1,64,448,24,123684
fe9929f1-6d16-4b45-bd63-b72847541984,geo-05B-hit-all-5,1720753765,1720878673,finished,1720753793,1720878673,A100-SXM4-80GB,8,1,64,448,28,124880
c696f5df-c81a-42a0-bed3-95424f436c32,geo-05B-hit-first,1720753768,1720878346,finished,1720753793,1720878346,A100-SXM4-80GB,8,1,64,448,25,124553
d32f1436-818f-4dbd-b186-820a07761bd0,geo-05B-hit-5,1720753792,1720878269,finished,1720753819,1720878269,A100-SXM4-80GB,8,1,64,448,27,124450
a97f40d6-d59e-4bba-9b98-3b83ed5a5079,geo-05B-hit-1,1720753795,1720877978,finished,1720753820,1720877978,A100-SXM4-80GB,8,1,64,448,25,124158
2e23d16b-2585-4f64-b6df-718d856791e3,geo-05B-hit-all-1,1720753797,1720876574,finished,1720753821,1720876574,A100-SXM4-80GB,8,1,64,448,24,122753
b929caaf-dcde-491a-a4e1-39f49a1438e5,sfr-ft-2,1720754056,1720754766,finished,1720754447,1720754766,A100-SXM4-80GB,8,1,64,448,391,319
b23b1413-b0be-4744-86c4-737299f480a4,qwen1-14B,1720754252,1720754492,finished,1720754426,1720754492,A100-SXM4-80GB,8,1,64,896,174,66
1585dd5f-0e9a-4437-903a-e212a38a36d6,marker-xiaodian,1720754421,1720754508,finished,1720754444,1720754508,A100-SXM4-80GB,8,1,64,896,23,64
26f53c0e-93f9-44bc-98b2-4eb3ef7b1005,sleep-yy,1720754508,1720754862,finished,1720754533,1720754862,A100-SXM4-80GB,8,1,64,896,25,329
95342cc4-235b-427a-bbbb-559ebe6ec79f,marker-xiaodian,1720754623,1720754763,finished,1720754688,1720754763,A100-SXM4-80GB,8,1,64,896,65,75
95b2094d-75a5-4de3-8899-dd69f282ec49,moe-sft,1720754630,1720755172,finished,1720754712,1720755172,A100-SXM4-80GB,8,1,64,448,82,460
77f95b0e-1004-4838-ac4b-bb197cdb2378,qwen1-14B,1720754649,1720754868,finished,1720754791,1720754868,A100-SXM4-80GB,8,1,64,896,142,77
e89dc688-282b-4263-bf4c-2a10c8836271,train-mg-4same,1720754651,1720778958,finished,1720755200,1720778958,A100-SXM4-80GB,8,1,64,448,549,23758
e2567231-82c4-4d94-ad0b-c56984400f2b,train-mg-4diff,1720754653,1720800080,finished,1720754716,1720800080,A100-SXM4-80GB,8,1,64,896,63,45364
0bf295d0-eb33-4199-b67e-b3977361c530,sql-spider-qy-0704-qwen,1720754658,1720999605,finished,1720754745,1720999605,A100-SXM4-80GB,8,1,64,448,87,244860
4f5e217e-0a41-4f5a-a19e-41b870f81b83,tq-llm-chat-infer-1,1720754679,1720754857,finished,1720754780,1720754857,A100-SXM4-80GB,8,1,64,448,101,77
ab40e510-6043-4b37-9406-59f347ce818a,geogpt-moe-qwen15-alpaca-sft,1720754689,1721023716,finished,1720800137,1721023716,A100-SXM4-80GB,8,2,64,448,45448,223579
c20375c2-cd19-4ac2-aa85-6491b122d560,mixtral-v1-0-0711-dpo,1720754702,1720755186,finished,1720755035,1720755186,A100-SXM4-80GB,8,16,64,448,333,151
95eb7222-1d56-485f-8a9e-9e7eb7cbd08d,qwen2-72b-0612-dpo-91b91-auto,1720754725,1720765660,finished,1720754874,1720765660,A100-SXM4-80GB,8,1,64,448,149,10786
4f11f287-2ab4-4692-826c-08c66142c150,geogpt-dairui-eval-code,1720754746,1720755250,finished,1720754772,1720755250,A100-SXM4-80GB,8,1,64,448,26,478
8d5c7da9-c768-4dd4-bbce-7940f8771630,q72b-chat-54eb0-auto,1720754749,1720767053,finished,1720754797,1720767053,A100-SXM4-80GB,8,1,64,448,48,12256
a7120fd2-9111-45db-93da-093346ec3b25,qwen1-5-7b-chat-d14ed-auto,1720754801,1720756902,finished,1720754878,1720756902,A100-SXM4-80GB,8,1,64,448,77,2024
56c7eac4-2dd8-4449-b81a-8f460359a64e,llama3-8b-cpt-80k-3b-1d5b4-auto,1720754813,1720762775,finished,1720754864,1720762775,A100-SXM4-80GB,8,1,64,896,51,7911
e03de585-e641-42c1-84a2-7398429ea9a0,qwen1-5-14b-chat-683ec-auto,1720754853,1720768441,finished,1720754878,1720768441,A100-SXM4-80GB,8,1,64,448,25,13563
649d78a9-031d-437f-81e9-bbb5a898ad42,sleep-yy,1720754862,1720754960,finished,1720754887,1720754960,A100-SXM4-80GB,8,1,64,896,25,73
39f94747-c564-47ae-b1a1-4522daebf73b,llama-factory-zj-test,1720754866,1720756304,finished,1720755101,1720756304,A100-SXM4-80GB,8,4,64,896,235,1203
0b640926-e417-4fb0-88a5-efa42cc9af39,llama-multi,1720754892,1720755081,finished,1720754918,1720755081,A100-SXM4-80GB,8,1,64,448,26,163
f8790d21-411c-4a84-8bec-701623d62433,llama3-8b-instruct-80k-qlora-4c697-auto,1720754911,1720762732,finished,1720754939,1720762732,A100-SXM4-80GB,8,1,64,896,28,7793
69907c97-20f3-44ab-b999-06fd8917d824,geogpt-sft-qwen2-72b-datav081-ep1,1720754921,1720801541,finished,1720755030,1720801541,A100-SXM4-80GB,8,1,64,448,109,46511
4344dea8-f3f2-494e-8308-1065d3f4a271,train-0710,1720754939,1720758930,finished,1720754962,1720758930,A100-SXM4-80GB,8,1,64,896,23,3968
4c046bb4-75f7-4b70-bd44-5b6c82259e4e,qwen1-14B,1720754942,1720755150,finished,1720755058,1720755150,A100-SXM4-80GB,8,1,64,896,116,92
8090f54c-38e6-4db2-9098-64b6283a6655,qwen2-72b-lp84-s2-regate2b-m-0365b-auto,1720754989,1720793754,finished,1720755040,1720793754,A100-SXM4-80GB,8,1,64,448,51,38714
79354515-a7e4-452a-924b-2a1e9ae4c132,Qwen2-72B-Instruct-0711-4-bs1-dad28-auto,1720755015,1720855374,finished,1720755047,1720855374,A100-SXM4-80GB,8,1,64,448,32,100327
826aa34c-6c8f-430f-927c-b31a993bbb11,qwen1-5-14b-sft-0-8m-mosaic-72b58-auto,1720755042,1720769196,finished,1720755067,1720769196,A100-SXM4-80GB,8,1,64,448,25,14129
2af9adcf-6ba0-461b-b658-eff1d80559e8,llama3-70b-lp84-23bcpt-1-2ep-cd52a-auto,1720755044,1720799210,finished,1720755067,1720799210,A100-SXM4-80GB,8,1,64,448,23,44143
aaf64b88-e87d-4f56-a0c5-bc0402cc0dce,sleep-yy,1720755076,1720755476,finished,1720755098,1720755476,A100-SXM4-80GB,8,1,64,896,22,378
7ef5880d-bdc8-44a9-9d7c-2f3cdc086ef7,geogpt-moe-0-5B-tag-1-freeze-attn-norm-detach,1720755155,1720786397,finished,1720755205,1720786397,A100-SXM4-80GB,8,2,64,896,50,31192
84e37d50-6ac9-4b85-bebb-eef6452655d8,tq-llm-chat-infer-1,1720755165,1720755259,finished,1720755189,1720755259,A100-SXM4-80GB,8,1,64,448,24,70
aea1e600-46f3-4698-a41b-d8320f31b4aa,geo-base-offline-eval,1720755204,1720765755,finished,1720755227,1720765755,A100-SXM4-80GB,8,1,64,448,23,10528
139a72b7-37cc-4b8d-813b-efbfacacaf74,qwen1-14B,1720755247,1720755336,finished,1720755269,1720755336,A100-SXM4-80GB,8,1,64,896,22,67
088f077d-1bfe-42f8-acb3-8256573ffa8b,tq-llm-chat-infer-1,1720755420,1720755513,finished,1720755446,1720755513,A100-SXM4-80GB,8,1,64,448,26,67
bb4ac6aa-b3ba-4165-8c59-99a44a16f97d,tq-embedding-4,1720755425,1720756089,finished,1720755448,1720756089,A100-SXM4-80GB,8,1,64,448,23,641
bc0c9a84-2fbc-40b5-9246-17c4c894993c,qwen1-14B,1720755434,1720755524,finished,1720755459,1720755524,A100-SXM4-80GB,8,1,64,896,25,65
4577990c-345e-4d1b-af71-76d8a0f790c4,sleep-yy,1720755564,1720755660,finished,1720755590,1720755660,A100-SXM4-80GB,8,1,64,896,26,70
dd540a98-b35b-43d8-b7a8-e9c4b899e167,geogpt-sft-80wc-magpie-qwen2-mczhmpyc-llama3-8b,1720755577,1720841947,finished,1720755645,1720841947,A100-SXM4-80GB,8,4,64,448,68,86302
7d58575e-dd1e-413e-9b31-bc1cd7edac0d,qwen1-14B,1720755595,1720755686,finished,1720755618,1720755686,A100-SXM4-80GB,8,1,64,896,23,68
367aca01-abf6-48fa-bdac-3fc173dbf18f,marker-xiaodian,1720755728,1720756002,finished,1720755752,1720756002,A100-SXM4-80GB,8,1,64,896,24,250
43102ca7-16d1-4f66-877a-fac532d729a5,sleep-yy,1720755752,1720755980,finished,1720755775,1720755980,A100-SXM4-80GB,8,1,64,896,23,205
3c37494b-1c38-47a2-bc22-3aa14e4d072d,qwen1-14B,1720755757,1720755846,finished,1720755779,1720755846,A100-SXM4-80GB,8,1,64,896,22,67
2aa22fc6-48d4-4975-a636-674930e131fc,geogpt-dairui-eval-code,1720755896,1720756356,finished,1720755918,1720756356,A100-SXM4-80GB,8,1,64,448,22,438
99bf02ce-9ea1-4210-91eb-0c9799c3e0ee,qwen1-14B,1720755938,1720756030,finished,1720755961,1720756030,A100-SXM4-80GB,8,1,64,896,23,69
bc87407d-7ae2-4648-93ad-8e3a97eef5e0,tq-llm-chat-infer-1,1720756018,1720758214,finished,1720756042,1720758214,A100-SXM4-80GB,8,1,64,448,24,2172
5892dbc2-540a-4c45-955c-a85921900b77,qwen1-14B,1720756121,1720756210,finished,1720756144,1720756210,A100-SXM4-80GB,8,1,64,896,23,66
79478f4f-2fc1-4214-bfe4-81b5b6d69a78,tq-embedding-4,1720756224,1720766293,finished,1720756247,1720766293,A100-SXM4-80GB,8,1,64,448,23,10046
163bc6ef-5ece-4c1a-ab68-58eb9c7ece8f,qwen1-14B,1720756305,1720756397,finished,1720756329,1720756397,A100-SXM4-80GB,8,1,64,896,24,68
93226dce-7cc7-464e-a1b3-dd6baf44bd1a,txchen-lm-eval2,1720756342,1720758653,finished,1720756365,1720758653,A100-SXM4-80GB,8,1,64,448,23,2288
04b94e12-e08b-497c-a76a-bb9e3b7f5f02,geogpt-dairui-eval-code,1720756356,1720756423,finished,1720756378,1720756423,A100-SXM4-80GB,8,1,64,448,22,45
5df7a9da-eac3-4d19-b457-1a6e23beb929,qwen1-14B,1720756465,1720756553,finished,1720756487,1720756553,A100-SXM4-80GB,8,1,64,896,22,66
9d62d3c4-8add-4a1b-8e71-663fc27ac17c,geogpt-dairui-eval-code,1720756491,1720756578,finished,1720756514,1720756578,A100-SXM4-80GB,8,1,64,448,23,64
b7c1c0a2-e9ee-4b89-b307-6c23a121cd1a,qwen1-14B,1720756620,1720756707,finished,1720756642,1720756707,A100-SXM4-80GB,8,1,64,896,22,65
0adbfd7e-81f4-4f1b-a60c-0cef1fac3ef9,qwen1-14B,1720756798,1720756894,finished,1720756825,1720756894,A100-SXM4-80GB,8,1,64,896,27,69
f4d5412f-3bf4-44ba-92de-3ab6400e57a4,geogpt-dairui-eval-code,1720756829,1720757290,finished,1720756852,1720757290,A100-SXM4-80GB,8,1,64,448,23,438
6572f574-84d1-4e0b-ae5d-e7025ebe2aec,qwen1-14B,1720756962,1720757054,finished,1720756985,1720757054,A100-SXM4-80GB,8,1,64,896,23,69
43055615-2a6d-4cdd-9e4f-f9dc346217a2,llama-factory-zj-test,1720757052,1720757720,finished,1720757123,1720757720,A100-SXM4-80GB,8,4,64,896,71,597
dc7b39ad-aa59-4dd2-a1ce-7e81f4fbf5ae,vae-baseline-replic,1720757103,1720761291,finished,1720757129,1720761291,A100-SXM4-80GB,8,1,64,896,26,4162
478c2443-b8a3-4bfc-ac58-90e7e0f6371b,qwen1-14B,1720757149,1720757238,finished,1720757171,1720757238,A100-SXM4-80GB,8,1,64,896,22,67
d614a283-b434-43fc-aaed-aa839750117c,geogpt-dairui-eval-code,1720757290,1720757680,finished,1720757314,1720757680,A100-SXM4-80GB,8,1,64,448,24,366
f75be197-1e15-4f7c-8f95-76005c2ca963,qwen1-14B,1720757310,1720757404,finished,1720757333,1720757404,A100-SXM4-80GB,8,1,64,896,23,71
6aacef5c-4952-48e2-9c52-23695fa812b1,cft-1-8m-sub-plus-mt-qwen2-72b,1720757340,1720844376,finished,1720757364,1720844376,A100-SXM4-80GB,8,1,64,448,24,87012
18f489d4-70a8-4143-8739-cb8d07038cf4,geo-mod-05b-test,1720757362,1720838516,finished,1720836235,1720838516,A100-SXM4-80GB,8,4,64,448,78873,2281
2f283cc8-4b5a-43a2-a46e-c06b371f4fc4,qwen1-14B,1720757492,1720757584,finished,1720757514,1720757584,A100-SXM4-80GB,8,1,64,896,22,70
8f03abf5-79d1-487d-81e3-6df76b8c1acd,qwen1-14B,1720757650,1720757745,finished,1720757676,1720757745,A100-SXM4-80GB,8,1,64,896,26,69
25c1f2e8-13be-44ca-832f-d394a6006426,geogpt-dairui-eval-code,1720757680,1720758092,finished,1720757703,1720758092,A100-SXM4-80GB,8,1,64,448,23,389
dd64f766-cf63-40c3-bff8-af121017e2af,llama-factory-zj-test,1720757720,1720758795,finished,1720757788,1720758795,A100-SXM4-80GB,8,4,64,896,68,1007
314adb96-1243-40fc-b445-ada515804775,qwen1-14B,1720757814,1720757906,finished,1720757837,1720757906,A100-SXM4-80GB,8,1,64,896,23,69
d83f5775-1d77-40ec-bdf5-eb50c5443613,geo-05B-zero3,1720757864,1720758183,finished,1720758113,1720758183,A100-SXM4-80GB,8,1,64,896,249,70
27ba9ad1-60f3-4a07-ba41-c7b482262903,qwen1-14B,1720757996,1720758088,finished,1720758020,1720758088,A100-SXM4-80GB,8,1,64,896,24,68
e866e8f4-b7b9-495d-af0c-29ad79080e47,qwen1-14B,1720758157,1720758247,finished,1720758180,1720758247,A100-SXM4-80GB,8,1,64,896,23,67
3e03d316-0398-456d-ade4-528d2f1fca32,tq-llm-chat-infer-1,1720758308,1720763522,finished,1720758331,1720763522,A100-SXM4-80GB,8,1,64,448,23,5191
27409e2d-f3fa-4b3f-86f4-1440b7d86557,qwen1-14B,1720758342,1720758433,finished,1720758365,1720758433,A100-SXM4-80GB,8,1,64,896,23,68
57d3fb3d-5e11-410d-a5a1-e2da9ee3e539,qwen1-14B,1720758503,1720758594,finished,1720758526,1720758594,A100-SXM4-80GB,8,1,64,896,23,68
a1441844-2706-40bc-8e1e-354e6a6fa589,geo-05B-zero3,1720758506,1720758711,finished,1720758530,1720758711,A100-SXM4-80GB,8,1,64,896,24,181
b04966c8-28ab-4550-9a95-b57be69e72e2,qwen1-14B,1720758662,1720758751,finished,1720758685,1720758751,A100-SXM4-80GB,8,1,64,896,23,66
e8649d15-0bfa-4c71-9e13-433ed7017f93,qwen1-14B,1720758842,1720758933,finished,1720758865,1720758933,A100-SXM4-80GB,8,1,64,896,23,68
a99218d1-41ab-4624-bb74-9a4d3b20efc1,train-0710,1720758930,1720759553,finished,1720758952,1720759553,A100-SXM4-80GB,8,1,64,896,22,601
a55ba8bc-9fe4-493e-b6f8-366d2d6ff71a,qwen1-14B,1720759001,1720759090,finished,1720759023,1720759090,A100-SXM4-80GB,8,1,64,896,22,67
5499417e-7663-4f25-bebf-c6b085f8a474,qwen1-14B,1720759159,1720759248,finished,1720759182,1720759248,A100-SXM4-80GB,8,1,64,896,23,66
35b30f62-ec31-44dd-804e-cff4a8545355,qwen1-14B,1720759316,1720759403,finished,1720759338,1720759403,A100-SXM4-80GB,8,1,64,896,22,65
7d1c4be8-a82d-4608-bdee-ee9d1e693e60,qwen1-14B,1720759491,1720759578,finished,1720759512,1720759578,A100-SXM4-80GB,8,1,64,896,21,66
831d477c-1124-4ac1-ba7e-7c9acafaf0b2,qwen1-14B,1720759645,1720759734,finished,1720759667,1720759734,A100-SXM4-80GB,8,1,64,896,22,67
5efaac2f-b13b-4a2e-b752-0dc3da29aa0e,sfr-ft-2,1720759710,1720768628,finished,1720759732,1720768628,A100-SXM4-80GB,8,1,64,448,22,8896
3dfdb4de-eb27-4ad2-a714-32bf33f246dd,qwen1-14B,1720759800,1720759888,finished,1720759823,1720759888,A100-SXM4-80GB,8,1,64,896,23,65
1c26c5fd-5ab2-437e-a6b1-4655c742af99,qwen1-14B,1720759975,1720760062,finished,1720759997,1720760062,A100-SXM4-80GB,8,1,64,896,22,65
2272d65e-6fd2-45fa-875c-ea1f938bd70c,qwen1-14B,1720760128,1720760215,finished,1720760150,1720760215,A100-SXM4-80GB,8,1,64,896,22,65
ae5de5bf-51de-4b11-a824-84a95de90430,qwen1-14B,1720760303,1720760389,finished,1720760324,1720760389,A100-SXM4-80GB,8,1,64,896,21,65
d964af49-3df6-4165-992e-26e75df247c5,txchen-lm-eval2,1720760446,1720763844,finished,1720760468,1720763844,A100-SXM4-80GB,8,1,64,448,22,3376
162e32e3-8148-4d70-947d-3c0965a8c031,qwen1-14B,1720760479,1720760567,finished,1720760501,1720760567,A100-SXM4-80GB,8,1,64,896,22,66
3597f691-3736-4e86-a222-7d502c8e5338,qwen1-14B,1720760653,1720760740,finished,1720760676,1720760740,A100-SXM4-80GB,8,1,64,896,23,64
8986ee24-edbd-45ea-b8ca-b70c606d1f43,qwen1-14B,1720760806,1720760892,finished,1720760827,1720760892,A100-SXM4-80GB,8,1,64,896,21,65
33d74218-2314-439b-bdfa-d638aad40a70,qwen1-14B,1720760980,1720761067,finished,1720761002,1720761067,A100-SXM4-80GB,8,1,64,896,22,65
e13bba0c-7aa1-4be4-9174-558ba397f8d9,test-deepspeed-gpu,1720760997,1720762687,finished,1720761041,1720762687,A100-SXM4-80GB,8,2,64,896,44,1646
36a50996-a5b1-4690-af31-c16112df1dea,qwen1-14B,1720761133,1720761220,finished,1720761155,1720761220,A100-SXM4-80GB,8,1,64,896,22,65
e1abffa0-28d1-4fd7-9784-89bbb328ccd3,vae-baseline-replic,1720761244,1720762469,finished,1720761314,1720762469,A100-SXM4-80GB,8,1,64,896,70,1155
a25299eb-86fa-4c4a-bb4e-da0c531819c4,qwen1-14B,1720761288,1720761375,finished,1720761311,1720761375,A100-SXM4-80GB,8,1,64,896,23,64
49447b84-2097-4e39-9adc-1a580f76b6b8,qwen1-14B,1720761464,1720761551,finished,1720761486,1720761551,A100-SXM4-80GB,8,1,64,896,22,65
75de7c7a-e34c-44b6-a9b5-15d0c196bb6b,qwen1-14B,1720761638,1720761726,finished,1720761661,1720761726,A100-SXM4-80GB,8,1,64,896,23,65
976ce259-aec5-445f-98ac-ccacf93bf8d1,mixtral-v1-0-0711-dpo,1720761669,1720762202,finished,1720761734,1720762202,A100-SXM4-80GB,8,16,64,448,65,468
22958958-2c7d-41e8-bbf0-6c8ef1136d64,qwen1-14B,1720761819,1720761906,finished,1720761841,1720761906,A100-SXM4-80GB,8,1,64,896,22,65
cdd181b6-0f31-4821-8fb2-fec38316cedd,qwen1-14B,1720761994,1720762081,finished,1720762016,1720762081,A100-SXM4-80GB,8,1,64,896,22,65
64062362-863d-4f60-8c77-4d0054a58d0e,qwen1-14B,1720762147,1720762238,finished,1720762170,1720762238,A100-SXM4-80GB,8,1,64,896,23,68
fd67734a-a128-4a38-9340-fef26208a0de,mixtral-v1-0-0711-dpo,1720762202,1720762882,finished,1720762267,1720762882,A100-SXM4-80GB,8,16,64,448,65,615
ced753db-8966-4fe5-a44b-af64516e5a90,qwen1-14B,1720762310,1720762397,finished,1720762332,1720762397,A100-SXM4-80GB,8,1,64,896,22,65
57fb3010-7657-4508-bb88-6fa2c731c273,vae-baseline-replic,1720762447,1720848950,finished,1720762492,1720848950,A100-SXM4-80GB,8,1,64,896,45,86458
f2d558b8-6d6c-4876-beca-824d0ee93be5,qwen1-14B,1720762466,1720762553,finished,1720762488,1720762553,A100-SXM4-80GB,8,1,64,896,22,65
efe5fa7a-5ad7-4772-bbbc-df1e1b02a056,train-0710,1720762529,1720768823,finished,1720762550,1720768823,A100-SXM4-80GB,8,1,64,896,21,6273
58f9747f-1bb6-42c3-9d61-7e6ea2509fa7,qwen1-14B,1720762642,1720762735,finished,1720762666,1720762735,A100-SXM4-80GB,8,1,64,896,24,69
83a1ec49-3634-4007-8f26-aba405142b65,tq-embedding-4,1720762681,1722240974,finished,1720762704,1722240974,A100-SXM4-80GB,1,32,8,112,23,1478270
17e3e9ed-8438-419d-bb44-5afc72f43216,tq-embedding-6,1720762682,1721717589,finished,1720762704,1721717589,A100-SXM4-80GB,1,32,8,112,22,954885
7cabc9b0-2056-4701-8d0c-e48e9287a541,test-deepspeed-gpu,1720762687,1720764644,finished,1720762752,1720764644,A100-SXM4-80GB,8,2,64,896,65,1892
3fd479db-fba8-4351-8be3-1e4691b0e5eb,qwen1-14B,1720762802,1720762897,finished,1720762824,1720762897,A100-SXM4-80GB,8,1,64,896,22,73
c6a4067d-e34a-4be4-9090-869163aa22cd,llama3-8b-cpt-80k-3b-1d5b4-auto,1720762844,1721032644,finished,1720762870,1721032644,A100-SXM4-80GB,8,1,64,896,26,269774
640e968b-3a88-444c-ba78-0f37b47c4ed8,qwen1-14B,1720762987,1720763055,finished,1720763009,1720763055,A100-SXM4-80GB,8,1,64,896,22,46
3b74b30a-bae3-44da-b8e8-2067e420e6d6,mixtral-v1-0-0711-dpo,1720763018,1720763205,finished,1720763084,1720763205,A100-SXM4-80GB,8,16,64,448,66,121
041eb73d-0a5c-4f66-ba97-276d498cf4d0,qwen1-14B,1720763128,1720763219,finished,1720763150,1720763219,A100-SXM4-80GB,8,1,64,896,22,69
a501f240-b0bb-4731-a18d-c06b012f83ce,qwen1-14B,1720763308,1720763396,finished,1720763331,1720763396,A100-SXM4-80GB,8,1,64,896,23,65
c87576b5-ab7e-4a17-9088-01dc6c96a393,qwen1-14B,1720763487,1720763556,finished,1720763511,1720763556,A100-SXM4-80GB,8,1,64,896,24,45
fd8fb14f-63c0-4f42-b537-7861e8284869,tq-llm-chat-infer-1,1720763522,1720768960,finished,1720763544,1720768960,A100-SXM4-80GB,8,1,64,448,22,5416
6599058d-1161-47ff-bdec-e9cee084e2d4,mixtral-v1-0-0711-dpo,1720763564,1720763749,finished,1720763631,1720763749,A100-SXM4-80GB,8,16,64,448,67,118
66575801-530b-4602-85ef-ba03ab1f0a5f,qwen1-14B,1720763623,1720763718,finished,1720763652,1720763718,A100-SXM4-80GB,8,1,64,896,29,66
71ab94a0-b6fa-4437-8f33-dd3dddd633ac,qwen1-14B,1720763809,1720763900,finished,1720763832,1720763900,A100-SXM4-80GB,8,1,64,896,23,68
21fe0e9b-a3ce-4010-8e13-06edcf2a54bf,txchen-lm-eval2,1720763844,1720777504,finished,1720763867,1720777504,A100-SXM4-80GB,8,1,64,448,23,13637
34d5c6b7-9500-4fb1-a129-a07d1337d373,qwen1-14B,1720763969,1720764064,finished,1720763992,1720764064,A100-SXM4-80GB,8,1,64,896,23,72
e5f43622-4134-4cf4-b093-04bdfa3bb4f9,llama3-extra-infer,1720764039,1720764203,finished,1720764062,1720764203,A100-SXM4-80GB,8,1,64,448,23,141
f63461bc-1679-419b-8c67-63a1d31d55fa,mixtral-v1-0-0711-dpo,1720764072,1720764502,finished,1720764140,1720764502,A100-SXM4-80GB,8,16,64,448,68,362
9d746a86-2bee-40b7-9164-1497c4e4b59d,qwen1-14B,1720764131,1720764249,finished,1720764160,1720764249,A100-SXM4-80GB,8,1,64,896,29,89
a96343bc-254a-4c45-9a76-77d534c6d148,qwen1-14B,1720764316,1720764406,finished,1720764338,1720764406,A100-SXM4-80GB,8,1,64,896,22,68
1e6358f8-1cd9-49c4-971f-cec701fdf410,qwen1-14B,1720764494,1720764582,finished,1720764517,1720764582,A100-SXM4-80GB,8,1,64,896,23,65
316ed323-5245-4284-abce-149c08a10783,qwen1-14B,1720764671,1720764760,finished,1720764694,1720764760,A100-SXM4-80GB,8,1,64,896,23,66
133e5e7e-c5e6-4f67-b53d-c7fcd644788a,llama3-extra-infer,1720764737,1720765848,finished,1720764759,1720765848,A100-SXM4-80GB,8,1,64,448,22,1089
a29b15c2-d731-4f18-a161-acfcd3a05018,test-deepspeed-gpu,1720764822,1720765922,finished,1720764866,1720765922,A100-SXM4-80GB,8,2,64,896,44,1056
362d2119-55c9-485a-b742-05abb2b0e1d4,qwen1-14B,1720764849,1720764957,finished,1720764871,1720764957,A100-SXM4-80GB,8,1,64,896,22,86
01355812-b850-4a05-8545-540a3c58a598,qwen1-14B,1720765046,1720765134,finished,1720765068,1720765134,A100-SXM4-80GB,8,1,64,896,22,66
c50261d2-dbbb-4f37-a171-3b494f34e7d5,qwen1-14B,1720765221,1720765306,finished,1720765242,1720765306,A100-SXM4-80GB,8,1,64,896,21,64
f0c78748-cea0-4b98-b582-ffbdfb06cc9f,qwen1-14B,1720765395,1720765479,finished,1720765416,1720765479,A100-SXM4-80GB,8,1,64,896,21,63
06c776ca-df34-4e69-a4c3-8ac889ca727a,slimorca-geo-mtm1-geotable-nt-14b,1720765421,1720852413,finished,1720765443,1720852413,A100-SXM4-80GB,8,1,64,448,22,86970
f2779de1-b961-472f-b15a-1f22983fcef3,qwen1-14B,1720765557,1720765637,finished,1720765577,1720765637,A100-SXM4-80GB,8,1,64,896,20,60
cb47e2c3-5e3d-441b-b1c7-73a6bbbc1910,llama3-8b-instruct-80k-qlora-7727d-auto,1720765653,1720774817,finished,1720765673,1720774817,A100-SXM4-80GB,8,1,64,896,20,9144
2d1c5f7e-eea1-41e5-bfae-4f83b3989b1b,qwen1-14B,1720765715,1720765790,finished,1720765734,1720765790,A100-SXM4-80GB,8,1,64,896,19,56
0edcb047-7126-481c-9ce5-fba904d12b07,qwen1-14B,1720765870,1720765946,finished,1720765889,1720765946,A100-SXM4-80GB,8,1,64,896,19,57
faf09300-716f-4f9b-ab7e-5037d2c9e987,test-deepspeed-gpu,1720765922,1720766056,finished,1720765979,1720766056,A100-SXM4-80GB,8,2,64,896,57,77
c1d5c8b9-2e9b-4b0e-8aba-43dcff417739,zjllm-sci-llama-3-7b,1720765979,1720776830,finished,1720766075,1720776830,A100-SXM4-80GB,8,1,64,448,96,10755
eaed3bea-3665-461d-9848-1b0fb34af5cb,qwen1-14B,1720766022,1720766100,finished,1720766041,1720766100,A100-SXM4-80GB,8,1,64,896,19,59
a373a8e6-1fcb-4107-838c-da6e0ec9d5d7,GeoGPT-0630,1720766109,1722220988,finished,1720766132,1722220988,A100-SXM4-80GB,8,1,64,448,23,1454856
f8657cfb-3598-4b2f-aeaa-b37769bed570,llama-actsave,1720766122,1720766502,finished,1720766142,1720766502,A100-SXM4-80GB,8,1,64,448,20,360
a1af2e87-cc55-4613-b414-3c434e0a21b1,qwen1-14B,1720766182,1720766282,finished,1720766202,1720766282,A100-SXM4-80GB,8,1,64,896,20,80
d8752f87-27af-41e6-b528-47c642361b20,llama-factory-zj-test,1720766281,1720767089,finished,1720766323,1720767089,A100-SXM4-80GB,8,4,64,896,42,766
ce5ee40c-1bee-46e7-9537-c46c5a40612a,tq-embedding-4,1720766335,1721032788,finished,1720766355,1721032788,A100-SXM4-80GB,8,1,64,448,20,266433
e94b81fc-b547-42b5-bd47-7a9c33ec9771,qwen1-14B,1720766364,1720766441,finished,1720766383,1720766441,A100-SXM4-80GB,8,1,64,896,19,58
68e66910-e077-4988-8bb4-93c9aceafb59,test,1720766459,1720766931,finished,1720766519,1720766931,A100-SXM4-80GB,8,2,64,896,60,412
ab8debad-c61b-4a07-9283-abe30af9c920,qwen1-14B,1720766520,1720766598,finished,1720766540,1720766598,A100-SXM4-80GB,8,1,64,896,20,58
38e233ee-5a09-4258-8b68-b5d798a92d59,llama-actsave,1720766637,1720767287,finished,1720766657,1720767287,A100-SXM4-80GB,8,1,64,448,20,630
f98c4217-61dd-47c6-9b64-c3a9d454bd01,qwen1-14B,1720766676,1720766753,finished,1720766695,1720766753,A100-SXM4-80GB,8,1,64,896,19,58
c96cb382-ee23-4fc4-97bb-c09efd83aafd,qwen1-14B,1720766831,1720766912,finished,1720766850,1720766912,A100-SXM4-80GB,8,1,64,896,19,62
514bb576-bcf1-432f-8f32-9e46f27db1ba,geo-base-offline-eval,1720766873,1720779481,finished,1720766893,1720779481,A100-SXM4-80GB,8,1,64,448,20,12588
9096950f-9ec3-4d5c-8725-3c883dfca0d7,geogpt-cot-train-cp-r1,1720766900,1720774174,finished,1720766920,1720774174,A100-SXM4-80GB,8,1,64,896,20,7254
bfecfe47-6059-403e-bfb7-d8902925c7f9,qwen1-14B,1720766991,1720767071,finished,1720767010,1720767071,A100-SXM4-80GB,8,1,64,896,19,61
5e31c789-2297-4f6a-8369-260684dae6e7,qwen2-72b-instruct-judge,1720767059,1721614523,finished,1720767080,1721614523,A100-SXM4-80GB,8,1,64,448,21,847443
68ecdc50-d85d-4e0d-a803-910cedb2866f,llama-factory-zj-test,1720767089,1720767890,finished,1720767149,1720767890,A100-SXM4-80GB,8,4,64,896,60,741
e32a5a54-b1b2-449a-828c-16ddbf136337,qwen1-14B,1720767150,1720767228,finished,1720767170,1720767228,A100-SXM4-80GB,8,1,64,896,20,58
af93c632-3dbb-4eb2-808a-bb5a842f0498,qwen1-14B,1720767306,1720767384,finished,1720767325,1720767384,A100-SXM4-80GB,8,1,64,896,19,59
b26324bf-88d0-4f06-b143-d2167b44a7ff,qwen1-14B,1720767463,1720767565,finished,1720767483,1720767565,A100-SXM4-80GB,8,1,64,896,20,82
185d5409-37fa-40b1-813a-22c02c5194fc,flash,1720767482,1720767584,finished,1720767523,1720767584,A100-SXM4-80GB,8,2,64,896,41,61
3d51d944-ad88-4ef3-abee-35b600702649,lzk-qwen15-7b-scihub-abstract-hw-2stage,1720767555,1720770027,finished,1720767576,1720770027,A100-SXM4-80GB,8,1,64,448,21,2451
772edc46-a743-40d8-9bde-43ec1a0865b3,qwen1-14B,1720767648,1720767729,finished,1720767668,1720767729,A100-SXM4-80GB,8,1,64,896,20,61
f1d6e549-6960-4dc9-9190-0421d54543fa,flash,1720767727,1720767930,finished,1720767787,1720767930,A100-SXM4-80GB,8,2,64,896,60,143
9465dc72-fa20-4ffd-815d-7999793c4e88,qwen1-14B,1720767809,1720767891,finished,1720767830,1720767891,A100-SXM4-80GB,8,1,64,896,21,61
0fa87638-c831-4559-9408-b279f53f09df,test-deepspeed-gpu,1720767825,1720779373,finished,1720771383,1720779373,A100-SXM4-80GB,8,2,64,896,3558,7990
f7b10b5f-7dd3-4a79-84df-aeadf9be918d,llama-factory-zj-test,1720767890,1720768867,finished,1720767930,1720768867,A100-SXM4-80GB,8,4,64,896,40,937
6cb1c823-98f2-4018-bdda-a909e7e11a6a,qwen1-14B,1720767972,1720768053,finished,1720767992,1720768053,A100-SXM4-80GB,8,1,64,896,20,61
afb5fc4c-d093-432b-9efc-bb93a40a4daf,qwen1-14B,1720768133,1720768214,finished,1720768152,1720768214,A100-SXM4-80GB,8,1,64,896,19,62
d9f8e6a2-a72d-4c3d-95eb-457f789d85dc,llama-actsave,1720768193,1720768553,finished,1720768215,1720768553,A100-SXM4-80GB,8,1,64,448,22,338
da1d5cbd-5536-490f-b499-b68d700f6477,flash,1720768212,1720768413,finished,1720768274,1720768413,A100-SXM4-80GB,8,2,64,896,62,139
30d3e984-4412-4f3e-89ba-b102f111c9ca,llama3-extra-infer,1720768212,1720783126,finished,1720768233,1720783126,A100-SXM4-80GB,8,1,64,448,21,14893
0aceb4da-45e1-4415-86f3-47c6dab1e948,qwen1-14B,1720768295,1720768376,finished,1720768315,1720768376,A100-SXM4-80GB,8,1,64,896,20,61
4248738a-e942-487b-bc7a-da432eb461bc,qwen1-14B,1720768455,1720768533,finished,1720768474,1720768533,A100-SXM4-80GB,8,1,64,896,19,59
a434aeec-e5b8-465a-b8b3-97ceec0bfb66,qwen1-14B,1720768611,1720768690,finished,1720768630,1720768690,A100-SXM4-80GB,8,1,64,896,19,60
f585a7b8-07ac-465c-8be2-cf64427d2914,sfr-ft-2,1720768628,1720769328,finished,1720768649,1720769328,A100-SXM4-80GB,8,1,64,448,21,679
bcf8b0a2-c4e2-4c8c-8f5f-a741a8f48430,llama-actsave,1720768631,1720769268,finished,1720768651,1720769268,A100-SXM4-80GB,8,1,64,448,20,617
bf2fb540-df51-4f3e-ad18-43a13a051a7d,qwen1-14B,1720768768,1720768849,finished,1720768787,1720768849,A100-SXM4-80GB,8,1,64,896,19,62
a7f43cdb-f0d5-4771-8d9d-d9380e7a97db,train-0710,1720768823,1720768926,finished,1720768845,1720768926,A100-SXM4-80GB,8,1,64,896,22,81
f84f9e51-eb08-4ca4-b0b3-ac47124c3b57,flash,1720768847,1720769047,finished,1720768908,1720769047,A100-SXM4-80GB,8,2,64,896,61,139
72e6bfc4-2e22-4f8c-93b3-40d20fc0f4ae,llama-factory-zj-test,1720768867,1720769722,finished,1720768908,1720769722,A100-SXM4-80GB,8,4,64,896,41,814
aec5c914-82e3-41c7-8ac3-9e7d82739b44,qwen1-14B,1720768910,1720768989,finished,1720768930,1720768989,A100-SXM4-80GB,8,1,64,896,20,59
fbc87087-41ee-4563-81a4-8b2fa1401e3b,train-0710,1720768966,1720769623,finished,1720768986,1720769623,A100-SXM4-80GB,8,1,64,896,20,637
835805a5-a7b7-401b-9889-531ecd7a7fe6,geogpt-cot-eval-cp-r1,1720769057,1720769216,finished,1720769078,1720769216,A100-SXM4-80GB,8,1,64,896,21,138
5bd9d09c-796e-447b-878e-8306d35018a0,qwen1-14B,1720769070,1720769170,finished,1720769090,1720769170,A100-SXM4-80GB,8,1,64,896,20,80
7355a62e-ddf5-417d-b896-ee577db3cc50,flash,1720769148,1720769348,finished,1720769207,1720769348,A100-SXM4-80GB,8,2,64,896,59,141
4405ab65-4e0b-4f3c-9a23-17dc00c844af,qwen1-14B,1720769249,1720769330,finished,1720769268,1720769330,A100-SXM4-80GB,8,1,64,896,19,62
9974dc66-b323-4b14-8214-e8f0a0b14c68,llama-actsave,1720769310,1720769847,finished,1720769330,1720769847,A100-SXM4-80GB,8,1,64,448,20,517
6771352f-a02d-4858-8564-0687cbf25c91,qwen2-72b-instruct-extra-128k-2186a-auto,1720769326,1720777946,finished,1720769346,1720777946,A100-SXM4-80GB,8,1,64,896,20,8600
eb839dc3-2a19-4f2e-8597-864f20848024,geogpt-cot-eval-cp-r1,1720769338,1720769792,finished,1720769357,1720769792,A100-SXM4-80GB,8,1,64,896,19,435
87b97c24-5157-48bf-b6e8-79720aea3353,qwen1-14B,1720769408,1720769486,finished,1720769427,1720769486,A100-SXM4-80GB,8,1,64,896,19,59
ef636f81-f8d6-4bf7-8096-8e56904f2fbb,geogpt-7b-lp40-s2-sft-1-8m,1720769472,1720770538,finished,1720769536,1720770538,A100-SXM4-80GB,8,4,64,448,64,1002
9397afb6-d8c7-470b-8f07-7bb436ed897b,geogpt-prompt-tuning-tg-infer2,1720769519,1720850647,finished,1720847442,1720850647,A100-SXM4-80GB,8,1,64,448,77923,3205
f08a87d2-8914-4961-ba4b-c7514061d9bf,geogpt-prompt-tuning-tg-infer1,1720769540,1720853440,finished,1720850666,1720853440,A100-SXM4-80GB,8,1,64,448,81126,2774
e17813a3-8d48-45f3-b884-1e33930efffd,qwen1-14B,1720769569,1720769645,finished,1720769588,1720769645,A100-SXM4-80GB,8,1,64,896,19,57
62fa5f8e-93ab-4caa-82e6-75b8ea97bd61,flash,1720769605,1720769824,finished,1720769682,1720769824,A100-SXM4-80GB,8,2,64,896,77,142
43f03587-ce02-4928-8386-d41fed2f1583,qwen1-14B,1720769704,1720769783,finished,1720769724,1720769783,A100-SXM4-80GB,8,1,64,896,20,59
f9117bb1-a176-4770-a4fa-fc78e08cd2ed,llama-factory-zj-test,1720769722,1720770431,finished,1720769761,1720770431,A100-SXM4-80GB,8,4,64,896,39,670
0c64bb94-8aaf-434e-8e19-ee8ad46bb784,train-0710,1720769760,1720770410,finished,1720769780,1720770410,A100-SXM4-80GB,8,1,64,896,20,630
a42cf2c7-f244-4fc8-8e5d-a9bbbfec8b53,sft-80wc-magpie-qwen2-mpyc-zh-mpyc-llama3-8b,1720769788,1720856240,finished,1720769830,1720856240,A100-SXM4-80GB,8,4,64,448,42,86410
e08cf154-352c-4391-918e-29e742fe3ffb,flash,1720769803,1720770035,finished,1720769886,1720770035,A100-SXM4-80GB,8,2,64,896,83,149
19917c93-d176-411d-86ea-20a704007905,qwen1-14B,1720769867,1720769973,finished,1720769887,1720769973,A100-SXM4-80GB,8,1,64,896,20,86
bbac0044-52c2-4585-80c4-16aa63ceb1bd,llama-actsave,1720769929,1720770314,finished,1720769952,1720770314,A100-SXM4-80GB,8,1,64,448,23,362
2bf865bd-e52a-4676-ac76-45de28e63864,mixtral-v1-0-0711-dpo,1720769958,1720770359,finished,1720770021,1720770359,A100-SXM4-80GB,8,8,64,448,63,338
093a2dda-3c15-44c6-83f5-9dc4387d7d33,qwen1-14B,1720770056,1720770136,finished,1720770076,1720770136,A100-SXM4-80GB,8,1,64,896,20,60
e6691000-e824-489a-91f8-5b719d991024,qwen1-14B,1720770215,1720770313,finished,1720770235,1720770313,A100-SXM4-80GB,8,1,64,896,20,78
f30d7cd9-697a-4e0a-8998-65d4b1be3e6c,qwen1-14B,1720770392,1720770471,finished,1720770413,1720770471,A100-SXM4-80GB,8,1,64,896,21,58
79aa3fde-a666-489b-9312-1258f76b85f9,llama-actsave,1720770394,1720771450,finished,1720770414,1720771450,A100-SXM4-80GB,8,1,64,448,20,1036
f5603cc9-7568-4347-b6dd-2b929b537556,llama-factory-zj-test,1720770431,1720772057,finished,1720770489,1720772057,A100-SXM4-80GB,8,4,64,896,58,1568
d4ed5558-b517-427e-b149-ecf42ace7f59,qwen1-14B,1720770551,1720770631,finished,1720770570,1720770631,A100-SXM4-80GB,8,1,64,896,19,61
fa4601fd-60c4-410c-905b-f0ec89c14575,flash,1720770589,1720770831,finished,1720770649,1720770831,A100-SXM4-80GB,8,2,64,896,60,182
abf30f30-8c7c-46f8-88f8-05789f0e6940,qwen1-14B,1720770709,1720770789,finished,1720770728,1720770789,A100-SXM4-80GB,8,1,64,896,19,61
3d32a0ee-49cc-43be-88a7-04e2fea7adf5,geogpt-7b-lp40-s2-sft-1-8m,1720770736,1720791048,finished,1720770795,1720791048,A100-SXM4-80GB,8,4,64,448,59,20253
4f51f239-c8b4-4e74-af42-f6c5013483f2,zero1-debug,1720770796,1720778523,finished,1720770859,1720778523,A100-SXM4-80GB,8,2,64,448,63,7664
d35346e1-2e7f-4ef3-98c7-52d59af46170,zero3-debug,1720770818,1720770956,finished,1720770879,1720770956,A100-SXM4-80GB,8,2,64,448,61,77
53639de1-b014-4236-a22c-30abe7fbc49c,flash,1720770831,1720771170,finished,1720770890,1720771170,A100-SXM4-80GB,8,2,64,896,59,280
3c40c9f8-08cd-40ab-b9f7-5f8736acea44,qwen1-14B,1720770872,1720770949,finished,1720770891,1720770949,A100-SXM4-80GB,8,1,64,896,19,58
a8c35e8a-4596-4988-bb8b-834111d2b6ec,easycontext-zj-test-cg,1720770988,1720773953,finished,1720771049,1720773953,A100-SXM4-80GB,8,4,64,896,61,2904
35d117b8-4159-480d-829a-39e24b679052,train-0710,1720771027,1720771643,finished,1720771047,1720771643,A100-SXM4-80GB,8,1,64,896,20,596
7b8cb6c2-24b4-4304-9497-2d646a18c3e2,qwen1-14B,1720771030,1720771111,finished,1720771051,1720771111,A100-SXM4-80GB,8,1,64,896,21,60
f5bca54b-b535-4b90-9781-afc401ed741f,zero3-debug,1720771098,1720778523,finished,1720771159,1720778523,A100-SXM4-80GB,8,2,64,448,61,7364
54a721c1-bdf9-469e-85ca-6280b30e479a,mixtral-v1-0-0711-dpo,1720771139,1720771476,finished,1720771179,1720771476,A100-SXM4-80GB,8,8,64,448,40,297
44c1739d-393b-4f85-b9c8-2589a2945e19,flash,1720771171,1720771566,finished,1720771234,1720771566,A100-SXM4-80GB,8,2,64,896,63,332
0a0622ba-f92c-4e57-a0e0-43f9f313191d,qwen1-14B,1720771194,1720771276,finished,1720771216,1720771276,A100-SXM4-80GB,8,1,64,896,22,60
fff6111c-5f36-4c12-a5cd-6ef847cdf7ea,geogpt-7b-chat-lp40-25bgeo,1720771243,1720790357,finished,1720771322,1720790357,A100-SXM4-80GB,8,32,64,448,79,19035
c9e4d716-a7e7-4134-b1ae-a537b10f8658,qwen1-14B,1720771368,1720771568,finished,1720771508,1720771568,A100-SXM4-80GB,8,1,64,896,140,60
3b9d1833-9d08-4440-a52e-e8dfdb57c54e,geogpt-dairui-eval-code-2,1720771391,1720772023,finished,1720771413,1720772023,A100-SXM4-80GB,8,1,64,448,22,610
d2f15042-2229-4a1c-9b37-497fa1ef080d,llama-actsave,1720771489,1720772293,finished,1720771509,1720772293,A100-SXM4-80GB,8,1,64,448,20,784
8193e5b4-88b3-4e31-8867-778b64c64671,flash,1720771566,1720772176,finished,1720771606,1720772176,A100-SXM4-80GB,8,2,64,896,40,570
8c1fc256-846e-4fb2-ac18-58a558a5a386,qwen1-14B,1720771646,1720771742,finished,1720771665,1720771742,A100-SXM4-80GB,8,1,64,896,19,77
0c4116b2-25d9-49e6-80d0-b15005f81dfd,qwen1-14B,1720771819,1720771897,finished,1720771838,1720771897,A100-SXM4-80GB,8,1,64,896,19,59
020ccc37-f2c8-455c-824a-34345817d607,llama3-70b-instruct,1720771947,1721627718,finished,1720771969,1721627718,A100-SXM4-80GB,8,1,64,448,22,855749
535a9fa3-a15a-49c9-a9fc-218e5252263b,mixtral-v1-0-0711-dpo,1720771966,1720772261,finished,1720772005,1720772261,A100-SXM4-80GB,8,8,64,448,39,256
1ae26da3-efef-4be0-9830-1b28ef98248e,qwen1-14B,1720771979,1720772059,finished,1720771998,1720772059,A100-SXM4-80GB,8,1,64,896,19,61
d269eb4a-28bf-49a2-ab8f-40bd82e5058a,geogpt-dairui-eval-code-2,1720772023,1720772775,finished,1720772042,1720772775,A100-SXM4-80GB,8,1,64,448,19,733
6de49c0c-9f2b-4e84-8235-9da3f7a362c7,qwen1-14B,1720772138,1720772234,finished,1720772157,1720772234,A100-SXM4-80GB,8,1,64,896,19,77
0c65af98-465c-4677-a98d-6bae9f578515,qwen1-14B,1720772312,1720772389,finished,1720772332,1720772389,A100-SXM4-80GB,8,1,64,896,20,57
8d518309-4e45-4834-ac7b-af3d94230037,ff,1720772467,1720772648,finished,1720772508,1720772648,A100-SXM4-80GB,8,2,64,896,41,140
e92fb8d6-7cfb-4c4a-8ae3-048ab2e4dd49,qwen1-14B,1720772469,1720772549,finished,1720772489,1720772549,A100-SXM4-80GB,8,1,64,896,20,60
b9fb7894-2e4a-4fef-b909-4fa3fbf22e31,mixtral-v1-0-0711-dpo,1720772516,1720772800,finished,1720772575,1720772800,A100-SXM4-80GB,8,8,64,448,59,225
0ab45495-00e5-4cc2-b32e-f49db893c867,qwen1-14B,1720772629,1720772708,finished,1720772649,1720772708,A100-SXM4-80GB,8,1,64,896,20,59
1bfc2d8d-67d2-47da-89cb-70bc0fed20de,flash,1720772770,1720773365,finished,1720772831,1720773365,A100-SXM4-80GB,8,2,64,896,61,534
fbde7646-1859-473e-aa7b-c513651b9332,qwen1-14B,1720772771,1720772852,finished,1720772793,1720772852,A100-SXM4-80GB,8,1,64,896,22,59
b5d3c601-af8b-4384-aff1-d1f9dc072b7a,llama-actsave,1720772772,1720773832,finished,1720772793,1720773832,A100-SXM4-80GB,8,1,64,448,21,1039
396b034d-0785-4f80-90a8-57e7df97cc81,geogpt-dairui-eval-code-2,1720772775,1720773633,finished,1720772796,1720773633,A100-SXM4-80GB,8,1,64,448,21,837
4f68b7dc-62fc-465a-bd8a-4159a31de6f5,geogpt-cot-eval-cp-r1,1720772801,1720774544,finished,1720772821,1720774544,A100-SXM4-80GB,8,1,64,896,20,1723
8ccf3c1d-f357-4e40-9134-ef9717d70702,qwen1-14B,1720772930,1720773008,finished,1720772950,1720773008,A100-SXM4-80GB,8,1,64,896,20,58
d6c03453-b2a9-4cf7-bc44-146c4676b412,qwen1-14B,1720773086,1720773166,finished,1720773106,1720773166,A100-SXM4-80GB,8,1,64,896,20,60
74d640df-97ff-4f9b-b466-ca1097ddcaaa,geo-sae-test,1720773169,1720775446,finished,1720773654,1720775446,A100-SXM4-80GB,8,1,64,896,485,1792
77aee04f-ed99-418c-a578-93f70579d48b,qwen1-14B,1720773246,1720773327,finished,1720773266,1720773327,A100-SXM4-80GB,8,1,64,896,20,61
5304ac1e-b7aa-49e2-8936-8b6d10a0da49,mixtral-v1-0-0711-dpo,1720773253,1720773552,finished,1720773311,1720773552,A100-SXM4-80GB,8,8,64,448,58,241
ff03c9a7-7020-496b-9ef3-fb8d2c2ab1da,qwen1-14B,1720773407,1720773486,finished,1720773427,1720773486,A100-SXM4-80GB,8,1,64,896,20,59
34e79db8-a3d0-4070-83a4-62b4e711cbfc,flash,1720773464,1720773710,finished,1720773543,1720773710,A100-SXM4-80GB,8,2,64,896,79,167
9c77f4b2-ca9f-4055-83bc-cec6f5946247,qwen1-14B,1720773565,1720773650,finished,1720773586,1720773650,A100-SXM4-80GB,8,1,64,896,21,64
bcac7a7b-0980-47cb-9688-2eba01aa0f43,lzk-qwen15-7b-scihub-abstract-hw-2stage,1720773575,1720797550,finished,1720777524,1720797550,A100-SXM4-80GB,8,1,64,448,3949,20026
84cb9384-f343-4c51-8aa5-73bb6bf1df62,lf-llama3-8b-ins-sft-dyn-test,1720773730,1720778796,finished,1720773791,1720778796,A100-SXM4-80GB,8,2,64,448,61,5005
ad4cb444-3d2f-4612-b45c-5521c0fba560,qwen1-14B,1720773731,1720773812,finished,1720773752,1720773812,A100-SXM4-80GB,8,1,64,896,21,60
b6eec0aa-981a-4eb7-a124-3ba9cc11f75c,flash,1720773791,1720773994,finished,1720773830,1720773994,A100-SXM4-80GB,8,2,64,896,39,164
f82cbf14-b279-4dc7-85de-4857e3b56459,qwen1-14B,1720773893,1720773996,finished,1720773913,1720773996,A100-SXM4-80GB,8,1,64,896,20,83
a45c1555-1036-455d-84b2-085c0f836eb9,train-0710,1720773972,1720774614,finished,1720773992,1720774614,A100-SXM4-80GB,8,1,64,896,20,622
ae0fd6ee-78ec-4266-b2f2-b68a97ae7b33,llama-actsave,1720773976,1720774353,finished,1720773996,1720774353,A100-SXM4-80GB,8,1,64,448,20,357
f68d09b1-b85b-4a63-87b2-95fccd31e8f0,qwen1-14B,1720774077,1720774165,finished,1720774099,1720774165,A100-SXM4-80GB,8,1,64,896,22,66
e43a825d-8522-42d7-be03-1795d693da8b,ff,1720774098,1720774291,finished,1720774164,1720774291,A100-SXM4-80GB,8,2,64,896,66,127
ce6b7d0c-d7d5-42cc-bd45-b9480223d85a,lzk-qwen15-7b-scihub-abstract-homework-sft,1720774113,1720811656,finished,1720791578,1720811656,A100-SXM4-80GB,8,1,64,448,17465,20078
3dac35d3-3f31-4737-9556-5097b985d059,lzk-qwen15-7b-scihub-abstract-homework-cpt,1720774134,1720805397,finished,1720775473,1720805397,A100-SXM4-80GB,8,1,64,448,1339,29924
ba4742c6-b1ff-4f6e-abee-961a1361696a,mixtral-v1-0-0711-dpo,1720774215,1720774502,finished,1720774256,1720774502,A100-SXM4-80GB,8,8,64,448,41,246
0dcb54a7-013c-49f0-a3b8-e1d4f9afd3e9,qwen1-14B,1720774249,1720774353,finished,1720774272,1720774353,A100-SXM4-80GB,8,1,64,896,23,81
dfbb7b39-43d5-4a3c-a186-c4d3636361b8,txchen-train-task,1720774424,1720805919,finished,1720799799,1720805919,A100-SXM4-80GB,8,1,64,896,25375,6120
ee6b16d4-88f5-40b1-90bb-114a85ea23ac,qwen1-14B,1720774435,1720774536,finished,1720774455,1720774536,A100-SXM4-80GB,8,1,64,896,20,81
f0c69b13-f978-405e-a177-23e929b96e3c,qwen1-14B,1720774617,1720774697,finished,1720774637,1720774697,A100-SXM4-80GB,8,1,64,896,20,60
17d9b9e1-30d0-49b4-8760-0b6684b6fd7c,qwen1-14B,1720774778,1720774860,finished,1720774799,1720774860,A100-SXM4-80GB,8,1,64,896,21,61
1046a522-c340-41b6-a0da-5bbd6aa11426,llama-actsave,1720774779,1720775180,finished,1720774799,1720775180,A100-SXM4-80GB,8,1,64,448,20,381
f05c0d51-cfad-49df-a71a-1df491a333da,qwen1-14B,1720774941,1720775020,finished,1720774961,1720775020,A100-SXM4-80GB,8,1,64,896,20,59
7eb40127-301e-4365-822e-805af2458bf0,geogpt-cot-train-cp-r1,1720775069,1720781950,finished,1720775089,1720781950,A100-SXM4-80GB,8,1,64,896,20,6861
4932951a-5541-4db5-8091-2624d1b024c0,train-0710,1720775078,1720776041,finished,1720775098,1720776041,A100-SXM4-80GB,8,1,64,896,20,943
28b55fe8-bc88-4a0d-b6c2-3596f369dfe0,qwen1-14B,1720775101,1720775180,finished,1720775120,1720775180,A100-SXM4-80GB,8,1,64,896,19,60
49ef60bb-7183-4fa1-863f-d231b6eb4153,qwen1-14B,1720775259,1720775341,finished,1720775280,1720775341,A100-SXM4-80GB,8,1,64,896,21,61
caab89bc-b311-4392-bf13-e7494c1df436,geogpt-dairui-eval-code-2,1720775284,1721104211,finished,1720786418,1721104211,A100-SXM4-80GB,8,1,64,448,11134,317793
71333624-7b9d-4cc8-b3d0-de0f00adb6aa,mixtral-v1-0-0711-dpo,1720775368,1720775549,finished,1720775428,1720775549,A100-SXM4-80GB,8,8,64,448,60,121
e026ba4f-3699-4992-a650-1e0fc759f0cd,qwen1-14B,1720775420,1720775502,finished,1720775443,1720775502,A100-SXM4-80GB,8,1,64,896,23,59
0abce8e2-d14f-4267-9821-08a89b225fc7,qwen1-14B,1720775580,1720775679,finished,1720775600,1720775679,A100-SXM4-80GB,8,1,64,896,20,79
d20439ad-7575-4951-9a1f-0909fa19f0f7,qwen1-14B,1720775757,1720775837,finished,1720775777,1720775837,A100-SXM4-80GB,8,1,64,896,20,60
1378dfd6-7b05-432f-b67c-265f338e675d,llama-actsave,1720775838,1720776205,finished,1720775859,1720776205,A100-SXM4-80GB,8,1,64,448,21,346
14f1de9a-6cf8-4ea9-b13f-598bc82038d8,mixtral-v1-0-0711-dpo,1720775888,1720776233,finished,1720775947,1720776233,A100-SXM4-80GB,8,8,64,448,59,286
43147315-e887-4675-b043-1185d4318648,qwen1-14B,1720775921,1720776002,finished,1720775940,1720776002,A100-SXM4-80GB,8,1,64,896,19,62
99f427dd-69d9-4831-b9c3-e2f24b9b9ce0,train-0710,1720776042,1720780459,finished,1720776062,1720780459,A100-SXM4-80GB,8,1,64,896,20,4397
cf910633-1d3d-4f7b-bed1-778e2f39e8d8,geo-seesaw-qwen05b-single-task-02,1720776048,1720799770,finished,1720797562,1720799770,A100-SXM4-80GB,8,1,64,896,21514,2208
6af23571-11c6-4555-9a2c-1be6e990992f,qwen1-14B,1720776085,1720776164,finished,1720776105,1720776164,A100-SXM4-80GB,8,1,64,896,20,59
7d1f50fb-70cf-42f0-b03b-100e5c4e5646,qwen1-14B,1720776247,1720776332,finished,1720776267,1720776332,A100-SXM4-80GB,8,1,64,896,20,65
7c988a05-c6ea-4977-8fd3-dc1fb3f03f27,mixtral-v1-0-0711-dpo,1720776275,1720776665,finished,1720776340,1720776665,A100-SXM4-80GB,8,8,64,448,65,325
80a2c316-730e-4e3e-9f7f-d30c8c2ac706,flash,1720776288,1720776676,finished,1720776331,1720776676,A100-SXM4-80GB,8,2,64,896,43,345
5bd58db7-8ede-437f-bbba-420ca8b786e7,reranker-base,1720776307,1720949280,finished,1720776330,1720949280,A100-SXM4-80GB,8,1,64,896,23,172950
e8517787-1d98-4772-8ea0-8f545f8e7c75,reranker-inference11,1720776308,1720949280,finished,1720776330,1720949280,A100-SXM4-80GB,8,1,64,448,22,172950
f6ca3a46-00f2-4e7c-8328-e1033c66d10f,llama-actsave,1720776312,1720776855,finished,1720776332,1720776855,A100-SXM4-80GB,8,1,64,448,20,523
a57f42f3-d732-4a74-850c-2eef33ddeca5,qwen1-14B,1720776414,1720776495,finished,1720776436,1720776495,A100-SXM4-80GB,8,1,64,896,22,59
319a4216-f789-49bf-973d-59274c6d4ff2,qwen1-14B,1720776578,1720776658,finished,1720776598,1720776658,A100-SXM4-80GB,8,1,64,896,20,60
6488d4e0-b178-4001-b6d9-2e56d391f45e,geogpt-cot-eval-cp-r1,1720776606,1720777363,finished,1720776626,1720777363,A100-SXM4-80GB,8,1,64,896,20,737
b2647839-67e3-4c13-84ea-02a277ec9d38,qwen1-14B,1720776736,1720776834,finished,1720776756,1720776834,A100-SXM4-80GB,8,1,64,896,20,78
ec3c304e-1471-462f-9446-4f16144e5c5c,qwen1-14B,1720776915,1720776992,finished,1720776934,1720776992,A100-SXM4-80GB,8,1,64,896,19,58
5ef7fa8c-149f-4c5d-9540-b2a62996603b,qwen1-14B,1720777072,1720777151,finished,1720777091,1720777151,A100-SXM4-80GB,8,1,64,896,19,60
e31852a4-fbf4-4bf3-921c-d76506a8c586,qwen1-14B,1720777233,1720777316,finished,1720777255,1720777316,A100-SXM4-80GB,8,1,64,896,22,61
ca3762c9-fb5c-40be-9a40-a7b55ac2b3a5,mixtral-v1-0-0711-dpo,1720777262,1720777697,finished,1720777300,1720777697,A100-SXM4-80GB,8,8,64,448,38,397
79094c87-71e5-44c0-9dc2-a32746ada36d,qwen1-14B,1720777396,1720777474,finished,1720777416,1720777474,A100-SXM4-80GB,8,1,64,896,20,58
ce29c50e-4696-4f1d-b4f7-c52e5fe5fde1,qwen1-14B,1720777553,1720777652,finished,1720777573,1720777652,A100-SXM4-80GB,8,1,64,896,20,79
a31a1854-3dd2-4f9f-875c-9746d7ccdcea,qwen1-14B,1720777731,1720777812,finished,1720777750,1720777812,A100-SXM4-80GB,8,1,64,896,19,62
c704433b-1b7e-4e7c-a422-bcc77c463bae,geogpt-cot-eval-cp-r1,1720777819,1720778563,finished,1720777839,1720778563,A100-SXM4-80GB,8,1,64,896,20,724
03417c1b-9621-4809-bd61-c593466e53b7,qwen1-14B,1720777891,1720777988,finished,1720777910,1720777988,A100-SXM4-80GB,8,1,64,896,19,78
e50b0e7a-537a-4ee5-9a89-66b1563a559d,qwen1-14B,1720778068,1720778146,finished,1720778087,1720778146,A100-SXM4-80GB,8,1,64,896,19,59
6928cfff-d662-4475-a089-284c8c0be20c,mixtral-v1-0-0711-dpo,1720778195,1720789056,finished,1720778235,1720789056,A100-SXM4-80GB,8,8,64,448,40,10821
4844f56d-ba16-4a2a-9cf9-f8bf9d76a4ec,qwen1-14B,1720778228,1720778309,finished,1720778250,1720778309,A100-SXM4-80GB,8,1,64,896,22,59
f755dd53-7a0e-43d4-9525-af60fd85297d,qwen1-14B,1720778389,1720778475,finished,1720778410,1720778475,A100-SXM4-80GB,8,1,64,896,21,65
30ad8733-f6f5-4670-8ef6-a9a33a8d6485,qwen1-14B,1720778556,1720778635,finished,1720778576,1720778635,A100-SXM4-80GB,8,1,64,896,20,59
6b62ab28-74c1-404f-85d5-9f4a9976ccc8,qwen1-14B,1720778717,1720778817,finished,1720778737,1720778817,A100-SXM4-80GB,8,1,64,896,20,80
3e7f219a-bab7-458a-95fa-8dc3f89aa579,lf-llama3-8b-ins-sft-dyn-test,1720778796,1720779017,finished,1720778856,1720779017,A100-SXM4-80GB,8,2,64,448,60,161
0fcc49b7-a90e-46a4-a2e6-8b7f198b8ce3,qwen1-14B,1720778897,1720778978,finished,1720778917,1720778978,A100-SXM4-80GB,8,1,64,896,20,61
0d434d74-cffa-41d3-9f96-ed98d2b2fefe,qwen2-72b-chat,1720778919,1721298074,finished,1720778940,1721298074,A100-SXM4-80GB,8,1,64,448,21,519134
adeacef3-cb33-4d26-be49-1c3f3aaa1bff,qwen1-14B,1720779059,1720779139,finished,1720779080,1720779139,A100-SXM4-80GB,8,1,64,896,21,59
c58a306d-697b-4d7b-8d4a-4fad2f8498e1,qwen1-14B,1720779218,1720779318,finished,1720779237,1720779318,A100-SXM4-80GB,8,1,64,896,19,81
c454f92c-5713-4cab-a93f-f8fc9e33060b,geogpt-cot-eval-cp-r1,1720779244,1720780086,finished,1720779265,1720780086,A100-SXM4-80GB,8,1,64,896,21,821
9a396add-f04e-4523-9350-415a89663b7b,qwen1-14B,1720779400,1720779478,finished,1720779420,1720779478,A100-SXM4-80GB,8,1,64,896,20,58
b73933fb-48ee-4ba3-acb6-2c1711a739b5,lf-llama3-8b-ins-sft-dyn-test,1720779418,1720782224,finished,1720779477,1720782224,A100-SXM4-80GB,8,2,64,448,59,2747
4ba5ab08-467d-4e13-816c-c849232a1ccc,qwen1-14B,1720779557,1720779657,finished,1720779577,1720779657,A100-SXM4-80GB,8,1,64,896,20,80
1589076e-6719-48df-8899-df21682a1bba,qwen1-14B,1720779739,1720779837,finished,1720779758,1720779837,A100-SXM4-80GB,8,1,64,896,19,79
47e02e5d-093e-4ddc-9da0-62a93b464b21,qwen1-14B,1720779917,1720780000,finished,1720779938,1720780000,A100-SXM4-80GB,8,1,64,896,21,62
efa09ccf-5d46-4e07-9d0f-177d6b089b79,qwen1-14B,1720780078,1720780157,finished,1720780098,1720780157,A100-SXM4-80GB,8,1,64,896,20,59
08bc0577-55a6-480f-9bd5-0253e295334a,qwen1-14B,1720780240,1720780341,finished,1720780259,1720780341,A100-SXM4-80GB,8,1,64,896,19,82
f217d674-2770-4101-ad84-ad5e7963f5f6,qwen1-14B,1720780421,1720780502,finished,1720780441,1720780502,A100-SXM4-80GB,8,1,64,896,20,61
2a1c9827-81fa-4e50-9eb4-7a41ac6024b5,geogpt-cot-eval-cp-r1,1720780449,1720781152,finished,1720780470,1720781152,A100-SXM4-80GB,8,1,64,896,21,682
49d62e92-808e-4c6b-85a3-f66b760fd066,train-0710,1720780459,1720782542,finished,1720780479,1720782542,A100-SXM4-80GB,8,1,64,896,20,2063
614d2d79-8d6b-47af-b950-450b4eaa5712,qwen1-14B,1720780582,1720780662,finished,1720780602,1720780662,A100-SXM4-80GB,8,1,64,896,20,60
5c4fdc84-ce6e-481d-8305-849f3394316a,qwen1-14B,1720780741,1720780840,finished,1720780761,1720780840,A100-SXM4-80GB,8,1,64,896,20,79
5f056149-f5ed-4773-bd8b-5ae7f81afa2f,geogpt-cot-train-cp-r1-back,1720780909,1720788187,finished,1720780931,1720788187,A100-SXM4-80GB,8,1,64,896,22,7256
25a98ff9-8001-48c8-b3a6-e112d82fb9d8,qwen1-14B,1720780923,1720781003,finished,1720780943,1720781003,A100-SXM4-80GB,8,1,64,896,20,60
425ed858-5eb0-4825-bc2e-bcb43fd74d12,qwen1-14B,1720781083,1720781165,finished,1720781104,1720781165,A100-SXM4-80GB,8,1,64,896,21,61
b9575b4e-45a9-4bfa-b8f1-73cb6a1b3a00,qwen1-14B,1720781244,1720781322,finished,1720781264,1720781322,A100-SXM4-80GB,8,1,64,896,20,58
e4291135-5398-4263-83e6-02352f6eb00f,qwen1-14B,1720781402,1720781481,finished,1720781422,1720781481,A100-SXM4-80GB,8,1,64,896,20,59
fc82e6c7-ce85-4346-a433-fb249322b0be,qwen1-14B,1720781560,1720781659,finished,1720781580,1720781659,A100-SXM4-80GB,8,1,64,896,20,79
0aad12a6-5c51-466e-9b6f-9ab946b429bc,qwen1-14B,1720781742,1720781821,finished,1720781762,1720781821,A100-SXM4-80GB,8,1,64,896,20,59
af940708-30af-4df4-aca3-3c49bb3ce3b9,qwen1-14B,1720781903,1720781983,finished,1720781922,1720781983,A100-SXM4-80GB,8,1,64,896,19,61
901dcc3d-125e-4b23-9b28-e76ad91e2bea,qwen1-14B,1720782064,1720782144,finished,1720782084,1720782144,A100-SXM4-80GB,8,1,64,896,20,60
e8a3b8e5-3057-4f3d-a1c5-5aaddf540c5a,qwen1-14B,1720782206,1720782285,finished,1720782226,1720782285,A100-SXM4-80GB,8,1,64,896,20,59
82e09ef3-9579-4cd9-92eb-d08bc41184a2,lf-llama3-8b-ins-sft-dyn-test,1720782224,1720786103,finished,1720782283,1720786103,A100-SXM4-80GB,8,2,64,448,59,3820
0f3cba41-d18a-499f-8114-e4d1bbc73508,geogpt-cot-eval-cp-r1,1720782334,1720783033,finished,1720782354,1720783033,A100-SXM4-80GB,8,1,64,896,20,679
e2b6f89d-9b1a-44f8-bdb9-4557d7636a99,qwen1-14B,1720782367,1720782465,finished,1720782387,1720782465,A100-SXM4-80GB,8,1,64,896,20,78
a98ebb18-93db-47e2-b8df-6fc87ef1f543,qwen1-14B,1720782545,1720782625,finished,1720782565,1720782625,A100-SXM4-80GB,8,1,64,896,20,60
f4f9f56a-2433-4686-945c-1c40b4474ece,qwen1-14B,1720782706,1720782786,finished,1720782726,1720782786,A100-SXM4-80GB,8,1,64,896,20,60
06b4d8fc-baab-4b7b-8deb-c60f0555357a,train-0710,1720782723,1720838412,finished,1720782744,1720838412,A100-SXM4-80GB,8,1,64,896,21,55668
d54abb6d-64c4-4cff-913f-f6a40a1cc57b,qwen1-14B,1720782866,1720782945,finished,1720782886,1720782945,A100-SXM4-80GB,8,1,64,896,20,59
f97210bb-ec6b-430f-bc31-9e2060822052,qwen1-14B,1720783025,1720783105,finished,1720783045,1720783105,A100-SXM4-80GB,8,1,64,896,20,60
90539479-b77a-4354-83bc-f4bcd24d858b,sparsity-0-19-dp-q72b-chat-10c82-auto,1720783152,1720795389,finished,1720783179,1720795389,A100-SXM4-80GB,8,1,64,448,27,12210
03ef5e2c-29d1-4408-a724-5ea2105af22c,sparsity-10-19-dp-q72b-chat-7a00b-auto,1720783155,1720795389,finished,1720783179,1720795389,A100-SXM4-80GB,8,1,64,448,24,12210
b14a2cc7-3080-4854-9002-b2c5d6fd0f1e,sparsity-0-18-dp-q72b-chat-a93f3-auto,1720783157,1720795205,finished,1720783179,1720795205,A100-SXM4-80GB,8,1,64,448,22,12026
b1440513-42d3-4606-93b9-1823900030c3,sparsity-10-18-dp-q72b-chat-194ec-auto,1720783159,1720795247,finished,1720783179,1720795247,A100-SXM4-80GB,8,1,64,448,20,12068
a24b61b1-7be3-45f7-976b-db9c3a7d8c6d,qwen1-14B,1720783196,1720783297,finished,1720783216,1720783297,A100-SXM4-80GB,8,1,64,896,20,81
50045e3d-abf0-4563-9b61-34f4da59246c,geogpt-ultrafuser-direct-eval,1720783220,1720799146,finished,1720783241,1720799146,A100-SXM4-80GB,8,1,64,448,21,15905
e36b4e5f-647a-407e-9e0a-2767bfff3b9f,qwen1-14B,1720783376,1720783455,finished,1720783396,1720783455,A100-SXM4-80GB,8,1,64,896,20,59
f6b77281-ebbf-4b45-889f-381511b19404,qwen1-14B,1720783534,1720783615,finished,1720783554,1720783615,A100-SXM4-80GB,8,1,64,896,20,61
ffc97a75-f858-4ea9-a28f-35383e4bee21,geogpt-cot-eval-cp-r1,1720783643,1720784340,finished,1720783664,1720784340,A100-SXM4-80GB,8,1,64,896,21,676
57b0a721-7581-41fb-8995-5cb26428b6cf,qwen1-14B,1720783696,1720783798,finished,1720783715,1720783798,A100-SXM4-80GB,8,1,64,896,19,83
cc780427-6c03-4d9f-a509-140ec75adef2,qwen1-14B,1720783879,1720783980,finished,1720783899,1720783980,A100-SXM4-80GB,8,1,64,896,20,81
34c67cfa-506f-4aef-9937-62e7494fac40,qwen1-14B,1720784063,1720784168,finished,1720784083,1720784168,A100-SXM4-80GB,8,1,64,896,20,85
212678fe-5315-43db-ab0f-99bd36c2654d,geogpt-finetuning-yxs,1720784157,1720847422,finished,1720847363,1720847422,A100-SXM4-80GB,8,1,64,896,63206,59
53003964-677e-4b66-b441-0c5d02140e02,qwen1-14B,1720784250,1720784332,finished,1720784271,1720784332,A100-SXM4-80GB,8,1,64,896,21,61
2d2d08a4-125e-4c96-b2d8-45c4d0bfa4e7,qwen1-14B,1720784414,1720784495,finished,1720784435,1720784495,A100-SXM4-80GB,8,1,64,896,21,60
53f7ec5b-904b-471c-9065-8ab94a4ae340,qwen1-14B,1720784578,1720784660,finished,1720784599,1720784660,A100-SXM4-80GB,8,1,64,896,21,61
4bac2490-05a6-4cbd-b7f1-717379c1dd87,qwen1-14B,1720784740,1720784822,finished,1720784760,1720784822,A100-SXM4-80GB,8,1,64,896,20,62
1f03559c-0230-4e36-914f-f71a7dc9efd0,qwen1-14B,1720784904,1720784986,finished,1720784925,1720784986,A100-SXM4-80GB,8,1,64,896,21,61
0cb3c93e-c09e-4c96-b600-fc4ab6dbd106,qwen1-14B,1720785068,1720785150,finished,1720785088,1720785150,A100-SXM4-80GB,8,1,64,896,20,62
49fa3d7e-28d5-41e9-afb9-49b253b12d13,qwen1-14B,1720785231,1720785313,finished,1720785251,1720785313,A100-SXM4-80GB,8,1,64,896,20,62
dc26926e-9c7a-489d-af3b-4bfb8838be9f,qwen1-14B,1720785394,1720785476,finished,1720785415,1720785476,A100-SXM4-80GB,8,1,64,896,21,61
1aeca192-18a9-4696-b219-f127944c05d1,qwen1-14B,1720785559,1720785643,finished,1720785579,1720785643,A100-SXM4-80GB,8,1,64,896,20,64
3166ef5d-649f-4cf0-bf29-4db9708a1c5e,qwen1-14B,1720785729,1720785832,finished,1720785749,1720785832,A100-SXM4-80GB,8,1,64,896,20,83
bdf4f299-be98-4c8c-b2bb-de11211d04c0,test-xiaodian,1720785890,1720849905,finished,1720785912,1720849905,A100-SXM4-80GB,8,1,64,896,22,63993
1a50ac35-2df2-4b5f-b689-239d5a1c3afe,qwen1-14B,1720785917,1720785998,finished,1720785937,1720785998,A100-SXM4-80GB,8,1,64,896,20,61
2c7b2981-fe37-482f-b3e7-5fb1b5ade244,qwen1-14B,1720786084,1720786167,finished,1720786105,1720786167,A100-SXM4-80GB,8,1,64,896,21,62
8c03f886-0fa4-4a6b-8224-544f00fedd8e,geogpt-dairui-model-merge-exp-2,1720786191,1720791550,finished,1720786418,1720791550,A100-SXM4-80GB,8,1,64,448,227,5132
301c75c6-ac89-4f9d-87bf-f3a06e648eb6,qwen1-14B,1720786251,1720786353,finished,1720786271,1720786353,A100-SXM4-80GB,8,1,64,896,20,82
fb8c7ebc-74ef-47b5-8bb0-5357a0cd1440,qwen1-14B,1720786437,1720786519,finished,1720786457,1720786519,A100-SXM4-80GB,8,1,64,896,20,62
369bcd02-e6f3-404a-ab4b-2f06ef99c833,qwen1-14B,1720786600,1720786682,finished,1720786620,1720786682,A100-SXM4-80GB,8,1,64,896,20,62
ad658678-4bd8-4c59-b252-b0423ada6aa0,qwen1-14B,1720786764,1720786845,finished,1720786784,1720786845,A100-SXM4-80GB,8,1,64,896,20,61
0693621c-70c7-47bc-bd06-c4501f684c38,qwen1-14B,1720786926,1720787029,finished,1720786947,1720787029,A100-SXM4-80GB,8,1,64,896,21,82
df36e333-7668-4f45-9d7f-9b2bbadae974,lf-llama3-8b-ins-sft-dyn-test,1720787007,1720787398,finished,1720787048,1720787398,A100-SXM4-80GB,8,2,64,448,41,350
c1453537-d4c6-44d1-b4e3-c6ee72eb1fb0,qwen1-14B,1720787111,1720787193,finished,1720787132,1720787193,A100-SXM4-80GB,8,1,64,896,21,61
101c72c7-0b22-4da9-8362-c2bfdd9529e9,qwen1-14B,1720787275,1720787358,finished,1720787297,1720787358,A100-SXM4-80GB,8,1,64,896,22,61
6ce9f8c6-d46e-4d57-a7ce-c9b950cf6542,lf-llama3-8b-ins-sft-dyn-test,1720787399,1720791283,finished,1720787440,1720791283,A100-SXM4-80GB,8,2,64,448,41,3843
03a68fef-03da-4d73-9441-bbf656702df9,qwen1-14B,1720787441,1720787522,finished,1720787461,1720787522,A100-SXM4-80GB,8,1,64,896,20,61
3853304a-af9a-4ad3-9c8b-2ab558763e93,qwen1-14B,1720787606,1720787687,finished,1720787626,1720787687,A100-SXM4-80GB,8,1,64,896,20,61
5a97abc0-417e-4684-8026-7b1873215ebb,qwen1-14B,1720787770,1720787853,finished,1720787791,1720787853,A100-SXM4-80GB,8,1,64,896,21,62
e6550d33-d633-4258-9ec1-4798e13925fc,qwen1-14B,1720787936,1720788038,finished,1720787957,1720788038,A100-SXM4-80GB,8,1,64,896,21,81
3130f934-79bf-4163-b531-19db7dbe8e28,qwen1-14B,1720788119,1720788199,finished,1720788139,1720788199,A100-SXM4-80GB,8,1,64,896,20,60
e6502506-8392-4c48-a89b-138c21b9e6d4,qwen1-14B,1720788282,1720788365,finished,1720788303,1720788365,A100-SXM4-80GB,8,1,64,896,21,62
9f14b7bc-42fc-49c9-a00d-e93d3ca12318,qwen1-14B,1720788447,1720788529,finished,1720788467,1720788529,A100-SXM4-80GB,8,1,64,896,20,62
02560a37-6ef0-4718-8ae0-a81104eb9b5f,qwen1-14B,1720788612,1720788694,finished,1720788633,1720788694,A100-SXM4-80GB,8,1,64,896,21,61
c147479f-14b8-4eda-9987-ed68ec4cd006,lf-llama3-8b-pt80k-resume,1720788735,1720788964,finished,1720788798,1720788964,A100-SXM4-80GB,8,4,64,448,63,166
0b9657cd-a8fc-49ae-8ca5-da7dc365c2bd,qwen1-14B,1720788758,1720788841,finished,1720788778,1720788841,A100-SXM4-80GB,8,1,64,896,20,63
29ad3636-2f2b-4313-8680-ccf4e8f8d312,qwen1-14B,1720788923,1720789007,finished,1720788944,1720789007,A100-SXM4-80GB,8,1,64,896,21,63
bdfd8df5-d3a7-479e-b1e7-12ff810ae949,geogpt-cot-eval-cp-r1,1720788974,1720790310,finished,1720788995,1720790310,A100-SXM4-80GB,8,1,64,896,21,1315
d794dc5d-42c7-4b74-bc40-edde2f369fa8,qwen1-14B,1720789089,1720789172,finished,1720789110,1720789172,A100-SXM4-80GB,8,1,64,896,21,62
078aef5b-ab3e-4be0-9a6d-28a101bafd85,qwen1-14B,1720789252,1720789335,finished,1720789273,1720789335,A100-SXM4-80GB,8,1,64,896,21,62
79c3eb49-bd8c-4318-a8fd-a0315b317269,qwen1-14B,1720789416,1720789498,finished,1720789436,1720789498,A100-SXM4-80GB,8,1,64,896,20,62
ac6720db-db5c-40e1-a492-5031937c76c0,qwen1-14B,1720789581,1720789663,finished,1720789602,1720789663,A100-SXM4-80GB,8,1,64,896,21,61
b5880ecc-cd12-4507-8466-07502dc79ac5,qwen1-14B,1720789744,1720789826,finished,1720789765,1720789826,A100-SXM4-80GB,8,1,64,896,21,61
fee58f66-bbdd-4da4-a0df-4683a81f5b00,train-0712,1720789906,1720790591,finished,1720789927,1720790591,A100-SXM4-80GB,8,1,64,896,21,664
1f2799ac-daee-476e-8c90-bb4fd86ddd22,qwen1-14B,1720789909,1720789990,finished,1720789930,1720789990,A100-SXM4-80GB,8,1,64,896,21,60
d376e285-0f60-45d1-81ad-a6c17119c604,qwen1-14B,1720790071,1720790154,finished,1720790092,1720790154,A100-SXM4-80GB,8,1,64,896,21,62
6cb07eb4-6f79-45a1-9b8b-f2d6cab9fcdf,qwen1-14B,1720790236,1720790323,finished,1720790255,1720790323,A100-SXM4-80GB,8,1,64,896,19,68
f962163a-6ae0-401f-b6ad-21f32876c92d,qwen1-14B,1720790410,1720790491,finished,1720790430,1720790491,A100-SXM4-80GB,8,1,64,896,20,61
7293108c-6ec8-4f10-a0e4-af1f97522c94,qwen1-14B,1720790574,1720790657,finished,1720790595,1720790657,A100-SXM4-80GB,8,1,64,896,21,62
6c058626-ae7b-4903-96b9-88ff192da383,train-0712,1720790592,1720838391,finished,1720790613,1720838391,A100-SXM4-80GB,8,1,64,896,21,47778
da1537c1-2de5-46b1-97ff-3d4ed6616e9d,qwen1-14B,1720790737,1720790819,finished,1720790758,1720790819,A100-SXM4-80GB,8,1,64,896,21,61
a0a81926-c929-4359-9d23-2d61a061c4a1,qwen1-14B,1720790899,1720790980,finished,1720790919,1720790980,A100-SXM4-80GB,8,1,64,896,20,61
60daf8a2-05b2-4afc-96ab-980339346055,qwen1-14B,1720791061,1720791143,finished,1720791081,1720791143,A100-SXM4-80GB,8,1,64,896,20,62
499b0cc1-2a71-4024-8951-e27107c02052,qwen1-14B,1720791224,1720791304,finished,1720791245,1720791304,A100-SXM4-80GB,8,1,64,896,21,59
c58be8d9-6f5c-4466-9f7a-53053a6ca9e3,qwen1-14B,1720791386,1720791467,finished,1720791406,1720791467,A100-SXM4-80GB,8,1,64,896,20,61
c9f5719f-594b-4249-8683-0954ece0767e,qwen1-14B,1720791547,1720791608,finished,1720791567,1720791608,A100-SXM4-80GB,8,1,64,896,20,41
fdd4fa36-c5b2-4999-b369-0e9daf06c172,qwen1-14B,1720791688,1720791769,finished,1720791708,1720791769,A100-SXM4-80GB,8,1,64,896,20,61
16496b63-71ec-4005-828b-dcdd0eaa9e82,qwen1-14B,1720791850,1720791929,finished,1720791870,1720791929,A100-SXM4-80GB,8,1,64,896,20,59
d86e910a-83ef-46b0-85f8-54ca65c79608,qwen1-14B,1720792010,1720792091,finished,1720792030,1720792091,A100-SXM4-80GB,8,1,64,896,20,61
11d9273f-003a-4215-b97a-7907c5e2d80d,qwen1-14B,1720792173,1720792253,finished,1720792193,1720792253,A100-SXM4-80GB,8,1,64,896,20,60
10cf7d5a-659c-4ca3-b9d9-080461fe89b3,qwen1-14B,1720792334,1720792416,finished,1720792354,1720792416,A100-SXM4-80GB,8,1,64,896,20,62
3e15766b-57c0-4c06-b1ed-b531243fc828,qwen1-14B,1720792496,1720792577,finished,1720792517,1720792577,A100-SXM4-80GB,8,1,64,896,21,60
d904af3b-6c77-4bd0-bd32-cb875ae4fc6a,qwen1-14B,1720792658,1720792739,finished,1720792678,1720792739,A100-SXM4-80GB,8,1,64,896,20,61
a85e4066-d05b-427c-a474-aceac44046e1,qwen1-14B,1720792821,1720792923,finished,1720792841,1720792923,A100-SXM4-80GB,8,1,64,896,20,82
8c01c015-9775-475a-84c9-1bdb3b499e64,qwen1-14B,1720793017,1720793097,finished,1720793037,1720793097,A100-SXM4-80GB,8,1,64,896,20,60
c1fd7a88-05d0-4215-ba77-2f4ae99fc924,qwen1-14B,1720793188,1720793283,finished,1720793212,1720793283,A100-SXM4-80GB,8,1,64,896,24,71
ca7f65b1-f7d2-4d87-bdef-773253bd27d9,qwen1-14B,1720793367,1720793447,finished,1720793387,1720793447,A100-SXM4-80GB,8,1,64,896,20,60
f7a9af7e-832d-4fca-9bd7-e21648cd1b31,qwen1-14B,1720793526,1720793607,finished,1720793546,1720793607,A100-SXM4-80GB,8,1,64,896,20,61
3b6c37e1-65b1-4a83-970d-018f7bad1503,qwen1-14B,1720793686,1720793768,finished,1720793706,1720793768,A100-SXM4-80GB,8,1,64,896,20,62
6d19b892-2501-4a9e-9bdc-c47ede2875ec,qwen1-14B,1720793848,1720793949,finished,1720793868,1720793949,A100-SXM4-80GB,8,1,64,896,20,81
00300c2b-2b20-48d6-abc2-528e7d42c028,qwen1-14B,1720794030,1720794110,finished,1720794049,1720794110,A100-SXM4-80GB,8,1,64,896,19,61
09b03425-ff36-4eee-a896-69a68b3a0655,qwen1-14B,1720794191,1720794272,finished,1720794211,1720794272,A100-SXM4-80GB,8,1,64,896,20,61
995df4d5-72f4-4250-8fe4-c3f826c25c8f,qwen1-14B,1720794353,1720794434,finished,1720794372,1720794434,A100-SXM4-80GB,8,1,64,896,19,62
dd603b3f-6c50-4bd7-a577-878778b722f7,qwen1-14B,1720794515,1720794625,finished,1720794535,1720794625,A100-SXM4-80GB,8,1,64,896,20,90
fe1403b2-dd62-4bb4-8b36-e19c0e32ace1,qwen1-14B,1720794709,1720794810,finished,1720794729,1720794810,A100-SXM4-80GB,8,1,64,896,20,81
82439eda-cd63-4559-984f-b1db1219c847,qwen1-14B,1720794890,1720794972,finished,1720794911,1720794972,A100-SXM4-80GB,8,1,64,896,21,61
387e4e5e-291a-422a-837e-00e72d7037b2,lf-llama3-8b-pt80k-resume,1720795034,1720795240,finished,1720795095,1720795240,A100-SXM4-80GB,8,4,64,448,61,145
616c7da9-b059-46d6-95b6-dcc4c97180a8,qwen1-14B,1720795056,1720795138,finished,1720795076,1720795138,A100-SXM4-80GB,8,1,64,896,20,62
4c654fed-0d34-430f-b9c3-cc6f54c7be84,qwen1-14B,1720795222,1720795303,finished,1720795241,1720795303,A100-SXM4-80GB,8,1,64,896,19,62
47878550-02b9-4504-bbfa-63da3b735b52,qwen1-14B,1720795385,1720795480,finished,1720795415,1720795480,A100-SXM4-80GB,8,1,64,896,30,65
59226447-e32d-4662-880e-5ea7570171b8,qwen1-14B,1720795560,1720795639,finished,1720795580,1720795639,A100-SXM4-80GB,8,1,64,896,20,59
79b35835-e60e-4ace-9811-3f6cbb570f14,qwen1-14B,1720795717,1720795796,finished,1720795736,1720795796,A100-SXM4-80GB,8,1,64,896,19,60
6322c756-3cd8-4bbf-892d-f5ba5eebdcc4,qwen1-14B,1720795875,1720795974,finished,1720795895,1720795974,A100-SXM4-80GB,8,1,64,896,20,79
ec7ac289-e39d-4872-8ee2-27380cf25062,qwen1-14B,1720796053,1720796132,finished,1720796073,1720796132,A100-SXM4-80GB,8,1,64,896,20,59
d99c24f9-73ee-42a9-b4a8-63f7952ff890,qwen1-14B,1720796210,1720796287,finished,1720796229,1720796287,A100-SXM4-80GB,8,1,64,896,19,58
efd2a9fd-b33d-405e-94af-3c63b6ebf55d,qwen1-14B,1720796367,1720796464,finished,1720796386,1720796464,A100-SXM4-80GB,8,1,64,896,19,78
87803a91-9f31-4a53-b899-020d3b04d049,qwen1-14B,1720796541,1720796619,finished,1720796560,1720796619,A100-SXM4-80GB,8,1,64,896,19,59
84e336cf-dbd0-4cd1-a90b-fe668f033d78,qwen1-14B,1720796699,1720796777,finished,1720796718,1720796777,A100-SXM4-80GB,8,1,64,896,19,59
3583877a-3982-4a0a-bc43-37023696dca7,qwen1-14B,1720796855,1720796952,finished,1720796875,1720796952,A100-SXM4-80GB,8,1,64,896,20,77
17f83032-fa6d-4656-8bc6-3c91d264d4cc,lf-llama3-8b-pt80k-resume,1720797032,1720798372,finished,1720797071,1720798372,A100-SXM4-80GB,8,4,64,448,39,1301
68433f8e-5043-43e1-baa4-b8c7a827dbf8,qwen1-14B,1720797033,1720797111,finished,1720797052,1720797111,A100-SXM4-80GB,8,1,64,896,19,59
cd5873d6-a0aa-4d32-8612-6113a9254259,qwen1-14B,1720797189,1720797267,finished,1720797208,1720797267,A100-SXM4-80GB,8,1,64,896,19,59
711f0ce0-d119-49d1-957d-b237193f5073,qwen1-14B,1720797345,1720797422,finished,1720797364,1720797422,A100-SXM4-80GB,8,1,64,896,19,58
7a7421d8-4e26-4f85-8ca7-ed1874f0cff5,qwen1-14B,1720797501,1720797599,finished,1720797520,1720797599,A100-SXM4-80GB,8,1,64,896,19,79
4c66cab0-3e8b-478c-9019-8a83947738d4,qwen1-14B,1720797678,1720797756,finished,1720797697,1720797756,A100-SXM4-80GB,8,1,64,896,19,59
28feb0ff-27fb-4be3-8384-8267f5b34221,qwen1-14B,1720797837,1720797936,finished,1720797857,1720797936,A100-SXM4-80GB,8,1,64,896,20,79
3ada56e2-6aad-42f5-a219-afbcaaa20a89,qwen1-14B,1720798014,1720798092,finished,1720798034,1720798092,A100-SXM4-80GB,8,1,64,896,20,58
fed2f786-c572-4516-a0b1-862f1530a107,qwen1-14B,1720798170,1720798252,finished,1720798189,1720798252,A100-SXM4-80GB,8,1,64,896,19,63
739f4a83-36b5-4b18-a2a2-a508c14c07c4,sparsity-9-dp-0612-2ba59-auto,1720798215,1720809706,finished,1720798236,1720809706,A100-SXM4-80GB,8,1,64,448,21,11470
93870677-719e-49f2-8120-133551ac200e,sparsity-8-dp-0612-fc84b-auto,1720798237,1720809864,finished,1720798257,1720809864,A100-SXM4-80GB,8,1,64,448,20,11607
bbeca371-f27c-45b8-9c3c-8c125c4d32ad,sparsity-0-18-dp-0612-9d460-auto,1720798258,1720813048,finished,1720798278,1720813048,A100-SXM4-80GB,8,1,64,448,20,14770
e947b660-ebf5-47af-9bdb-8654058d4905,qwen1-14B,1720798334,1720798413,finished,1720798354,1720798413,A100-SXM4-80GB,8,1,64,896,20,59
1cee58d2-d538-4897-988d-deed17a12103,qwen1-14B,1720798492,1720798592,finished,1720798512,1720798592,A100-SXM4-80GB,8,1,64,896,20,80
db30bd1c-31a7-4e45-a880-754d7817c4ce,qwen1-14B,1720798673,1720798751,finished,1720798692,1720798751,A100-SXM4-80GB,8,1,64,896,19,59
3b96bbae-1bc9-4559-919b-112942c3276d,sparsity-10-18-dp-0612-6458c-auto,1720798815,1720813428,finished,1720798836,1720813428,A100-SXM4-80GB,8,1,64,448,21,14592
1ae972d4-4447-46b7-848e-7fcb8649db3a,qwen1-14B,1720798831,1720798913,finished,1720798851,1720798913,A100-SXM4-80GB,8,1,64,896,20,62
5c5bd689-4244-454c-9550-dd8486d26ba3,sparsity-10-18-dp-0612-2d73a-auto,1720798939,1720815127,finished,1720798960,1720815127,A100-SXM4-80GB,8,1,64,448,21,16167
8e359ba0-6fcf-4473-9c1a-b2eafe62c2de,qwen1-14B,1720798997,1720799079,finished,1720799017,1720799079,A100-SXM4-80GB,8,1,64,896,20,62
15c09356-a433-4a8f-89df-e9c311c87971,sparsity-10-18-dp-q72b-chat-4ff78-auto,1720799105,1720802399,finished,1720799124,1720802399,A100-SXM4-80GB,8,1,64,448,19,3275
68bc2128-4dda-4631-9924-68a697336da9,qwen1-14B,1720799162,1720799243,finished,1720799182,1720799243,A100-SXM4-80GB,8,1,64,896,20,61
b7b9840f-95ea-4a57-84c0-55730eefa4f4,qwen1-14B,1720799322,1720799403,finished,1720799343,1720799403,A100-SXM4-80GB,8,1,64,896,21,60
acc37af3-ca1c-4cd9-9379-9ca2418ab131,qwen1-14B,1720799484,1720799585,finished,1720799504,1720799585,A100-SXM4-80GB,8,1,64,896,20,81
4b2230a0-e595-4b06-aaaa-e74d7a7d3965,qwen1-14B,1720799667,1720799747,finished,1720799686,1720799747,A100-SXM4-80GB,8,1,64,896,19,61
bb8bbaf3-af75-492e-91f0-a9df2a9d6660,qwen1-14B,1720799829,1720799912,finished,1720799850,1720799912,A100-SXM4-80GB,8,1,64,896,21,62
6dfc3e91-513f-4fc0-b8cf-b55e8ed6de0d,qwen1-14B,1720799994,1720800080,finished,1720800018,1720800080,A100-SXM4-80GB,8,1,64,896,24,62
01776f20-645b-41b2-878e-a1b92dea9ff2,qwen1-14B,1720800161,1720800243,finished,1720800182,1720800243,A100-SXM4-80GB,8,1,64,896,21,61
c1796fca-f33d-43ba-980c-e6d87a219bf5,qwen1-14B,1720800327,1720800436,finished,1720800350,1720800436,A100-SXM4-80GB,8,1,64,896,23,86
a67eeb80-989a-4647-917c-5d44198fc15d,geogpt-lxz-2-9m-mix-data-llama3-8b,1720800331,1720898598,finished,1720800396,1720898598,A100-SXM4-80GB,8,8,64,448,65,98202
238cad88-563e-417b-94c9-8e5aaf432dd9,qwen1-14B,1720800517,1720800599,finished,1720800538,1720800599,A100-SXM4-80GB,8,1,64,896,21,61
25738f37-49e3-4c26-a309-dd35f4b7add4,qwen1-14B,1720800679,1720800760,finished,1720800700,1720800760,A100-SXM4-80GB,8,1,64,896,21,60
5e6e8776-7f05-44da-b91a-6d47671da5e2,qwen1-14B,1720800842,1720800943,finished,1720800863,1720800943,A100-SXM4-80GB,8,1,64,896,21,80
8f0b53bb-0a0e-4f2d-a0de-73f225c73b93,qwen1-14B,1720801025,1720801106,finished,1720801045,1720801106,A100-SXM4-80GB,8,1,64,896,20,61
13da8088-2e30-48f4-ac1d-710c921e8456,qwen1-14B,1720801189,1720801291,finished,1720801210,1720801291,A100-SXM4-80GB,8,1,64,896,21,81
731d9201-4ad2-4cc3-8175-12f423d50c67,qwen1-14B,1720801374,1720801457,finished,1720801395,1720801457,A100-SXM4-80GB,8,1,64,896,21,62
4968a6b9-bba9-4992-b031-cfdba35ee371,qwen1-14B,1720801538,1720801620,finished,1720801559,1720801620,A100-SXM4-80GB,8,1,64,896,21,61
8f2bcb1a-34c0-4c1e-9603-2438d32018f9,qwen1-14B,1720801702,1720801783,finished,1720801722,1720801783,A100-SXM4-80GB,8,1,64,896,20,61
510e7f39-cdef-409f-8a4c-73c429328b37,qwen1-14B,1720801864,1720801945,finished,1720801884,1720801945,A100-SXM4-80GB,8,1,64,896,20,61
ee9c0c98-d621-4956-b1a4-b236a5e2c810,qwen1-14B,1720802026,1720802108,finished,1720802046,1720802108,A100-SXM4-80GB,8,1,64,896,20,62
7a056372-aaf2-4d08-a4d3-616c07d2067c,qwen1-14B,1720802188,1720802271,finished,1720802209,1720802271,A100-SXM4-80GB,8,1,64,896,21,62
df5537a3-9952-4202-a5ae-e44cd87d6098,qwen1-14B,1720802353,1720802436,finished,1720802375,1720802436,A100-SXM4-80GB,8,1,64,896,22,61
31fc072d-b20c-4359-86d1-cae8a125b2d9,qwen1-14B,1720802516,1720802597,finished,1720802536,1720802597,A100-SXM4-80GB,8,1,64,896,20,61
09dfb4c7-0841-4a50-b00f-f02597e2bc14,qwen1-14B,1720802678,1720802759,finished,1720802698,1720802759,A100-SXM4-80GB,8,1,64,896,20,61
93d8870e-a4f0-4eed-96e4-802987715c21,qwen1-14B,1720802839,1720802921,finished,1720802859,1720802921,A100-SXM4-80GB,8,1,64,896,20,62
36475a17-cd8d-48db-9094-92f622a71acc,qwen1-14B,1720803002,1720803084,finished,1720803022,1720803084,A100-SXM4-80GB,8,1,64,896,20,62
b6a5b80f-c02a-40cc-b44e-5978fcfe7f49,qwen1-14B,1720803165,1720803245,finished,1720803185,1720803245,A100-SXM4-80GB,8,1,64,896,20,60
52b9a5a5-4b73-484c-a52b-ab333668c047,qwen1-14B,1720803325,1720803404,finished,1720803345,1720803404,A100-SXM4-80GB,8,1,64,896,20,59
d5595579-a4be-4c0d-945f-cca5a338ee35,qwen1-14B,1720803484,1720803567,finished,1720803504,1720803567,A100-SXM4-80GB,8,1,64,896,20,63
3f5814d8-385b-4309-a027-f20a6893666f,qwen1-14B,1720803648,1720803729,finished,1720803668,1720803729,A100-SXM4-80GB,8,1,64,896,20,61
e9a83f5b-247b-4b00-b470-c8646992dd59,qwen1-14B,1720803810,1720803911,finished,1720803830,1720803911,A100-SXM4-80GB,8,1,64,896,20,81
89155c5c-6a76-4fe3-94a2-2e418b0a7f35,llama3-8b-pt32k,1720803972,1720839631,finished,1720804033,1720839631,A100-SXM4-80GB,8,4,64,448,61,35598
a83d1a7b-6711-4c4a-84a1-d5a660f6f266,qwen1-14B,1720803973,1720804076,finished,1720803993,1720804076,A100-SXM4-80GB,8,1,64,896,20,83
e42469ee-5475-4a23-9169-1cf9125594fc,lf-llama3-8b-pt80k-resume,1720804096,1720804299,finished,1720804158,1720804299,A100-SXM4-80GB,8,4,64,448,62,141
efa0d59d-4cff-4378-b86c-024e3589dc70,qwen1-14B,1720804160,1720804241,finished,1720804180,1720804241,A100-SXM4-80GB,8,1,64,896,20,61
f05afe5e-7031-40e4-8895-88d3c28a5780,qwen1-14B,1720804320,1720804400,finished,1720804340,1720804400,A100-SXM4-80GB,8,1,64,896,20,60
8aa499d6-50f7-4826-965b-77791c7484f3,qwen1-14B,1720804481,1720804561,finished,1720804501,1720804561,A100-SXM4-80GB,8,1,64,896,20,60
9aa11972-6ebc-451a-bebf-a0b2cd007969,qwen1-14B,1720804642,1720804722,finished,1720804662,1720804722,A100-SXM4-80GB,8,1,64,896,20,60
389f421a-8325-428a-83e9-79fc43b6bbdc,qwen1-14B,1720804802,1720804883,finished,1720804821,1720804883,A100-SXM4-80GB,8,1,64,896,19,62
addfdfa9-6033-4bad-8e61-3dc42d236883,qwen1-14B,1720804964,1720805066,finished,1720804985,1720805066,A100-SXM4-80GB,8,1,64,896,21,81
0e9699c4-b018-4172-9c55-2be51607f392,qwen1-14B,1720805146,1720805245,finished,1720805166,1720805245,A100-SXM4-80GB,8,1,64,896,20,79
f993111f-262e-41e8-af3b-c9ac5e5d8953,qwen1-14B,1720805326,1720805406,finished,1720805346,1720805406,A100-SXM4-80GB,8,1,64,896,20,60
242f34c1-8908-417f-a084-6b604398f3ea,qwen1-14B,1720805486,1720805586,finished,1720805506,1720805586,A100-SXM4-80GB,8,1,64,896,20,80
85191cc4-3b05-4165-a85b-0c9c8f7f32ec,qwen1-14B,1720805666,1720805745,finished,1720805686,1720805745,A100-SXM4-80GB,8,1,64,896,20,59
96c79e66-5b67-4dd0-8875-d73d25b729ce,qwen1-14B,1720805827,1720805909,finished,1720805847,1720805909,A100-SXM4-80GB,8,1,64,896,20,62
cd07baff-64b7-47ab-824d-6ffe6496d4b8,qwen1-14B,1720805990,1720806070,finished,1720806010,1720806070,A100-SXM4-80GB,8,1,64,896,20,60
013c30dd-b18b-46dd-b452-9b306648d5a7,qwen1-14B,1720806152,1720806232,finished,1720806172,1720806232,A100-SXM4-80GB,8,1,64,896,20,60
53f8e4bc-1bf6-44b9-82b2-44a1bfe07d76,qwen1-14B,1720806312,1720806393,finished,1720806332,1720806393,A100-SXM4-80GB,8,1,64,896,20,61
6c91fb80-39c5-4683-bc9f-ee21444fcb47,qwen1-14B,1720806472,1720806553,finished,1720806492,1720806553,A100-SXM4-80GB,8,1,64,896,20,61
1a088239-5772-4b69-a6bf-aae68a5b23f7,qwen1-14B,1720806634,1720806714,finished,1720806654,1720806714,A100-SXM4-80GB,8,1,64,896,20,60
28b1d51a-f4be-45bf-a33e-16b4a3ab821a,qwen1-14B,1720806795,1720806874,finished,1720806815,1720806874,A100-SXM4-80GB,8,1,64,896,20,59
060b5602-0327-4ef2-81ef-e2ccb78d0b76,qwen1-14B,1720806954,1720807032,finished,1720806973,1720807032,A100-SXM4-80GB,8,1,64,896,19,59
93de6bd5-ee41-4c22-8e2b-a49b485b4c70,qwen1-14B,1720807110,1720807192,finished,1720807131,1720807192,A100-SXM4-80GB,8,1,64,896,21,61
1f0cc587-9251-4909-8de3-b20b0fc4f3d9,qwen1-14B,1720807273,1720807353,finished,1720807293,1720807353,A100-SXM4-80GB,8,1,64,896,20,60
8fab0fc3-f098-428e-bf1c-d72d05417f41,qwen1-14B,1720807435,1720807516,finished,1720807456,1720807516,A100-SXM4-80GB,8,1,64,896,21,60
43befea3-23a6-42e3-ae3a-9b3760aad14a,qwen1-14B,1720807597,1720807677,finished,1720807616,1720807677,A100-SXM4-80GB,8,1,64,896,19,61
cd5c9600-e4e7-4fc3-965f-a239a21d5e35,qwen1-14B,1720807757,1720807838,finished,1720807777,1720807838,A100-SXM4-80GB,8,1,64,896,20,61
0a3e99c5-39f3-41f9-8082-db43187ff488,qwen1-14B,1720807918,1720807999,finished,1720807938,1720807999,A100-SXM4-80GB,8,1,64,896,20,61
e633ebc0-71d0-4c9b-9a81-9d291064f6a1,qwen1-14B,1720808080,1720808161,finished,1720808101,1720808161,A100-SXM4-80GB,8,1,64,896,21,60
5ede4db2-72e5-4222-9e03-c758cc5578af,qwen1-14B,1720808241,1720808322,finished,1720808262,1720808322,A100-SXM4-80GB,8,1,64,896,21,60
977e52d7-40dd-478b-b641-8265c18a236a,qwen1-14B,1720808403,1720808484,finished,1720808423,1720808484,A100-SXM4-80GB,8,1,64,896,20,61
0ffb3957-9de1-4103-ae7b-82d76f6e76c2,qwen1-14B,1720808563,1720808642,finished,1720808583,1720808642,A100-SXM4-80GB,8,1,64,896,20,59
21ef189d-cbeb-4f53-9860-109b36a18909,qwen1-14B,1720808720,1720808819,finished,1720808739,1720808819,A100-SXM4-80GB,8,1,64,896,19,80
f6ebd0a4-d887-4e4f-9cab-ad7a59347122,qwen1-14B,1720808897,1720808978,finished,1720808917,1720808978,A100-SXM4-80GB,8,1,64,896,20,61
33923e80-f2df-4ce5-b000-6490adf60c83,qwen1-14B,1720809058,1720809138,finished,1720809079,1720809138,A100-SXM4-80GB,8,1,64,896,21,59
1270bdd7-07d9-4d8a-a448-e0c68ed7e79c,qwen1-14B,1720809219,1720809299,finished,1720809239,1720809299,A100-SXM4-80GB,8,1,64,896,20,60
a87ac962-be30-48fc-9fbd-97c32d20d4bb,qwen1-14B,1720809379,1720809458,finished,1720809400,1720809458,A100-SXM4-80GB,8,1,64,896,21,58
9e64d589-3eb8-4d6b-a5f3-63b9c343bdfa,qwen1-14B,1720809539,1720809620,finished,1720809560,1720809620,A100-SXM4-80GB,8,1,64,896,21,60
4b5a0ef6-5a3a-4681-8f19-7782f2f52dc9,qwen1-14B,1720809702,1720809783,finished,1720809722,1720809783,A100-SXM4-80GB,8,1,64,896,20,61
5c65085b-3a50-460b-8318-af6817ad8a14,qwen1-14B,1720809860,1720809940,finished,1720809881,1720809940,A100-SXM4-80GB,8,1,64,896,21,59
25815d7b-2602-4716-9845-224e45c0273d,qwen1-14B,1720810020,1720810119,finished,1720810040,1720810119,A100-SXM4-80GB,8,1,64,896,20,79
727e1cc5-1abc-4533-a667-48f75d48a5c4,qwen1-14B,1720810198,1720810278,finished,1720810218,1720810278,A100-SXM4-80GB,8,1,64,896,20,60
f9553c3b-d69a-47d4-a419-5f481ba8f83b,qwen1-14B,1720810358,1720810456,finished,1720810377,1720810456,A100-SXM4-80GB,8,1,64,896,19,79
825bdd32-770e-428f-9470-cb01b0b92759,qwen1-14B,1720810536,1720810615,finished,1720810556,1720810615,A100-SXM4-80GB,8,1,64,896,20,59
542ebaa2-ae1b-482a-b5c4-8a92b60d8bdc,qwen1-14B,1720810693,1720810772,finished,1720810712,1720810772,A100-SXM4-80GB,8,1,64,896,19,60
0812842f-daef-49f5-9831-58cf35100931,qwen1-14B,1720810851,1720810931,finished,1720810870,1720810931,A100-SXM4-80GB,8,1,64,896,19,61
44b38f19-78c3-44f9-aeff-3c216834b0a0,qwen1-14B,1720811010,1720811090,finished,1720811031,1720811090,A100-SXM4-80GB,8,1,64,896,21,59
de64d1f4-e23c-49a3-a9bc-f4fe614af431,qwen1-14B,1720811168,1720811247,finished,1720811188,1720811247,A100-SXM4-80GB,8,1,64,896,20,59
b9e77577-954e-4987-b2d3-852c8f83620e,qwen1-14B,1720811328,1720811407,finished,1720811348,1720811407,A100-SXM4-80GB,8,1,64,896,20,59
c3044966-f745-4550-bcb5-b23a939bdccf,qwen1-14B,1720811485,1720811566,finished,1720811505,1720811566,A100-SXM4-80GB,8,1,64,896,20,61
92fea51f-3cdc-442b-9227-adfeee757d90,qwen1-14B,1720811645,1720811746,finished,1720811666,1720811746,A100-SXM4-80GB,8,1,64,896,21,80
ca5a2bbf-43d0-4308-be6d-f63300b60355,qwen1-14B,1720811826,1720811907,finished,1720811847,1720811907,A100-SXM4-80GB,8,1,64,896,21,60
425668c2-685b-464a-a8b5-cea70cd8274e,qwen1-14B,1720811987,1720812067,finished,1720812007,1720812067,A100-SXM4-80GB,8,1,64,896,20,60
cad1b362-3468-49a8-aaa5-4adc4c07f487,qwen1-14B,1720812146,1720812245,finished,1720812166,1720812245,A100-SXM4-80GB,8,1,64,896,20,79
e8c14a9c-155f-48e5-8724-0caa6814d3cf,qwen1-14B,1720812324,1720812405,finished,1720812344,1720812405,A100-SXM4-80GB,8,1,64,896,20,61
4a6d8423-5feb-4274-a08f-90029ed9a2a9,qwen1-14B,1720812484,1720812564,finished,1720812504,1720812564,A100-SXM4-80GB,8,1,64,896,20,60
e02a3e11-e46b-4a69-96a9-c239a22114dd,qwen1-14B,1720812644,1720812724,finished,1720812664,1720812724,A100-SXM4-80GB,8,1,64,896,20,60
3e6b496e-821d-470f-8dd8-7ef5b3faa125,qwen1-14B,1720812806,1720812884,finished,1720812825,1720812884,A100-SXM4-80GB,8,1,64,896,19,59
a18584c5-77d9-4636-831d-85883b770858,qwen1-14B,1720812964,1720813043,finished,1720812984,1720813043,A100-SXM4-80GB,8,1,64,896,20,59
67925df1-5bf5-4073-be27-3914d34ea221,qwen1-14B,1720813123,1720813223,finished,1720813143,1720813223,A100-SXM4-80GB,8,1,64,896,20,80
2d11a2f8-25da-485e-b0a1-dd23d6a3796b,qwen1-14B,1720813303,1720813383,finished,1720813323,1720813383,A100-SXM4-80GB,8,1,64,896,20,60
17710757-e925-4f5e-9694-234df717bb2c,qwen1-14B,1720813463,1720813541,finished,1720813483,1720813541,A100-SXM4-80GB,8,1,64,896,20,58
ec1af8c9-b4ad-479a-9972-8a41096001c4,qwen1-14B,1720813620,1720813700,finished,1720813640,1720813700,A100-SXM4-80GB,8,1,64,896,20,60
66c36d11-7aca-458e-a4f4-d6ba0bef0b02,qwen1-14B,1720813779,1720813858,finished,1720813799,1720813858,A100-SXM4-80GB,8,1,64,896,20,59
f2d19ea6-303a-4a30-b900-3329e9d5a3ae,qwen1-14B,1720813937,1720814016,finished,1720813956,1720814016,A100-SXM4-80GB,8,1,64,896,19,60
0859fc31-ec8a-4817-b0e9-b992808896d9,qwen1-14B,1720814096,1720814195,finished,1720814116,1720814195,A100-SXM4-80GB,8,1,64,896,20,79
dd8d5d2f-36dd-4f93-b900-a7fc38a77d82,qwen1-14B,1720814275,1720814353,finished,1720814294,1720814353,A100-SXM4-80GB,8,1,64,896,19,59
3f691c49-2ede-4e21-b091-4a498c5c1557,qwen1-14B,1720814433,1720814533,finished,1720814452,1720814533,A100-SXM4-80GB,8,1,64,896,19,81
5c4b568a-5cec-4e38-9ad5-f6ca0e7c4441,qwen1-14B,1720814611,1720814690,finished,1720814631,1720814690,A100-SXM4-80GB,8,1,64,896,20,59
739cd3a2-dc55-4c36-af8b-43b3cd594a9f,qwen1-14B,1720814768,1720814846,finished,1720814788,1720814846,A100-SXM4-80GB,8,1,64,896,20,58
133dc6c5-420b-4228-bb23-8f181402b7b0,qwen1-14B,1720814926,1720815004,finished,1720814945,1720815004,A100-SXM4-80GB,8,1,64,896,19,59
ef4c5e70-3f45-4538-8679-e4828d140bf3,qwen1-14B,1720815084,1720815163,finished,1720815103,1720815163,A100-SXM4-80GB,8,1,64,896,19,60
e15d5b92-8ded-4baa-9a19-9d3a04b71a30,qwen1-14B,1720815242,1720815321,finished,1720815262,1720815321,A100-SXM4-80GB,8,1,64,896,20,59
ce1d0908-9532-477b-8eab-47406b06060c,qwen1-14B,1720815399,1720815496,finished,1720815418,1720815496,A100-SXM4-80GB,8,1,64,896,19,78
eb89e929-9b83-4b38-8e3c-4b9b16e4194a,qwen1-14B,1720815574,1720815654,finished,1720815594,1720815654,A100-SXM4-80GB,8,1,64,896,20,60
d2a1d21c-bcd4-42aa-958b-0b67e9a00332,qwen1-14B,1720815733,1720815811,finished,1720815752,1720815811,A100-SXM4-80GB,8,1,64,896,19,59
896e6269-6c97-4743-9f11-d2d696983eb7,qwen1-14B,1720815889,1720815967,finished,1720815909,1720815967,A100-SXM4-80GB,8,1,64,896,20,58
a15af414-68e6-46c8-bf0b-92684bea006b,qwen1-14B,1720816047,1720816124,finished,1720816066,1720816124,A100-SXM4-80GB,8,1,64,896,19,58
c862fe1d-005f-4f87-af9b-3a5ff4508ad3,qwen1-14B,1720816203,1720816282,finished,1720816222,1720816282,A100-SXM4-80GB,8,1,64,896,19,60
61133df0-075c-46b5-8365-de0267494546,qwen1-14B,1720816362,1720816442,finished,1720816382,1720816442,A100-SXM4-80GB,8,1,64,896,20,60
29fc8f7d-0574-45e2-923a-1b4e5130b556,qwen1-14B,1720816519,1720816597,finished,1720816538,1720816597,A100-SXM4-80GB,8,1,64,896,19,59
01a81e6b-3721-48ed-b697-9cc9e9e8d79d,qwen1-14B,1720816673,1720816752,finished,1720816693,1720816752,A100-SXM4-80GB,8,1,64,896,20,59
ccfbe85b-16a7-4252-b0b4-5d664fd49746,qwen1-14B,1720816830,1720816908,finished,1720816849,1720816908,A100-SXM4-80GB,8,1,64,896,19,59
60104c72-41a6-4464-9217-fdb81a3eeb16,qwen1-14B,1720816988,1720817068,finished,1720817008,1720817068,A100-SXM4-80GB,8,1,64,896,20,60
5c9a9da2-40bd-4981-83db-c7fdf38adfbc,qwen1-14B,1720817147,1720817225,finished,1720817167,1720817225,A100-SXM4-80GB,8,1,64,896,20,58
5275952f-1dec-471c-9688-4856d85c9f10,qwen1-14B,1720817305,1720817404,finished,1720817325,1720817404,A100-SXM4-80GB,8,1,64,896,20,79
73b62e2a-e8da-4a4b-9b76-fc69ff8ed58e,qwen1-14B,1720817484,1720817562,finished,1720817503,1720817562,A100-SXM4-80GB,8,1,64,896,19,59
e85108a9-b53d-4ccc-9372-f844f85b2fc5,qwen1-14B,1720817641,1720817720,finished,1720817661,1720817720,A100-SXM4-80GB,8,1,64,896,20,59
6fbd5d2e-e4dd-48df-a42f-8d595ebf5fb1,qwen1-14B,1720817798,1720817877,finished,1720817818,1720817877,A100-SXM4-80GB,8,1,64,896,20,59
00b5f8c2-a36f-468e-b00f-d62026f35c0f,qwen1-14B,1720817956,1720818033,finished,1720817975,1720818033,A100-SXM4-80GB,8,1,64,896,19,58
b35081fe-f1eb-4518-84ac-94946c618cde,qwen1-14B,1720818111,1720818189,finished,1720818130,1720818189,A100-SXM4-80GB,8,1,64,896,19,59
8ede6895-7344-4196-b494-67b751636ae6,qwen1-14B,1720818269,1720818347,finished,1720818289,1720818347,A100-SXM4-80GB,8,1,64,896,20,58
1dd05ec1-e2fa-4858-8831-e35fa7bad575,qwen1-14B,1720818424,1720818502,finished,1720818443,1720818502,A100-SXM4-80GB,8,1,64,896,19,59
fd268a07-4731-446b-9c25-f6c584c86973,qwen1-14B,1720818581,1720818659,finished,1720818601,1720818659,A100-SXM4-80GB,8,1,64,896,20,58
001e4e66-6bfc-4bec-b010-9cf7c0e9a4af,qwen1-14B,1720818738,1720818816,finished,1720818758,1720818816,A100-SXM4-80GB,8,1,64,896,20,58
cda53817-accb-4079-80ff-07f799c0ef87,qwen1-14B,1720818894,1720818991,finished,1720818914,1720818991,A100-SXM4-80GB,8,1,64,896,20,77
cfe3bf73-ec15-437e-90ed-e1abfc415a2e,qwen1-14B,1720819069,1720819148,finished,1720819088,1720819148,A100-SXM4-80GB,8,1,64,896,19,60
5bdb3201-2fe4-40bf-8a4f-2864c278c140,qwen1-14B,1720819227,1720819323,finished,1720819246,1720819323,A100-SXM4-80GB,8,1,64,896,19,77
aea54f56-7e0e-493f-94f7-542406d9f0b5,qwen1-14B,1720819400,1720819478,finished,1720819420,1720819478,A100-SXM4-80GB,8,1,64,896,20,58
44632977-e721-4ead-9bbf-2cf1a803fbf6,qwen1-14B,1720819556,1720819635,finished,1720819575,1720819635,A100-SXM4-80GB,8,1,64,896,19,60
98fc6eac-41a0-4fdd-bedd-6b619647b390,qwen1-14B,1720819714,1720819793,finished,1720819734,1720819793,A100-SXM4-80GB,8,1,64,896,20,59
90bc6642-ba2e-420d-995b-49ff2a3e69b9,qwen1-14B,1720819871,1720819950,finished,1720819891,1720819950,A100-SXM4-80GB,8,1,64,896,20,59
88806ec5-0206-4326-bb85-ff72df1abe99,qwen1-14B,1720820029,1720820107,finished,1720820048,1720820107,A100-SXM4-80GB,8,1,64,896,19,59
74bf146b-c6b4-42af-9c1c-13827b8e5faa,qwen1-14B,1720820186,1720820265,finished,1720820206,1720820265,A100-SXM4-80GB,8,1,64,896,20,59
ce2b987b-24d2-414d-bcec-2ff5d6e0b454,qwen1-14B,1720820344,1720820422,finished,1720820364,1720820422,A100-SXM4-80GB,8,1,64,896,20,58
820e5071-e0f1-4acf-ac65-5022d9f0c6b1,qwen1-14B,1720820502,1720820581,finished,1720820522,1720820581,A100-SXM4-80GB,8,1,64,896,20,59
b6aea06e-d0e0-487e-9eab-38b9268e91e0,qwen1-14B,1720820660,1720820739,finished,1720820680,1720820739,A100-SXM4-80GB,8,1,64,896,20,59
53b181e7-9d0f-49ec-bd9f-b8dfc37e8bb0,qwen1-14B,1720820816,1720820914,finished,1720820836,1720820914,A100-SXM4-80GB,8,1,64,896,20,78
3bd6c762-e41a-421e-8009-6f76f33401f5,qwen1-14B,1720820992,1720821070,finished,1720821012,1720821070,A100-SXM4-80GB,8,1,64,896,20,58
bacf0e93-b193-4e9d-b939-e119581a4c23,qwen1-14B,1720821149,1720821226,finished,1720821169,1720821226,A100-SXM4-80GB,8,1,64,896,20,57
c8491752-0029-4e5c-82ec-5e1d50637688,qwen1-14B,1720821304,1720821403,finished,1720821324,1720821403,A100-SXM4-80GB,8,1,64,896,20,79
599ca0be-459b-455a-8819-73ad343f3a36,qwen1-14B,1720821480,1720821579,finished,1720821500,1720821579,A100-SXM4-80GB,8,1,64,896,20,79
081e6cb4-1789-4121-8b4f-2f7e6e2f80ef,qwen1-14B,1720821662,1720821741,finished,1720821682,1720821741,A100-SXM4-80GB,8,1,64,896,20,59
d471f74f-85d0-4cba-9214-6ce44f403ac1,qwen1-14B,1720821820,1720821899,finished,1720821840,1720821899,A100-SXM4-80GB,8,1,64,896,20,59
eda6af31-a468-4ba5-a44f-187f05f9634a,qwen1-14B,1720821978,1720822057,finished,1720821998,1720822057,A100-SXM4-80GB,8,1,64,896,20,59
383da989-7100-4bbc-b04e-4569de64f822,qwen1-14B,1720822135,1720822213,finished,1720822154,1720822213,A100-SXM4-80GB,8,1,64,896,19,59
16fa37b0-b57c-4e12-8d4d-bc99990ec7f9,qwen1-14B,1720822293,1720822371,finished,1720822312,1720822371,A100-SXM4-80GB,8,1,64,896,19,59
98235ed2-fe77-46ac-ace3-9216daa37103,qwen1-14B,1720822451,1720822529,finished,1720822470,1720822529,A100-SXM4-80GB,8,1,64,896,19,59
5fc8e774-5a74-4639-8bdc-78257ec9b656,qwen1-14B,1720822610,1720822709,finished,1720822630,1720822709,A100-SXM4-80GB,8,1,64,896,20,79
1e973432-e717-4eba-b742-a4cf3042bc46,qwen1-14B,1720822788,1720822866,finished,1720822808,1720822866,A100-SXM4-80GB,8,1,64,896,20,58
3da9283a-a080-4426-b920-6f537b4b024c,qwen1-14B,1720822944,1720823024,finished,1720822963,1720823024,A100-SXM4-80GB,8,1,64,896,19,61
1e8f6b09-226e-410f-8e9c-e16fe2fa4fdc,qwen1-14B,1720823103,1720823201,finished,1720823123,1720823201,A100-SXM4-80GB,8,1,64,896,20,78
bc12f862-c6cc-4cea-886a-88225763fde4,qwen1-14B,1720823278,1720823376,finished,1720823297,1720823376,A100-SXM4-80GB,8,1,64,896,19,79
1d358eac-3ba5-4246-887f-b098417cf775,qwen1-14B,1720823456,1720823534,finished,1720823476,1720823534,A100-SXM4-80GB,8,1,64,896,20,58
34a6c743-3c6c-4b74-a2c5-ba2b2cadf01d,qwen1-14B,1720823613,1720823711,finished,1720823633,1720823711,A100-SXM4-80GB,8,1,64,896,20,78
ee76de86-cb02-4239-a715-20fe6fe73b9c,qwen1-14B,1720823789,1720823869,finished,1720823809,1720823869,A100-SXM4-80GB,8,1,64,896,20,60
9907b0a9-8ff9-40b3-9cd2-48bff698f2a2,qwen1-14B,1720823947,1720824025,finished,1720823966,1720824025,A100-SXM4-80GB,8,1,64,896,19,59
a27a77ae-3b63-43be-97c4-fa8cc1aa8c8a,qwen1-14B,1720824104,1720824203,finished,1720824124,1720824203,A100-SXM4-80GB,8,1,64,896,20,79
dd70840c-c7bb-4176-a49f-1b9408775750,qwen1-14B,1720824280,1720824359,finished,1720824300,1720824359,A100-SXM4-80GB,8,1,64,896,20,59
128c69b7-c5d9-442c-84b9-fb246cccf26a,qwen1-14B,1720824439,1720824536,finished,1720824458,1720824536,A100-SXM4-80GB,8,1,64,896,19,78
5875bcce-bd64-41b2-b360-be413c0349bc,qwen1-14B,1720824614,1720824692,finished,1720824634,1720824692,A100-SXM4-80GB,8,1,64,896,20,58
7ddc8d7c-e6a9-4582-93c7-6978e0934e54,qwen1-14B,1720824772,1720824869,finished,1720824791,1720824869,A100-SXM4-80GB,8,1,64,896,19,78
388e493b-c5ae-46fa-83e9-6529df714471,qwen1-14B,1720824948,1720825028,finished,1720824968,1720825028,A100-SXM4-80GB,8,1,64,896,20,60
45682fe6-7e47-43fc-8f23-feb998a78ce2,qwen1-14B,1720825106,1720825204,finished,1720825126,1720825204,A100-SXM4-80GB,8,1,64,896,20,78
eec12f6d-3c0c-47b3-a573-b6d24afbfae0,qwen1-14B,1720825282,1720825360,finished,1720825302,1720825360,A100-SXM4-80GB,8,1,64,896,20,58
d58e22bc-20f3-4019-ad54-67d686da9825,qwen1-14B,1720825440,1720825518,finished,1720825459,1720825518,A100-SXM4-80GB,8,1,64,896,19,59
3be893c1-52fc-4f13-8702-b2a31ae8e039,qwen1-14B,1720825595,1720825672,finished,1720825614,1720825672,A100-SXM4-80GB,8,1,64,896,19,58
8b587a43-fa1d-4c5e-98a6-8cf539232a81,qwen1-14B,1720825750,1720825828,finished,1720825770,1720825828,A100-SXM4-80GB,8,1,64,896,20,58
5f65c064-251b-46e5-8b34-a0fd4945b6ad,qwen1-14B,1720825906,1720825984,finished,1720825925,1720825984,A100-SXM4-80GB,8,1,64,896,19,59
20e89605-8a32-4a04-be9c-482fe6349b88,qwen1-14B,1720826063,1720826143,finished,1720826083,1720826143,A100-SXM4-80GB,8,1,64,896,20,60
4708e963-85fa-45c3-af52-e180279cdb9f,qwen1-14B,1720826221,1720826299,finished,1720826240,1720826299,A100-SXM4-80GB,8,1,64,896,19,59
71157037-4640-44f2-9ae1-97d19a18fc6b,lf-llama3-8b-pt80k-resume,1720826339,1720826694,finished,1720826398,1720826694,A100-SXM4-80GB,8,4,64,448,59,296
7f4bb8bf-a8c2-45ec-b94f-b2eb313f3ffd,qwen1-14B,1720826360,1720826439,finished,1720826380,1720826439,A100-SXM4-80GB,8,1,64,896,20,59
8eaf152d-7eb5-4036-b54e-53a5765d4aaf,qwen1-14B,1720826519,1720826617,finished,1720826539,1720826617,A100-SXM4-80GB,8,1,64,896,20,78
a100676b-c39e-4f86-9630-0e333d257415,qwen1-14B,1720826696,1720826776,finished,1720826717,1720826776,A100-SXM4-80GB,8,1,64,896,21,59
0b36fcd5-0b50-4adc-8770-de0653cbb7cf,llama3-8b-sft32k-lora-attn,1720826715,1720826892,finished,1720826755,1720826892,A100-SXM4-80GB,8,4,64,448,40,137
57d52a3e-4cda-426a-b4b7-b2c81868415a,qwen1-14B,1720826854,1720826953,finished,1720826874,1720826953,A100-SXM4-80GB,8,1,64,896,20,79
188ff6c8-b59f-410a-90e3-524abd99af2d,qwen1-14B,1720827031,1720827109,finished,1720827051,1720827109,A100-SXM4-80GB,8,1,64,896,20,58
0dd79448-96b5-4d3c-82e1-fb2d81878e08,qwen1-14B,1720827187,1720827265,finished,1720827207,1720827265,A100-SXM4-80GB,8,1,64,896,20,58
2569b7e2-aa3b-4720-b210-ca819e747b0a,qwen1-14B,1720827344,1720827428,finished,1720827364,1720827428,A100-SXM4-80GB,8,1,64,896,20,64
8e22aedf-f3f1-4889-8099-d04a1ee9281e,lf-llama3-8b-pt80k-resume,1720827446,1720828673,finished,1720827486,1720828673,A100-SXM4-80GB,8,4,64,448,40,1187
0a1ad7b4-acb9-4e6b-b79a-87d7010c2a66,llama3-8b-sft32k-lora-attn,1720827447,1721271709,finished,1720827487,1721271709,A100-SXM4-80GB,8,4,64,448,40,444222
5b1d2f01-811e-45d4-8bec-af5fe7f9209c,qwen1-14B,1720827490,1720827569,finished,1720827510,1720827569,A100-SXM4-80GB,8,1,64,896,20,59
78a67c93-7542-4080-b13c-76e360957fcf,qwen1-14B,1720827649,1720827727,finished,1720827669,1720827727,A100-SXM4-80GB,8,1,64,896,20,58
e0a1cdb6-3dee-47df-9713-1d8685bae4ab,qwen1-14B,1720827804,1720827883,finished,1720827824,1720827883,A100-SXM4-80GB,8,1,64,896,20,59
34e391ba-2ed7-45b9-b30c-9bdcdfd9f86a,qwen1-14B,1720827963,1720828042,finished,1720827983,1720828042,A100-SXM4-80GB,8,1,64,896,20,59
95a5f7c8-2575-4575-af0d-4eae52a11062,qwen1-14B,1720828122,1720828220,finished,1720828142,1720828220,A100-SXM4-80GB,8,1,64,896,20,78
38fc3a4d-2705-4449-a412-8bdc2af0ae18,qwen1-14B,1720828298,1720828377,finished,1720828318,1720828377,A100-SXM4-80GB,8,1,64,896,20,59
dd874f11-c647-4423-a8eb-5e614ab73973,qwen1-14B,1720828457,1720828536,finished,1720828477,1720828536,A100-SXM4-80GB,8,1,64,896,20,59
fa4da732-a702-4f5f-acb5-6ac1de945fa7,qwen1-14B,1720828614,1720828694,finished,1720828635,1720828694,A100-SXM4-80GB,8,1,64,896,21,59
bd42410c-4ac6-4847-9454-06b12052cd8c,qwen1-14B,1720828773,1720828851,finished,1720828792,1720828851,A100-SXM4-80GB,8,1,64,896,19,59
6e1806ac-6e5e-4d5b-899d-f793349a75d9,qwen1-14B,1720828931,1720829008,finished,1720828950,1720829008,A100-SXM4-80GB,8,1,64,896,19,58
ff639249-fe59-49bf-a301-844431a50efa,qwen1-14B,1720829086,1720829166,finished,1720829107,1720829166,A100-SXM4-80GB,8,1,64,896,21,59
a8533251-d865-4ce0-9768-0d4e2ffee634,qwen1-14B,1720829245,1720829323,finished,1720829264,1720829323,A100-SXM4-80GB,8,1,64,896,19,59
91647aa1-ff79-4035-9bc5-0e25350c6816,qwen1-14B,1720829401,1720829481,finished,1720829422,1720829481,A100-SXM4-80GB,8,1,64,896,21,59
8e1a3a14-d0e4-4278-a35f-d8e05cb850a2,qwen1-14B,1720829560,1720829641,finished,1720829579,1720829641,A100-SXM4-80GB,8,1,64,896,19,62
4c5b753d-623e-4c69-9794-d989651ad139,lf-llama3-8b-pt80k-resume,1720829619,1720829858,finished,1720829679,1720829858,A100-SXM4-80GB,8,4,64,448,60,179
8a6f2cc1-e133-4a75-813d-4a55cbeeb27b,qwen1-14B,1720829700,1720829780,finished,1720829721,1720829780,A100-SXM4-80GB,8,1,64,896,21,59
8a8b3093-ec68-4c08-b883-df194082a3ee,qwen1-14B,1720829859,1720829938,finished,1720829879,1720829938,A100-SXM4-80GB,8,1,64,896,20,59
3b843843-0db4-4a2d-b942-1839509441af,qwen1-14B,1720830017,1720830096,finished,1720830037,1720830096,A100-SXM4-80GB,8,1,64,896,20,59
fe3906c1-9132-4f4e-96d1-7d3a34f82f29,qwen1-14B,1720830174,1720830254,finished,1720830194,1720830254,A100-SXM4-80GB,8,1,64,896,20,60
210ab334-0544-4b61-a2b2-50afb495af16,qwen1-14B,1720830332,1720830411,finished,1720830351,1720830411,A100-SXM4-80GB,8,1,64,896,19,60
16d5b1a7-dbfa-49e8-962e-05f9c3f244b8,qwen1-14B,1720830490,1720830567,finished,1720830509,1720830567,A100-SXM4-80GB,8,1,64,896,19,58
0e280b4e-6baf-402e-be8a-e543aa5dffe0,qwen1-14B,1720830644,1720830722,finished,1720830664,1720830722,A100-SXM4-80GB,8,1,64,896,20,58
a7a886b8-d902-463c-8377-b54f4156c88b,qwen1-14B,1720830801,1720830880,finished,1720830820,1720830880,A100-SXM4-80GB,8,1,64,896,19,60
09876aa4-a1e0-4801-b0b2-68ca959eb78f,qwen1-14B,1720830959,1720831040,finished,1720830981,1720831040,A100-SXM4-80GB,8,1,64,896,22,59
b6fa5ac1-4b3c-4fce-b5af-2de8cd64798a,geo-base-offline-eval,1720830962,1720841965,finished,1720830983,1720841965,A100-SXM4-80GB,8,1,64,448,21,10982
03fd460e-16fb-46b3-9a65-629de3ac722e,qwen1-14B,1720831119,1720831198,finished,1720831139,1720831198,A100-SXM4-80GB,8,1,64,896,20,59
de8c6ef2-30c2-4deb-abd7-ca579a1db049,qwen1-14B,1720831276,1720831354,finished,1720831296,1720831354,A100-SXM4-80GB,8,1,64,896,20,58
56618877-18a6-4fe5-b8ce-797cf4e09b04,qwen1-14B,1720831433,1720831513,finished,1720831453,1720831513,A100-SXM4-80GB,8,1,64,896,20,60
fe15acc0-a9fa-4563-85d2-18659eff11f4,qwen1-14B,1720831592,1720831671,finished,1720831612,1720831671,A100-SXM4-80GB,8,1,64,896,20,59
647a0db3-6ebb-422f-9110-b283c6ad5524,qwen1-14B,1720831750,1720831828,finished,1720831769,1720831828,A100-SXM4-80GB,8,1,64,896,19,59
e4c1c253-85c5-49cd-9ee1-a02aef2eb8a6,qwen1-14B,1720831908,1720831986,finished,1720831928,1720831986,A100-SXM4-80GB,8,1,64,896,20,58
185aeac8-133b-4da2-963d-eb08f57aa253,qwen1-14B,1720832065,1720832145,finished,1720832085,1720832145,A100-SXM4-80GB,8,1,64,896,20,60
13400f3f-85ef-4c91-8d15-4727f64997a9,qwen1-14B,1720832224,1720832302,finished,1720832243,1720832302,A100-SXM4-80GB,8,1,64,896,19,59
e6da1f26-0ae0-4af1-aaaf-e08e3d5c3d52,qwen1-14B,1720832382,1720832461,finished,1720832402,1720832461,A100-SXM4-80GB,8,1,64,896,20,59
279656e8-9586-440a-ab3a-a49ba3531386,qwen1-14B,1720832538,1720832617,finished,1720832558,1720832617,A100-SXM4-80GB,8,1,64,896,20,59
66977e54-cfc5-4818-9ff5-996c3e1bfe64,qwen1-14B,1720832696,1720832775,finished,1720832716,1720832775,A100-SXM4-80GB,8,1,64,896,20,59
2fe12c67-9c6f-46db-908a-7990c0ba19a1,qwen1-14B,1720832854,1720832953,finished,1720832874,1720832953,A100-SXM4-80GB,8,1,64,896,20,79
d778cc76-4ebb-40e2-89ca-0e42db0fa2a4,qwen1-14B,1720833033,1720833112,finished,1720833052,1720833112,A100-SXM4-80GB,8,1,64,896,19,60
dfebaea2-e856-46ab-ba77-9b114621cf69,qwen1-14B,1720833192,1720833290,finished,1720833211,1720833290,A100-SXM4-80GB,8,1,64,896,19,79
9db6033b-3ca4-49ba-aee0-8b3346e10114,qwen1-14B,1720833369,1720833448,finished,1720833389,1720833448,A100-SXM4-80GB,8,1,64,896,20,59
96605173-fdbe-4bd4-9c9c-2f9629bd8449,qwen1-14B,1720833526,1720833604,finished,1720833546,1720833604,A100-SXM4-80GB,8,1,64,896,20,58
3e724680-7a0d-42ba-bae7-5880a7a3c16d,qwen1-14B,1720833682,1720833780,finished,1720833701,1720833780,A100-SXM4-80GB,8,1,64,896,19,79
92950072-8e3c-4fc9-98eb-a030796ceecb,qwen1-14B,1720833859,1720833938,finished,1720833879,1720833938,A100-SXM4-80GB,8,1,64,896,20,59
07b73b0d-6f37-4ef7-9080-f4ca4e49c12b,qwen1-14B,1720834018,1720834116,finished,1720834038,1720834116,A100-SXM4-80GB,8,1,64,896,20,78
f2f1eff3-3fe7-4db5-ae5a-622997a54f31,qwen1-14B,1720834195,1720834294,finished,1720834215,1720834294,A100-SXM4-80GB,8,1,64,896,20,79
998bdd78-8305-4273-96ce-737c9ad25039,qwen1-14B,1720834373,1720834452,finished,1720834394,1720834452,A100-SXM4-80GB,8,1,64,896,21,58
0e527003-9482-489a-a924-8472350569af,qwen1-14B,1720834532,1720834610,finished,1720834551,1720834610,A100-SXM4-80GB,8,1,64,896,19,59
a922d880-1a11-46db-a0f8-229f0331e3f2,qwen1-14B,1720834689,1720834769,finished,1720834709,1720834769,A100-SXM4-80GB,8,1,64,896,20,60
c2494187-7b9b-42fc-bb1b-a14e3cf1e423,qwen1-14B,1720834846,1720834925,finished,1720834866,1720834925,A100-SXM4-80GB,8,1,64,896,20,59
b0625f76-e064-474f-9279-943a7daaafd0,qwen1-14B,1720835003,1720835082,finished,1720835023,1720835082,A100-SXM4-80GB,8,1,64,896,20,59
81749e80-d762-4406-9519-8f37fdd00f7b,qwen1-14B,1720835161,1720835240,finished,1720835181,1720835240,A100-SXM4-80GB,8,1,64,896,20,59
47582081-43fa-4fda-9d50-9c9af9b9bc96,data-gen-magpie-3,1720835284,1720937935,finished,1720835305,1720937935,A100-SXM4-80GB,8,1,64,448,21,102630
4b9acc54-c9cf-485f-b41a-cd95d629854b,qwen1-14B,1720835321,1720835401,finished,1720835340,1720835401,A100-SXM4-80GB,8,1,64,896,19,61
dc86da02-3ea8-4f43-876e-7f2359bcf99d,qwen1-14B,1720835480,1720835579,finished,1720835499,1720835579,A100-SXM4-80GB,8,1,64,896,19,80
b9e2ef63-6040-40be-998e-b588b8219f6f,qwen1-14B,1720835658,1720835737,finished,1720835678,1720835737,A100-SXM4-80GB,8,1,64,896,20,59
47e615fa-7e04-47e1-b34a-4cee249f030c,qwen1-14B,1720835815,1720835894,finished,1720835834,1720835894,A100-SXM4-80GB,8,1,64,896,19,60
7d566372-a145-496b-a217-106b522dddde,qwen1-14B,1720835975,1720836055,finished,1720835995,1720836055,A100-SXM4-80GB,8,1,64,896,20,60
eab092d1-1f96-4e1e-8310-1d44486197ec,qwen1-14B,1720836134,1720836212,finished,1720836153,1720836212,A100-SXM4-80GB,8,1,64,896,19,59
a5c5d898-bc00-4636-a784-e039a5b1e6bf,geo-seesaw-sft-code-alpaca-ultra-eval-test,1720836176,1720979130,finished,1720838535,1720979130,A100-SXM4-80GB,8,1,64,896,2359,140595
cbf6288d-1de9-4dde-b86c-4183bed4dfa8,qwen1-14B,1720836291,1720836370,finished,1720836311,1720836370,A100-SXM4-80GB,8,1,64,896,20,59
76a470da-bb92-4b99-8b3b-6d717c409454,qwen1-14B,1720836450,1720836531,finished,1720836470,1720836531,A100-SXM4-80GB,8,1,64,896,20,61
5756979d-6b71-4fa6-ac07-b044918924ef,data-gen-magpie-2,1720836514,1720858832,finished,1720836536,1720858832,A100-SXM4-80GB,8,1,64,448,22,22296
4fa4ff89-18be-4693-887e-105081c5c62b,lf-llama3-8b-pt80k-resume,1720836612,1720838312,finished,1720836652,1720838312,A100-SXM4-80GB,8,4,64,448,40,1660
809ba86d-ba2e-46c3-839c-09cad3c22d4a,qwen1-14B,1720836613,1720836693,finished,1720836633,1720836693,A100-SXM4-80GB,8,1,64,896,20,60
fa909cdf-aeb2-4962-8b61-4e2103e6916f,qwen1-14B,1720836772,1720836851,finished,1720836791,1720836851,A100-SXM4-80GB,8,1,64,896,19,60
9d1db80e-f8c8-4f0a-a899-5845fa8ca509,qwen1-14B,1720836930,1720837008,finished,1720836950,1720837008,A100-SXM4-80GB,8,1,64,896,20,58
8a6d222d-91b7-499e-8bd7-70cac3f5f57f,qwen1-14B,1720837088,1720837186,finished,1720837108,1720837186,A100-SXM4-80GB,8,1,64,896,20,78
e1432b40-1b9d-4b19-9ce1-39d8786b608a,qwen1-14B,1720837264,1720837343,finished,1720837284,1720837343,A100-SXM4-80GB,8,1,64,896,20,59
21adbe54-cb46-4b69-9fff-62d87e136dd6,qwen1-14B,1720837422,1720837502,finished,1720837442,1720837502,A100-SXM4-80GB,8,1,64,896,20,60
5599ae76-47bb-4b28-a9b1-b234f5c105b0,qwen1-14B,1720837580,1720837660,finished,1720837600,1720837660,A100-SXM4-80GB,8,1,64,896,20,60
6a5dab0f-d6e9-40b0-a61a-cba8f8f2a1f8,qwen1-14B,1720837740,1720837819,finished,1720837760,1720837819,A100-SXM4-80GB,8,1,64,896,20,59
9f6e7557-a4db-4273-9e2c-84a430fef4b8,qwen1-14B,1720837897,1720837997,finished,1720837916,1720837997,A100-SXM4-80GB,8,1,64,896,19,81
55ff5320-ad0d-46c6-b39a-06ed10afe1d3,geogpt-7b-chat-lp40-25bgeo,1720838028,1720909666,finished,1720838102,1720909666,A100-SXM4-80GB,8,32,64,448,74,71564
82d96348-70ef-458f-9659-9e7f50d9bc10,geogpt-7b-lp40-s2-sft-1-8m,1720838028,1720867264,finished,1720838101,1720867264,A100-SXM4-80GB,8,4,64,448,73,29163
438d1161-28e5-41b6-9237-df9e9e693dcc,geogpt-llama3-lp84-sft,1720838049,1720963259,finished,1720838089,1720963259,A100-SXM4-80GB,8,32,64,448,40,125170
a80c099c-a1b1-40dd-adf9-fc7069c0fa4e,qwen1-14B,1720838082,1720838333,finished,1720838130,1720838333,A100-SXM4-80GB,8,1,64,896,48,203
9170cb0a-88d0-4002-b5e4-e00832399de2,llama3-70b-lp84-23bcpt-1-2ep-cd52a-auto,1720838297,1720889862,finished,1720838320,1720889862,A100-SXM4-80GB,8,1,64,448,23,51542
826187bd-a765-4a73-8958-cc6ac5f44814,qwen2-72b-lp84-s2-regate2b-m-c2558-auto,1720838299,1720884233,finished,1720838320,1720884233,A100-SXM4-80GB,8,1,64,448,21,45913
917211ed-c50e-4cfe-b97b-92d77a75475d,qwen1-14B,1720838415,1720838492,finished,1720838434,1720838492,A100-SXM4-80GB,8,1,64,896,19,58
4c9e5390-a32b-42a5-8d7f-a3347deb2065,qwen1-14B,1720838571,1720838669,finished,1720838590,1720838669,A100-SXM4-80GB,8,1,64,896,19,79
7beb81fb-0b42-4d80-8f2d-ed0fc10a90a7,qwen1-14B,1720838747,1720838827,finished,1720838768,1720838827,A100-SXM4-80GB,8,1,64,896,21,59
a83b120d-6e28-4e01-af50-aa3ea5214fd0,qwen1-14B,1720838907,1720839005,finished,1720838927,1720839005,A100-SXM4-80GB,8,1,64,896,20,78
68c340dd-c798-483a-8640-a0484b1ed0b7,qwen1-14B,1720839083,1720839163,finished,1720839102,1720839163,A100-SXM4-80GB,8,1,64,896,19,61
c057e9e0-7482-4cbd-96fa-53a2a172effc,qwen1-14B,1720839240,1720839319,finished,1720839260,1720839319,A100-SXM4-80GB,8,1,64,896,20,59
7af79c63-b439-4e6c-aba0-d54f434f6ce4,qwen1-14B,1720839396,1720839475,finished,1720839416,1720839475,A100-SXM4-80GB,8,1,64,896,20,59
7ebbcd2d-8215-478d-b179-c804db7fafe9,qwen1-14B,1720839553,1720839633,finished,1720839573,1720839633,A100-SXM4-80GB,8,1,64,896,20,60
2e3c78f5-6440-4fea-8e58-cd90e907d91d,qwen1-14B,1720839711,1720839789,finished,1720839731,1720839789,A100-SXM4-80GB,8,1,64,896,20,58
7c3437f2-942d-4382-a926-e820e7259c2b,qwen1-14B,1720839868,1720839947,finished,1720839888,1720839947,A100-SXM4-80GB,8,1,64,896,20,59
41118e4b-aa91-47cf-bf4a-134096a5c01a,llama3-8b-sft81k-lora-qkvo,1720839886,1720840242,finished,1720839926,1720840242,A100-SXM4-80GB,8,4,64,448,40,316
c1f43227-21bc-43cd-a24a-33fa571e7215,qwen1-14B,1720840026,1720840104,finished,1720840045,1720840104,A100-SXM4-80GB,8,1,64,896,19,59
25985808-33bd-46ec-b727-d12b87436096,qwen1-14B,1720840182,1720840262,finished,1720840202,1720840262,A100-SXM4-80GB,8,1,64,896,20,60
b4ceca48-769b-4215-a53c-f6df6227c261,llama3-8b-sft81k-lora-qkvo,1720840242,1720840458,finished,1720840301,1720840458,A100-SXM4-80GB,8,4,64,448,59,157
d5e3bbb6-03af-46d7-b814-ce377b0710d6,qwen1-14B,1720840341,1720840419,finished,1720840360,1720840419,A100-SXM4-80GB,8,1,64,896,19,59
b9fc20bd-7b9e-4706-86d4-8e9d728ffdae,llama-factory-long-sp-pt-test,1720840399,1720840536,finished,1720840418,1720840536,A100-SXM4-80GB,8,1,64,448,19,118
674ad5e2-9123-457b-848f-8bd205878eb7,qwen1-14B,1720840498,1720840576,finished,1720840518,1720840576,A100-SXM4-80GB,8,1,64,896,20,58
ece5d766-e549-4f95-9ddc-653ad179294d,qwen1-14B,1720840655,1720840754,finished,1720840674,1720840754,A100-SXM4-80GB,8,1,64,896,19,80
035eaae2-f6c9-4bc9-9981-fa2641c00616,qwen1-14B,1720840832,1720840912,finished,1720840852,1720840912,A100-SXM4-80GB,8,1,64,896,20,60
99d8429e-eb36-4d35-b748-d8a22ab5bb04,qwen1-14B,1720840991,1720841069,finished,1720841010,1720841069,A100-SXM4-80GB,8,1,64,896,19,59
21764326-0067-46c3-84f0-43c45dfc3279,qwen1-14B,1720841146,1720841225,finished,1720841166,1720841225,A100-SXM4-80GB,8,1,64,896,20,59
83d4ac82-c244-4a8d-b828-819c560cdd51,qwen1-14B,1720841305,1720841383,finished,1720841324,1720841383,A100-SXM4-80GB,8,1,64,896,19,59
ead6ead8-5606-430b-a817-7a93bf1012b5,llama3-8b-sft81k-lora-qkvo,1720841422,1720841620,finished,1720841462,1720841620,A100-SXM4-80GB,8,4,64,448,40,158
6b1ee75e-21b2-413c-ba41-8d1aca648377,qwen1-14B,1720841444,1720841542,finished,1720841463,1720841542,A100-SXM4-80GB,8,1,64,896,19,79
9306ef67-3d10-4702-bc86-73258b6169cc,llama-factory-long-sp-pt-test,1720841541,1720841661,finished,1720841561,1720841661,A100-SXM4-80GB,8,1,64,448,20,100
b9ea193e-7185-4966-bb0e-54b9ae9544d7,qwen1-14B,1720841622,1720841701,finished,1720841642,1720841701,A100-SXM4-80GB,8,1,64,896,20,59
2f0dcb16-f78c-432a-ac2f-6ae5be302408,qwen1-14B,1720841779,1720841862,finished,1720841799,1720841862,A100-SXM4-80GB,8,1,64,896,20,63
9c389972-b323-4540-9072-7174c96b107b,llama3-8b-sft81k-lora-qkvo,1720841861,1720842061,finished,1720841900,1720842061,A100-SXM4-80GB,8,4,64,448,39,161
b02c243a-f9c9-45b6-ba35-28aa796989ae,lf-llama3-8b-pt80k-resume,1720841880,1720843938,finished,1720841940,1720843938,A100-SXM4-80GB,8,4,64,448,60,1998
ac2ee39d-1435-4e29-b38d-6d2ea224b234,qwen1-14B,1720841922,1720842002,finished,1720841942,1720842002,A100-SXM4-80GB,8,1,64,896,20,60
3e12a9e1-cbaf-46f5-ad43-776bf6a134a8,citysora-modelv4-cele-ppm-65-512-from-200k256,1720842005,1720948856,finished,1720842066,1720948856,A100-SXM4-80GB,8,4,64,896,61,106790
58e96505-8df0-4cf8-8e99-decfcf8354ed,qwen1-14B,1720842063,1720842141,finished,1720842083,1720842141,A100-SXM4-80GB,8,1,64,896,20,58
cac84b09-7d26-4bbb-9a9b-153e10b27fb6,qwen1-14B,1720842203,1720842282,finished,1720842222,1720842282,A100-SXM4-80GB,8,1,64,896,19,60
5511f943-139c-47ed-9277-c62b50e39a87,qwen1-14B,1720842361,1720842439,finished,1720842381,1720842439,A100-SXM4-80GB,8,1,64,896,20,58
5f28ca9c-cec6-453f-9211-82f4e0693ccd,qwen1-14B,1720842517,1720842595,finished,1720842537,1720842595,A100-SXM4-80GB,8,1,64,896,20,58
da205ac5-c0b6-4427-8606-8a782fa44ac3,qwen1-14B,1720842674,1720842791,finished,1720842694,1720842791,A100-SXM4-80GB,8,1,64,896,20,97
7e52f1d0-c2c6-4bd6-b7d7-428ae4571475,llama-factory-long-sp-pt-test,1720842692,1720842849,finished,1720842712,1720842849,A100-SXM4-80GB,8,1,64,448,20,137
5864bd69-2343-492d-b85e-da4e7a9d30cc,qwen1-14B,1720842869,1720842948,finished,1720842889,1720842948,A100-SXM4-80GB,8,1,64,896,20,59
da7b30c2-13a9-41f8-a791-41aae942e261,qwen1-14B,1720843029,1720843107,finished,1720843049,1720843107,A100-SXM4-80GB,8,1,64,896,20,58
089d354b-3e32-490f-875c-1fd6b8430f58,llama3-8b-sft81k-lora-qkvo,1720843047,1720843266,finished,1720843087,1720843266,A100-SXM4-80GB,8,4,64,448,40,179
c7457c78-119c-43b8-8d24-9f6f708f8c73,llama-factory-long-sp-pt-test,1720843067,1720843384,finished,1720843286,1720843384,A100-SXM4-80GB,8,1,64,448,219,98
e2e6ca5e-f120-4287-ae4e-442a16329f48,qwen1-14B,1720843185,1720843267,finished,1720843205,1720843267,A100-SXM4-80GB,8,1,64,896,20,62
5c784be4-a132-4ded-835d-1df73a67b666,qwen1-14B,1720843346,1720843424,finished,1720843365,1720843424,A100-SXM4-80GB,8,1,64,896,19,59
f8005e3f-46e7-4d63-a061-c2d003deb384,qwen1-14B,1720843502,1720843581,finished,1720843522,1720843581,A100-SXM4-80GB,8,1,64,896,20,59
828cf873-83e7-4543-b5d2-deab896c64c3,test,1720843615,1721010354,finished,1720843635,1721010354,A100-SXM4-80GB,8,1,64,896,20,166719
98fe9ae9-8582-499d-a4e9-9e2e42daaff9,qwen1-14B,1720843660,1720843738,finished,1720843679,1720843738,A100-SXM4-80GB,8,1,64,896,19,59
5397db10-f8f9-48d3-8cfe-7b7c5b8e02d0,llama3-8b-sft81k-lora-qkvo,1720843817,1720844035,finished,1720843875,1720844035,A100-SXM4-80GB,8,4,64,448,58,160
ab10e520-1780-4fed-816c-cca4cf32739a,qwen1-14B,1720843818,1720843898,finished,1720843837,1720843898,A100-SXM4-80GB,8,1,64,896,19,61
a11d5a29-58d9-4654-99ea-66031fcac381,llama-factory-long-sp-pt-test,1720843896,1720844054,finished,1720843957,1720844054,A100-SXM4-80GB,8,1,64,448,61,97
f1ee4cad-6ab9-4db7-8613-379d872e4d11,lf-llama3-8b-pt80k-resume,1720843938,1720844233,finished,1720844075,1720844233,A100-SXM4-80GB,8,4,64,448,137,158
7b9c71fd-d150-400d-b557-c0b09056f40d,qwen1-14B,1720843978,1720844056,finished,1720843997,1720844056,A100-SXM4-80GB,8,1,64,896,19,59
fca89953-7135-4d04-a496-d95f4d6a4d04,qwen1-14B,1720844136,1720844215,finished,1720844156,1720844215,A100-SXM4-80GB,8,1,64,896,20,59
19c59047-1f70-4642-92cd-98dea56d509e,qwen1-14B,1720844293,1720844372,finished,1720844313,1720844372,A100-SXM4-80GB,8,1,64,896,20,59
3a689e78-8c82-4388-9f66-04db7d44f695,qwen1-14B,1720844451,1720844549,finished,1720844470,1720844549,A100-SXM4-80GB,8,1,64,896,19,79
1748cc29-c58a-4226-a8a4-d40eeb97e3c9,qwen1-14B,1720844627,1720844705,finished,1720844647,1720844705,A100-SXM4-80GB,8,1,64,896,20,58
9909906d-c96f-452a-a07b-bc72709c27d4,qwen1-14B,1720844784,1720844862,finished,1720844804,1720844862,A100-SXM4-80GB,8,1,64,896,20,58
030fa03f-b95c-466b-806b-94162a55be87,qwen1-14B,1720844940,1720845017,finished,1720844960,1720845017,A100-SXM4-80GB,8,1,64,896,20,57
b10b3e22-1a54-42ec-8ded-113d94ff6553,qwen1-14B,1720845096,1720845194,finished,1720845116,1720845194,A100-SXM4-80GB,8,1,64,896,20,78
c7a58254-c278-4725-a2f9-85683c3744f3,qwen1-14B,1720845273,1720845351,finished,1720845292,1720845351,A100-SXM4-80GB,8,1,64,896,19,59
44cda389-6f0d-4fa2-95ba-97e7a4b76a4b,qwen1-14B,1720845429,1720845508,finished,1720845448,1720845508,A100-SXM4-80GB,8,1,64,896,19,60
9bede8a4-af10-4687-b465-becb7706762a,qwen1-14B,1720845586,1720845685,finished,1720845606,1720845685,A100-SXM4-80GB,8,1,64,896,20,79
33b5c03c-b4d0-4294-9e3d-4f81a2b597fc,qwen1-14B,1720845763,1720845844,finished,1720845783,1720845844,A100-SXM4-80GB,8,1,64,896,20,61
c130b3f1-ce70-46d1-ba91-c0221f599c7c,llama3-8b-sft81k-lora-qkvo,1720845862,1720846067,finished,1720845923,1720846067,A100-SXM4-80GB,8,4,64,448,61,144
8d1abe10-6aa5-41d0-bf03-edfb080f46e9,qwen1-14B,1720845925,1720846006,finished,1720845945,1720846006,A100-SXM4-80GB,8,1,64,896,20,61
d07a58ac-3d99-47d5-8155-ca5a4d254ee4,lf-llama3-8b-pt80k-resume,1720846005,1720846185,finished,1720846045,1720846185,A100-SXM4-80GB,8,4,64,448,40,140
28ca2409-3ae0-4c84-a4c8-8bced74cba2e,llama-factory-long-sp-pt-test,1720846067,1720846204,finished,1720846086,1720846204,A100-SXM4-80GB,8,1,64,448,19,118
5a20c907-3600-4a1c-8edd-9d2f868f08a2,qwen1-14B,1720846088,1720846166,finished,1720846107,1720846166,A100-SXM4-80GB,8,1,64,896,19,59
01c81bae-8b16-44c3-a28c-c3e12b29a457,llama3-8b-sft81k-lora-qkvo,1720846226,1720846426,finished,1720846285,1720846426,A100-SXM4-80GB,8,4,64,448,59,141
69b691fb-658a-4a3d-92d9-0e04e80452f7,qwen1-14B,1720846227,1720846309,finished,1720846246,1720846309,A100-SXM4-80GB,8,1,64,896,19,63
85c91991-ed57-439c-9fe3-844ca0fc1af5,lf-llama3-8b-pt80k-resume,1720846308,1720849198,finished,1720846366,1720849198,A100-SXM4-80GB,8,4,64,448,58,2832
00b9f074-60e0-4da1-899f-d0f42ef7281d,llama-factory-long-sp-pt-test,1720846327,1720846741,finished,1720846445,1720846741,A100-SXM4-80GB,8,1,64,448,118,296
7509af47-cac1-41c4-8e3c-5875164b0ad3,qwen1-14B,1720846388,1720846467,finished,1720846407,1720846467,A100-SXM4-80GB,8,1,64,896,19,60
93850558-e77a-4f6b-9e3c-96550356e3ec,qwen1-14B,1720846546,1720846625,finished,1720846566,1720846625,A100-SXM4-80GB,8,1,64,896,20,59
3105efa1-a618-4a0c-9bd7-531c3bd9849d,qwen1-14B,1720846703,1720846781,finished,1720846723,1720846781,A100-SXM4-80GB,8,1,64,896,20,58
39c517ad-4462-4474-98c4-f073f38d766d,qwen1-14B,1720846860,1720846939,finished,1720846880,1720846939,A100-SXM4-80GB,8,1,64,896,20,59
650ded0e-9959-4976-a92c-0ef6bab1fbdd,qwen1-14B,1720847017,1720847115,finished,1720847037,1720847115,A100-SXM4-80GB,8,1,64,896,20,78
f2dddb26-4c46-45d5-ad0a-207cb5bb470d,qwen1-14B,1720847195,1720847273,finished,1720847214,1720847273,A100-SXM4-80GB,8,1,64,896,19,59
0ded3e51-b001-4675-9b11-2a36569d43da,m8x7b-sft-2ep-dpo-0deec-auto,1720847278,1720859654,finished,1720847297,1720859654,A100-SXM4-80GB,8,1,64,448,19,12357
e91f0ec9-0496-4abb-9966-4760ce9f85ed,qwen1-14B,1720847352,1720847431,finished,1720847372,1720847431,A100-SXM4-80GB,8,1,64,896,20,59
2a4974c7-8239-40fb-a052-c1f18608679b,m8x7b-sft-2ep-dpo-eb4f8-auto,1720847435,1720849855,finished,1720847455,1720849855,A100-SXM4-80GB,8,1,64,448,20,2400
d03cf0aa-bde1-4062-94f8-0378de19a53a,qwen1-14B,1720847510,1720847590,finished,1720847530,1720847590,A100-SXM4-80GB,8,1,64,896,20,60
b5f229c4-8e6a-42ad-9f75-8eb100444736,qwen1-14B,1720847669,1720847748,finished,1720847688,1720847748,A100-SXM4-80GB,8,1,64,896,19,60
ba8ec8a3-89e1-41dd-97b6-d9d532cc338c,qwen1-14B,1720847827,1720847913,finished,1720847846,1720847913,A100-SXM4-80GB,8,1,64,896,19,67
e7453328-29b3-4db6-a5fe-ec66738c08ed,geo-base-e16,1720847876,1720848692,finished,1720847916,1720848692,A100-SXM4-80GB,8,28,64,448,40,776
6f4fcecf-7358-464c-9b68-3d7c26e626a5,qwen1-14B,1720848004,1720848084,finished,1720848024,1720848084,A100-SXM4-80GB,8,1,64,896,20,60
d07ad19e-d9ea-4068-bcbe-5422ef0401c8,train-0713,1720848080,1720848786,finished,1720848101,1720848786,A100-SXM4-80GB,8,1,64,896,21,685
858b85fc-ef86-42f2-8a8b-7e8872ffc73a,llama3-8b-sft81k-lora-qkvo,1720848164,1720848364,finished,1720848203,1720848364,A100-SXM4-80GB,8,4,64,448,39,161
57f62baf-cc82-4fd8-babf-34ac3445be7f,qwen1-14B,1720848165,1720848264,finished,1720848185,1720848264,A100-SXM4-80GB,8,1,64,896,20,79
f7fff951-8c0b-4925-a841-1994f7d15b4f,qwen1-14B,1720848345,1720848424,finished,1720848365,1720848424,A100-SXM4-80GB,8,1,64,896,20,59
b1af4428-c686-4df4-9d1b-6ae0f8bb508f,qwen1-14B,1720848503,1720848600,finished,1720848522,1720848600,A100-SXM4-80GB,8,1,64,896,19,78
9364cb2a-de4d-437e-a592-99ec57dbdfc9,llama3-8b-sft81k-lora-qkvo,1720848641,1720851463,finished,1720848687,1720851463,A100-SXM4-80GB,8,4,64,448,46,2776
abff7632-e089-4e38-908b-720167000f29,qwen1-14B,1720848690,1720848769,finished,1720848710,1720848769,A100-SXM4-80GB,8,1,64,896,20,59
dbf0117f-e701-43bd-992c-4519ab5b83a1,llama-factory-long-sp-pt-test,1720848708,1721005370,finished,1720849217,1721005370,A100-SXM4-80GB,8,1,64,448,509,156153
f0461a3e-adba-410c-9382-96efa395ab12,qwen1-14B,1720848848,1720848927,finished,1720848868,1720848927,A100-SXM4-80GB,8,1,64,896,20,59
19b85af8-b997-49d6-8e85-d81a7771912c,train-0713,1720848885,1720874302,finished,1720848904,1720874302,A100-SXM4-80GB,8,1,64,896,19,25398
2858b865-3c14-46e7-a6d2-3461ffdbad91,qwen1-14B,1720849008,1720849099,finished,1720849029,1720849099,A100-SXM4-80GB,8,1,64,896,21,70
9587c206-ab5a-4b33-af96-0a31d64a13c8,geo-base-e16,1720849011,1720924404,finished,1720849071,1720924404,A100-SXM4-80GB,8,28,64,448,60,75333
46c278e8-7442-4a86-9efa-76cf62fab58b,qwen1-14B,1720849179,1720849258,finished,1720849199,1720849258,A100-SXM4-80GB,8,1,64,896,20,59
ac363a20-c94f-4ee1-98e1-2f14f5c5f280,qwen1-14B,1720849337,1720849415,finished,1720849357,1720849415,A100-SXM4-80GB,8,1,64,896,20,58
41c7f9a7-d8c1-4b7a-bc1f-f8d986ac0856,qwen1-14B,1720849494,1720849573,finished,1720849514,1720849573,A100-SXM4-80GB,8,1,64,896,20,59
0e5ae614-d072-4e89-aea9-345ef2e6705e,qwen1-14B,1720849652,1720849733,finished,1720849672,1720849733,A100-SXM4-80GB,8,1,64,896,20,61
022581cb-899b-480f-aec5-730497cf6afa,qwen1-14B,1720849811,1720849890,finished,1720849831,1720849890,A100-SXM4-80GB,8,1,64,896,20,59
7df9e360-14c3-403e-9d9a-e21c4eb50bf8,qwen1-14B,1720849970,1720850048,finished,1720849990,1720850048,A100-SXM4-80GB,8,1,64,896,20,58
d2d23195-2223-4b6c-b841-e33fdf8bf889,qwen1-14B,1720850126,1720850205,finished,1720850146,1720850205,A100-SXM4-80GB,8,1,64,896,20,59
f97fe763-9794-4ee8-bdeb-1f8da80dd492,qwen1-14B,1720850283,1720850361,finished,1720850303,1720850361,A100-SXM4-80GB,8,1,64,896,20,58
5a4fe5db-89f5-499c-ae60-ed88245065a9,qwen1-14B,1720850442,1720850520,finished,1720850462,1720850520,A100-SXM4-80GB,8,1,64,896,20,58
9ce10b6a-ed7e-47e4-bd3b-3b7af8e0c465,qwen1-14B,1720850598,1720850676,finished,1720850617,1720850676,A100-SXM4-80GB,8,1,64,896,19,59
392ca023-0e15-4421-a934-a49543f85cda,qwen1-14B,1720850755,1720850834,finished,1720850775,1720850834,A100-SXM4-80GB,8,1,64,896,20,59
681a4cc1-bf18-49c9-9668-b8f28748c266,qwen1-14B,1720850911,1720850991,finished,1720850931,1720850991,A100-SXM4-80GB,8,1,64,896,20,60
ed05286c-8478-4904-90ee-ec7f919599a8,qwen1-14B,1720851069,1720851148,finished,1720851089,1720851148,A100-SXM4-80GB,8,1,64,896,20,59
49359a34-56c5-4363-a0b6-86da6265c0a0,qwen1-14B,1720851227,1720851305,finished,1720851247,1720851305,A100-SXM4-80GB,8,1,64,896,20,58
f17cd244-f98d-4245-9d0c-fcaf485ad120,qwen1-14B,1720851385,1720851464,finished,1720851404,1720851464,A100-SXM4-80GB,8,1,64,896,19,60
52b50053-e02b-4ce4-b0da-21804fc71100,llama3-8b-sft81k-lora-qkvo,1720851463,1720852092,finished,1720851522,1720852092,A100-SXM4-80GB,8,4,64,448,59,570
8433a579-8a2d-4833-9938-f853ca8f36a3,qwen1-14B,1720851543,1720851622,finished,1720851562,1720851622,A100-SXM4-80GB,8,1,64,896,19,60
9f5f9e8f-b9d2-46bc-9c4f-f5ef18090350,qwen1-14B,1720851701,1720851779,finished,1720851720,1720851779,A100-SXM4-80GB,8,1,64,896,19,59
7bb475a3-320d-48f7-bd0f-58d87ab5eaa7,qwen1-14B,1720851856,1720851934,finished,1720851876,1720851934,A100-SXM4-80GB,8,1,64,896,20,58
a37ecd79-f778-4a2d-97fa-eb7d8002226a,qwen1-14B,1720852012,1720852093,finished,1720852032,1720852093,A100-SXM4-80GB,8,1,64,896,20,61
64b6a4f8-ebd1-4059-abdb-7ab993a7b009,llama3-8b-sft81k-lora-qkvo,1720852092,1720852346,finished,1720852150,1720852346,A100-SXM4-80GB,8,4,64,448,58,196
937ae864-dbad-4ea0-b533-d4bdb89adfb7,qwen1-14B,1720852171,1720852269,finished,1720852191,1720852269,A100-SXM4-80GB,8,1,64,896,20,78
86f187ea-452e-41aa-bde1-27a26fc8d86b,qwen1-14B,1720852348,1720852428,finished,1720852368,1720852428,A100-SXM4-80GB,8,1,64,896,20,60
c03c9eb1-4371-431f-bce0-aebcc37da4b2,qwen1-14B,1720852507,1720852585,finished,1720852526,1720852585,A100-SXM4-80GB,8,1,64,896,19,59
7bb6bf0f-baf6-4664-b14c-25f956edb109,qwen1-14B,1720852664,1720852762,finished,1720852683,1720852762,A100-SXM4-80GB,8,1,64,896,19,79
b5b5c804-1242-4d1c-8c92-5c30bc441548,zxx-ts,1720852819,1720853627,finished,1720852860,1720853627,A100-SXM4-80GB,8,4,64,896,41,767
5a80a9f6-f803-41c8-b193-c99a4a02ba93,qwen1-14B,1720852841,1720852920,finished,1720852861,1720852920,A100-SXM4-80GB,8,1,64,896,20,59
50fcf326-d5da-4da5-93ae-7244793effdb,qwen1-14B,1720852999,1720853077,finished,1720853018,1720853077,A100-SXM4-80GB,8,1,64,896,19,59
2e3f3a8c-7cd8-4195-84dc-14fecdee6984,qwen1-14B,1720853155,1720853253,finished,1720853174,1720853253,A100-SXM4-80GB,8,1,64,896,19,79
630604f3-9911-413f-bc26-a358eaee49d2,qwen1-14B,1720853332,1720853410,finished,1720853351,1720853410,A100-SXM4-80GB,8,1,64,896,19,59
6c91def9-b7fb-45b0-956b-2bc4f47c12b1,qwen1-14B,1720853489,1720853567,finished,1720853508,1720853567,A100-SXM4-80GB,8,1,64,896,19,59
85af0559-7d1f-4f74-8b4e-5dde1d711379,vae-baseline-replic,1720853551,1721703797,finished,1720853570,1721703797,A100-SXM4-80GB,8,1,64,896,19,850227
0d457f65-5494-4f55-863d-9e2c2f944f16,train-0713B-lr1e-5,1720853624,1720875841,finished,1720853645,1720875841,A100-SXM4-80GB,8,1,64,896,21,22196
f8e27144-ebc1-4c24-b482-60c54ec49dbf,qwen1-14B,1720853628,1720853707,finished,1720853647,1720853707,A100-SXM4-80GB,8,1,64,896,19,60
6ecb612b-0369-4a88-bc60-b74fb7ecd279,qwen1-14B,1720853786,1720853864,finished,1720853805,1720853864,A100-SXM4-80GB,8,1,64,896,19,59
55b3645c-944a-44f9-b5e2-fb23e3cee9fa,llama3-8b-sft81k-lora-qkvo,1720853924,1720856660,finished,1720853964,1720856660,A100-SXM4-80GB,8,4,64,448,40,2696
0478dc2d-faad-4fed-997c-98a782ccc2da,qwen1-14B,1720853945,1720854026,finished,1720853966,1720854026,A100-SXM4-80GB,8,1,64,896,21,60
98e5ee62-7a10-41ea-aed2-8f42349a387e,qwen1-14B,1720854105,1720854183,finished,1720854125,1720854183,A100-SXM4-80GB,8,1,64,896,20,58
b89198d9-b07f-4333-b01e-48acdcddb47b,qwen1-14B,1720854262,1720854341,finished,1720854282,1720854341,A100-SXM4-80GB,8,1,64,896,20,59
8c01d07a-9068-4f4b-a36f-d24e8d97b2f5,qwen1-14B,1720854420,1720854498,finished,1720854440,1720854498,A100-SXM4-80GB,8,1,64,896,20,58
cf46602b-7b35-4484-9199-e186f978146c,qwen1-14B,1720854576,1720854654,finished,1720854596,1720854654,A100-SXM4-80GB,8,1,64,896,20,58
058ef795-254d-4817-b9f7-f0fae56f4118,qwen1-14B,1720854733,1720854811,finished,1720854752,1720854811,A100-SXM4-80GB,8,1,64,896,19,59
549e2c92-5ddb-4220-92b0-3752488112d3,qwen1-14B,1720854889,1720854969,finished,1720854909,1720854969,A100-SXM4-80GB,8,1,64,896,20,60
9ab874d9-3a28-47d1-b0a3-5994330baeb2,qwen1-14B,1720855048,1720855127,finished,1720855068,1720855127,A100-SXM4-80GB,8,1,64,896,20,59
21c7489d-f301-4e69-ae10-eb417ec7eb8e,qwen1-14B,1720855206,1720855285,finished,1720855225,1720855285,A100-SXM4-80GB,8,1,64,896,19,60
30d0df08-9de8-434e-b20b-776aad4b725c,qwen1-14B,1720855365,1720855441,finished,1720855384,1720855441,A100-SXM4-80GB,8,1,64,896,19,57
9b06998e-46ea-480f-a96b-f4b3a797c842,qwen1-14B,1720855519,1720855598,finished,1720855539,1720855598,A100-SXM4-80GB,8,1,64,896,20,59
74116f2a-0c85-4405-8be7-a681a005e50d,qwen1-14B,1720855675,1720855753,finished,1720855695,1720855753,A100-SXM4-80GB,8,1,64,896,20,58
311f554b-a1a3-42e5-9ef8-3a19c111e356,qwen1-14B,1720855830,1720855907,finished,1720855849,1720855907,A100-SXM4-80GB,8,1,64,896,19,58
9ef62ba5-4196-4917-84e5-80ea4c2f1e6f,qwen1-14B,1720855985,1720856063,finished,1720856005,1720856063,A100-SXM4-80GB,8,1,64,896,20,58
409c17ee-901a-4626-a7ad-ef3da0c9836d,qwen1-14B,1720856140,1720856236,finished,1720856159,1720856236,A100-SXM4-80GB,8,1,64,896,19,77
cf98b341-1383-4e88-82a7-43474ff57cbf,qwen1-14B,1720856313,1720856390,finished,1720856332,1720856390,A100-SXM4-80GB,8,1,64,896,19,58
a5daa228-6c6d-42d7-be4c-8f0709a2a065,qwen1-14B,1720856467,1720856543,finished,1720856486,1720856543,A100-SXM4-80GB,8,1,64,896,19,57
65063e68-c7b1-420a-be1b-26ab27334e9c,qwen1-14B,1720856622,1720856700,finished,1720856642,1720856700,A100-SXM4-80GB,8,1,64,896,20,58
cc0f3540-b683-429c-abd3-ff214e7925aa,llama3-8b-sft81k-lora-qkvo,1720856660,1721011612,finished,1720856698,1721011612,A100-SXM4-80GB,8,4,64,448,38,154914
b40933ef-d35d-478d-98c9-8b48bdc03d77,qwen1-14B,1720856778,1720856856,finished,1720856797,1720856856,A100-SXM4-80GB,8,1,64,896,19,59
8316096d-f5a1-41ed-a039-ee871abe6f5f,qwen1-14B,1720856933,1720857028,finished,1720856952,1720857028,A100-SXM4-80GB,8,1,64,896,19,76
a9436085-0766-48c5-86f2-0484920f8dc3,qwen1-14B,1720857106,1720857183,finished,1720857126,1720857183,A100-SXM4-80GB,8,1,64,896,20,57
6eafcdf2-ae6d-430d-af37-cc6bcf8ea2ad,qwen1-14B,1720857261,1720857338,finished,1720857280,1720857338,A100-SXM4-80GB,8,1,64,896,19,58
52898d87-52e4-4969-b415-5bdd679f9114,qwen1-14B,1720857417,1720857494,finished,1720857436,1720857494,A100-SXM4-80GB,8,1,64,896,19,58
2d6d2c76-8b41-4c0b-b190-6a4ad8bec7ef,qwen1-14B,1720857572,1720857651,finished,1720857592,1720857651,A100-SXM4-80GB,8,1,64,896,20,59
0a7bedb5-63d8-4f04-81b0-db550ceee526,qwen1-14B,1720857728,1720857805,finished,1720857747,1720857805,A100-SXM4-80GB,8,1,64,896,19,58
d5fd36c1-bc47-4a3b-ab73-c3bdbb01a1ef,sft-ultrachat-me5-14b-eval,1720857830,1720944855,finished,1720857849,1720944855,A100-SXM4-80GB,8,1,64,896,19,87006
19f286c0-b0cb-4c54-bdaa-890199cd3177,qwen1-14B,1720857884,1720857963,finished,1720857904,1720857963,A100-SXM4-80GB,8,1,64,896,20,59
bde1450d-da2b-4ba7-837d-61426bf172a6,qwen1-14B,1720858040,1720858116,finished,1720858059,1720858116,A100-SXM4-80GB,8,1,64,896,19,57
01aa920e-b1be-4709-960f-79d2c0a89d56,sft-92k-common-92k-geo-mix-72b,1720858120,1720945145,finished,1720858140,1720945145,A100-SXM4-80GB,8,1,64,896,20,87005
b75ba7e1-33c7-4ddc-96f5-ee1f0cb058dd,qwen1-14B,1720858195,1720858277,finished,1720858217,1720858277,A100-SXM4-80GB,8,1,64,896,22,60
26ffa478-31f7-4e76-916a-d5c485f28762,zxxzxx123,1720858216,1720858667,finished,1720858276,1720858667,A100-SXM4-80GB,8,4,64,896,60,391
3467569e-3cc2-446b-8a32-11d4dc71a1b3,qwen1-14B,1720858356,1720858435,finished,1720858376,1720858435,A100-SXM4-80GB,8,1,64,896,20,59
368d5627-689a-49a3-a15c-9a3f50535d0a,sft-tulu-v2-14b-eval,1720858400,1720858831,finished,1720858420,1720858831,A100-SXM4-80GB,8,1,64,896,20,411
94639590-63fb-4dea-ae27-c71f0180ee5f,qwen1-14B,1720858513,1720858591,finished,1720858532,1720858591,A100-SXM4-80GB,8,1,64,896,19,59
cd93a6fc-c927-4681-953f-25a14e3eb673,zxxzxx123,1720858667,1720858806,finished,1720858727,1720858806,A100-SXM4-80GB,8,4,64,896,60,79
d40a0ee3-9122-45d8-9260-861fb9b41991,qwen1-14B,1720858669,1720858768,finished,1720858689,1720858768,A100-SXM4-80GB,8,1,64,896,20,79
f75d53e3-95d1-4d15-b101-c04ce7319fe0,qwen1-14B,1720858847,1720858925,finished,1720858867,1720858925,A100-SXM4-80GB,8,1,64,896,20,58
698677a3-bb62-4127-a41c-a5265475c455,qwen1-14B,1720859002,1720859081,finished,1720859022,1720859081,A100-SXM4-80GB,8,1,64,896,20,59
1a33e139-9c6a-4785-a3c1-e09bbdaf9cdd,sft-tulu-v2-14b-eval,1720859026,1720859459,finished,1720859046,1720859459,A100-SXM4-80GB,8,1,64,896,20,413
75050c7b-2cd7-4c27-b75d-f16cf61a6167,zxxzxx123,1720859060,1720860078,finished,1720859099,1720860078,A100-SXM4-80GB,8,4,64,896,39,979
038e80ea-8f87-4234-9a61-56d06af95b5c,qwen1-14B,1720859159,1720859258,finished,1720859179,1720859258,A100-SXM4-80GB,8,1,64,896,20,79
3d46a024-4819-42ab-b14d-4eda47ed88be,qwen1-14B,1720859337,1720859416,finished,1720859356,1720859416,A100-SXM4-80GB,8,1,64,896,19,60
7dfb6b9d-4344-48f0-96e8-3c222e1c2202,qwen1-14B,1720859494,1720859572,finished,1720859513,1720859572,A100-SXM4-80GB,8,1,64,896,19,59
501d299e-ff82-40f7-bef2-bcf080f984a3,qwen1-14B,1720859650,1720859747,finished,1720859669,1720859747,A100-SXM4-80GB,8,1,64,896,19,78
048614fc-a676-41ca-af52-e04199c910d4,qwen1-14B,1720859824,1720859902,finished,1720859843,1720859902,A100-SXM4-80GB,8,1,64,896,19,59
48fdc808-d8ca-4d85-9420-dadfe06aa056,qwen1-14B,1720859980,1720860059,finished,1720860000,1720860059,A100-SXM4-80GB,8,1,64,896,20,59
d2fa315c-bd5e-4c7c-ad39-e71ff636c14e,geogpt-1-8m-plus-ultrachat-m3-eval-2,1720860005,1720947013,finished,1720860025,1720947013,A100-SXM4-80GB,8,1,64,896,20,86988
0361c352-fa71-43be-aceb-701736e9ecb2,qwen1-14B,1720860137,1720860214,finished,1720860156,1720860214,A100-SXM4-80GB,8,1,64,896,19,58
790ad7ec-efb0-4228-8ca2-6b4d0fbba6a6,qwen1-14B,1720860291,1720860368,finished,1720860311,1720860368,A100-SXM4-80GB,8,1,64,896,20,57
4ba097ae-8af0-4d30-a924-9f068a1ebe77,qwen1-14B,1720860447,1720860524,finished,1720860466,1720860524,A100-SXM4-80GB,8,1,64,896,19,58
00632ae3-8791-4e23-a09e-d8300a6b8ae7,qwen1-14B,1720860603,1720860701,finished,1720860623,1720860701,A100-SXM4-80GB,8,1,64,896,20,78
1241722c-0933-40c0-a3dc-50eed6f6c278,qwen1-14B,1720860779,1720860858,finished,1720860799,1720860858,A100-SXM4-80GB,8,1,64,896,20,59
f634746f-8d87-4322-8ff2-d71a021ad8be,qwen1-14B,1720860936,1720861015,finished,1720860956,1720861015,A100-SXM4-80GB,8,1,64,896,20,59
066dc8b8-1a9c-4e3d-a115-2b1aac387d7c,qwen1-14B,1720861094,1720861190,finished,1720861113,1720861190,A100-SXM4-80GB,8,1,64,896,19,77
81c94e30-e2f3-48bb-a285-591b9d1fb9ba,qwen1-14B,1720861268,1720861346,finished,1720861287,1720861346,A100-SXM4-80GB,8,1,64,896,19,59
a5137284-29ef-4cbd-bf81-f2e71e88069f,qwen1-14B,1720861424,1720861502,finished,1720861444,1720861502,A100-SXM4-80GB,8,1,64,896,20,58
224e4909-e07b-4797-be1d-3ea564e9003b,qwen1-14B,1720861581,1720861677,finished,1720861600,1720861677,A100-SXM4-80GB,8,1,64,896,19,77
46858f59-e370-4505-bddd-af2805506596,qwen1-14B,1720861756,1720861834,finished,1720861775,1720861834,A100-SXM4-80GB,8,1,64,896,19,59
7b2ef570-6725-43c8-8d67-f6ec9acd91c4,qwen1-14B,1720861912,1720862010,finished,1720861931,1720862010,A100-SXM4-80GB,8,1,64,896,19,79
f05382ed-088c-4b4d-b49d-111f94b121c4,qwen1-14B,1720862089,1720862167,finished,1720862109,1720862167,A100-SXM4-80GB,8,1,64,896,20,58
e60744b0-f334-4a5b-bcd2-ca8b74038e5d,qwen1-14B,1720862245,1720862324,finished,1720862265,1720862324,A100-SXM4-80GB,8,1,64,896,20,59
41d2a846-3fca-4721-9026-a811906e59f6,qwen1-14B,1720862402,1720862480,finished,1720862421,1720862480,A100-SXM4-80GB,8,1,64,896,19,59
1bb9c566-0676-4976-a4d7-d7127833d99a,qwen1-14B,1720862557,1720862636,finished,1720862577,1720862636,A100-SXM4-80GB,8,1,64,896,20,59
edc67a98-dddc-48c2-9aae-9ed196fdec45,qwen1-14B,1720862715,1720862794,finished,1720862736,1720862794,A100-SXM4-80GB,8,1,64,896,21,58
187dc0e9-2558-4e08-981a-3152de041ef9,qwen1-14B,1720862871,1720862969,finished,1720862890,1720862969,A100-SXM4-80GB,8,1,64,896,19,79
f104ec20-b372-4ad2-a25e-b52ee61750e6,qwen1-14B,1720863047,1720863125,finished,1720863067,1720863125,A100-SXM4-80GB,8,1,64,896,20,58
4bec281f-864d-4d61-b872-8d148c7cfa23,qwen1-14B,1720863203,1720863280,finished,1720863222,1720863280,A100-SXM4-80GB,8,1,64,896,19,58
38b0add9-f31e-4e55-b443-4dc02845bdb2,qwen1-14B,1720863358,1720863437,finished,1720863378,1720863437,A100-SXM4-80GB,8,1,64,896,20,59
32c39df4-7d0b-47d7-adce-4ced3c16f783,qwen1-14B,1720863516,1720863595,finished,1720863536,1720863595,A100-SXM4-80GB,8,1,64,896,20,59
c3a46e40-f9d7-482c-801e-6fc095e79440,qwen1-14B,1720863673,1720863749,finished,1720863692,1720863749,A100-SXM4-80GB,8,1,64,896,19,57
973592aa-be4c-4904-b676-476eb16e0c76,qwen1-14B,1720863827,1720863905,finished,1720863847,1720863905,A100-SXM4-80GB,8,1,64,896,20,58
1a6a4954-c07c-46e9-88a5-7bf0a11cdf41,qwen1-14B,1720863983,1720864061,finished,1720864003,1720864061,A100-SXM4-80GB,8,1,64,896,20,58
bf40380b-0d5e-4947-8d12-4f3d10d673e1,qwen1-14B,1720864138,1720864215,finished,1720864157,1720864215,A100-SXM4-80GB,8,1,64,896,19,58
1cac80d6-cc62-4040-be77-83418b62cffb,geogpt-lxz-2-9m-mix-data-v2-llama3-8b,1720864220,1720954485,finished,1720864279,1720954485,A100-SXM4-80GB,8,8,64,448,59,90206
5e4fab70-2b80-4af9-ba48-5c6e7c5fcb99,qwen1-14B,1720864297,1720864374,finished,1720864317,1720864374,A100-SXM4-80GB,8,1,64,896,20,57
2f0c1118-d260-4b17-9821-197c8fa953e9,qwen1-14B,1720864453,1720864530,finished,1720864472,1720864530,A100-SXM4-80GB,8,1,64,896,19,58
64b653cf-909a-4400-b96e-9e2df5803987,qwen1-14B,1720864608,1720864707,finished,1720864628,1720864707,A100-SXM4-80GB,8,1,64,896,20,79
ee0117eb-0e23-4830-bdb9-55d1305ef68a,qwen1-14B,1720864785,1720864867,finished,1720864805,1720864867,A100-SXM4-80GB,8,1,64,896,20,62
46bacd3a-4e11-4338-bcfd-c816dcaa1ac6,qwen1-14B,1720864946,1720865025,finished,1720864966,1720865025,A100-SXM4-80GB,8,1,64,896,20,59
e1418f79-e6e7-4c8b-84ee-925980189794,qwen1-14B,1720865102,1720865179,finished,1720865121,1720865179,A100-SXM4-80GB,8,1,64,896,19,58
3095f177-f8ca-4f73-b4da-58a48c5eb116,qwen1-14B,1720865258,1720865335,finished,1720865277,1720865335,A100-SXM4-80GB,8,1,64,896,19,58
750e1da6-8ce3-4b3b-b4aa-e5899dafcc36,qwen1-14B,1720865414,1720865492,finished,1720865433,1720865492,A100-SXM4-80GB,8,1,64,896,19,59
16d9c67e-5a59-451b-aa28-9d747c4099b4,qwen1-14B,1720865570,1720865650,finished,1720865590,1720865650,A100-SXM4-80GB,8,1,64,896,20,60
c32869cb-3fe9-44db-afbb-2e787ed07580,qwen1-14B,1720865728,1720865806,finished,1720865747,1720865806,A100-SXM4-80GB,8,1,64,896,19,59
cd8493e3-8f33-4938-a815-d34521a6e083,qwen1-14B,1720865884,1720865964,finished,1720865904,1720865964,A100-SXM4-80GB,8,1,64,896,20,60
963ca81a-3ccc-4cf8-90d9-8e3b1e69f4aa,qwen1-14B,1720866043,1720866121,finished,1720866062,1720866121,A100-SXM4-80GB,8,1,64,896,19,59
bfbed882-50aa-4c00-8e1d-2225dca21adb,qwen1-14B,1720866199,1720866278,finished,1720866219,1720866278,A100-SXM4-80GB,8,1,64,896,20,59
78e96a39-3052-4358-8dd9-7eab253564b8,qwen1-14B,1720866357,1720866455,finished,1720866376,1720866455,A100-SXM4-80GB,8,1,64,896,19,79
53c67455-5c2d-4002-85d0-1b63ef803a4b,qwen1-14B,1720866533,1720866612,finished,1720866553,1720866612,A100-SXM4-80GB,8,1,64,896,20,59
c8af84c3-4abc-4e96-bb08-125d113d38c7,qwen1-14B,1720866689,1720866767,finished,1720866708,1720866767,A100-SXM4-80GB,8,1,64,896,19,59
cb39f2b8-0927-4ac2-9427-539cf3d705ef,qwen1-14B,1720866845,1720866923,finished,1720866864,1720866923,A100-SXM4-80GB,8,1,64,896,19,59
ff2418cf-fa24-488a-8bd5-56cff17f6aff,qwen1-14B,1720867002,1720867081,finished,1720867022,1720867081,A100-SXM4-80GB,8,1,64,896,20,59
eef2275e-06b5-46ff-bf35-b5c39bb99bef,qwen1-14B,1720867159,1720867237,finished,1720867179,1720867237,A100-SXM4-80GB,8,1,64,896,20,58
dbf8e101-11a4-4b81-954f-0c13a2dcb712,qwen1-14B,1720867315,1720867394,finished,1720867335,1720867394,A100-SXM4-80GB,8,1,64,896,20,59
49fa4333-4cc7-4b99-a6a7-11ef98e90d38,qwen1-14B,1720867472,1720867549,finished,1720867491,1720867549,A100-SXM4-80GB,8,1,64,896,19,58
fd62222f-344c-4af3-978f-1ac24b7c9a96,qwen1-14B,1720867628,1720867706,finished,1720867648,1720867706,A100-SXM4-80GB,8,1,64,896,20,58
246f6b57-54cd-454a-88c9-309c0c5cd0f9,qwen1-14B,1720867784,1720867863,finished,1720867804,1720867863,A100-SXM4-80GB,8,1,64,896,20,59
3fe530aa-4eb0-46b7-bb1d-636014ccc5f3,qwen1-14B,1720867941,1720868019,finished,1720867961,1720868019,A100-SXM4-80GB,8,1,64,896,20,58
29a7eee6-93b5-461e-a235-5f6564f98791,qwen1-14B,1720868097,1720868197,finished,1720868117,1720868197,A100-SXM4-80GB,8,1,64,896,20,80
66948740-42ad-4bdb-ab2f-73e20244b894,geo-05B-zero3,1720868120,1720868317,finished,1720868140,1720868317,A100-SXM4-80GB,8,1,64,896,20,177
2ee2fc32-685a-4ceb-9d68-1faf96e15236,tq-llm-chat-infer-1,1720868207,1720874782,finished,1720868227,1720874782,A100-SXM4-80GB,8,1,64,448,20,6555
7f4a39f6-24dd-4fe5-aa3e-e6b11f3a9aa0,qwen1-14B,1720868276,1720868352,finished,1720868295,1720868352,A100-SXM4-80GB,8,1,64,896,19,57
50e48bb2-9e8c-4fd2-a06b-af6348b40b45,qwen1-14B,1720868430,1720868509,finished,1720868450,1720868509,A100-SXM4-80GB,8,1,64,896,20,59
eb971bf5-4af3-4c53-822c-8449acb467e6,qwen1-14B,1720868587,1720868665,finished,1720868606,1720868665,A100-SXM4-80GB,8,1,64,896,19,59
a5c2709e-05e7-4bd8-b4f8-a8dfbc605faf,qwen1-14B,1720868744,1720868822,finished,1720868764,1720868822,A100-SXM4-80GB,8,1,64,896,20,58
28fbf6e0-9d1d-451a-af90-1af49de6e340,qwen1-14B,1720868901,1720868979,finished,1720868921,1720868979,A100-SXM4-80GB,8,1,64,896,20,58
dba8e768-4e1e-43cc-9b47-8ee7a29790d7,qwen1-14B,1720869058,1720869155,finished,1720869077,1720869155,A100-SXM4-80GB,8,1,64,896,19,78
fb45a6ff-027a-43f1-b97b-63c30e18594a,qwen1-14B,1720869234,1720869312,finished,1720869254,1720869312,A100-SXM4-80GB,8,1,64,896,20,58
08095459-fea4-4f61-9794-6f8c2d1cd98b,qwen1-14B,1720869391,1720869469,finished,1720869410,1720869469,A100-SXM4-80GB,8,1,64,896,19,59
056ff3fa-7848-43ef-a40b-ecceb9c56280,qwen1-14B,1720869548,1720869647,finished,1720869567,1720869647,A100-SXM4-80GB,8,1,64,896,19,80
7c420667-7744-4ec8-a022-92fe51f62b80,qwen1-14B,1720869725,1720869802,finished,1720869744,1720869802,A100-SXM4-80GB,8,1,64,896,19,58
6373d207-0768-40df-9fe5-c32bef38325f,geo-05B-zero3,1720869728,1720869944,finished,1720869747,1720869944,A100-SXM4-80GB,8,1,64,896,19,197
19566ee2-e5c1-42a2-9dbc-622956eddb9a,qwen1-14B,1720869882,1720869961,finished,1720869901,1720869961,A100-SXM4-80GB,8,1,64,896,19,60
59af9ed1-60b0-4549-a666-90ba5b415c4f,qwen1-14B,1720870039,1720870138,finished,1720870059,1720870138,A100-SXM4-80GB,8,1,64,896,20,79
e9cb84e7-4e6a-456b-ba76-6b0557690755,qwen1-14B,1720870217,1720870296,finished,1720870237,1720870296,A100-SXM4-80GB,8,1,64,896,20,59
fc2702fb-dc32-4095-9ba1-7800e42b3bc9,qwen1-14B,1720870374,1720870452,finished,1720870394,1720870452,A100-SXM4-80GB,8,1,64,896,20,58
98677ef5-bd21-498e-a399-a38eb07adfce,qwen1-14B,1720870530,1720870628,finished,1720870550,1720870628,A100-SXM4-80GB,8,1,64,896,20,78
2b0e0d19-78a6-4cc1-9bab-62b3c5757096,qwen1-14B,1720870706,1720870784,finished,1720870725,1720870784,A100-SXM4-80GB,8,1,64,896,19,59
ddd6c17f-7643-4ea9-837f-347bb545295a,qwen1-14B,1720870863,1720870940,finished,1720870882,1720870940,A100-SXM4-80GB,8,1,64,896,19,58
cb47f69a-ec17-4e5f-8c6f-463ddf6d0fa1,qwen1-14B,1720871018,1720871095,finished,1720871037,1720871095,A100-SXM4-80GB,8,1,64,896,19,58
bf10f807-6124-4438-bcbe-aab3c381835d,qwen1-14B,1720871174,1720871253,finished,1720871194,1720871253,A100-SXM4-80GB,8,1,64,896,20,59
31d73d89-8fd3-4c15-aa35-da5b30fcdf16,qwen1-14B,1720871332,1720871410,finished,1720871352,1720871410,A100-SXM4-80GB,8,1,64,896,20,58
65404fe2-4971-425e-82cb-70e577cfd489,qwen1-14B,1720871489,1720871568,finished,1720871509,1720871568,A100-SXM4-80GB,8,1,64,896,20,59
a061ee5c-d7b0-4c92-a829-f178138297af,qwen1-14B,1720871647,1720871745,finished,1720871667,1720871745,A100-SXM4-80GB,8,1,64,896,20,78
afceeff9-d771-482d-89d6-3b69baf4f53e,qwen1-14B,1720871826,1720871905,finished,1720871845,1720871905,A100-SXM4-80GB,8,1,64,896,19,60
8376acd4-bbce-4d37-aebc-522953df9eee,qwen1-14B,1720871983,1720872064,finished,1720872003,1720872064,A100-SXM4-80GB,8,1,64,896,20,61
b210655e-5571-41cb-88a3-2c9107d08478,qwen1-14B,1720872141,1720872219,finished,1720872161,1720872219,A100-SXM4-80GB,8,1,64,896,20,58
335521d4-63e0-4a13-b131-3a705e2cddd2,qwen1-14B,1720872298,1720872376,finished,1720872317,1720872376,A100-SXM4-80GB,8,1,64,896,19,59
f513c4be-f8ef-4a65-b695-44b30be94590,qwen1-14B,1720872454,1720872533,finished,1720872474,1720872533,A100-SXM4-80GB,8,1,64,896,20,59
23ddfce0-0d53-4e6b-ad87-f4c1f31ace35,qwen1-14B,1720872611,1720872690,finished,1720872631,1720872690,A100-SXM4-80GB,8,1,64,896,20,59
58c31824-d986-4763-afa0-405b5ec720f8,qwen1-14B,1720872768,1720872847,finished,1720872788,1720872847,A100-SXM4-80GB,8,1,64,896,20,59
b185f5a1-ff03-410f-b82f-9f64c254679b,qwen1-14B,1720872925,1720873001,finished,1720872944,1720873001,A100-SXM4-80GB,8,1,64,896,19,57
5909094f-7ee1-40fc-8b90-31e4fec87abb,qwen1-14B,1720873081,1720873179,finished,1720873101,1720873179,A100-SXM4-80GB,8,1,64,896,20,78
7974728e-b364-4cd0-9cb8-3ceed20a9ef2,lzk-qwen15-7b-scihub-abstract-hw-2stage,1720873091,1720880081,finished,1720873111,1720880081,A100-SXM4-80GB,8,1,64,448,20,6970
48e6bd48-a8de-4596-9cd3-9d4194200d62,qwen1-14B,1720873257,1720873335,finished,1720873276,1720873335,A100-SXM4-80GB,8,1,64,896,19,59
aa391abc-15f6-41a9-823f-3f7f92d41e5d,qwen1-14B,1720873412,1720873489,finished,1720873431,1720873489,A100-SXM4-80GB,8,1,64,896,19,58
8dc06d85-9378-4e11-a797-6a2c4ed41f2f,geo-05B-zero3,1720873511,1720873724,finished,1720873530,1720873724,A100-SXM4-80GB,8,1,64,896,19,194
5cdaeb06-688b-40fd-8cdd-e55bd13acec7,qwen1-14B,1720873566,1720873644,finished,1720873585,1720873644,A100-SXM4-80GB,8,1,64,896,19,59
ac724bed-f140-42ba-9c85-1627dbb916f0,qwen1-14B,1720873721,1720873799,finished,1720873741,1720873799,A100-SXM4-80GB,8,1,64,896,20,58
b0345c90-d1f7-4789-84ba-f89867799e7a,qwen1-14B,1720873877,1720873955,finished,1720873896,1720873955,A100-SXM4-80GB,8,1,64,896,19,59
a85dcf3c-d621-451c-9483-ffcb657794b8,qwen1-14B,1720874032,1720874131,finished,1720874052,1720874131,A100-SXM4-80GB,8,1,64,896,20,79
fe84384d-0b7f-4310-9949-48a2d49ed87b,qwen1-14B,1720874209,1720874286,finished,1720874228,1720874286,A100-SXM4-80GB,8,1,64,896,19,58
bf4aab3e-a6a4-4c99-aefe-e6e10109e308,qwen1-14B,1720874364,1720874443,finished,1720874383,1720874443,A100-SXM4-80GB,8,1,64,896,19,60
b004e7fb-92ed-4220-ad14-b5a08ab73912,qwen1-14B,1720874522,1720874618,finished,1720874541,1720874618,A100-SXM4-80GB,8,1,64,896,19,77
d216bfb5-99ea-4ad6-bed7-ff086188801c,qwen1-14B,1720874695,1720874792,finished,1720874715,1720874792,A100-SXM4-80GB,8,1,64,896,20,77
79fae738-c2b7-4e76-b87d-997971a071ea,qwen1-14B,1720874870,1720874949,finished,1720874889,1720874949,A100-SXM4-80GB,8,1,64,896,19,60
a35bb7ec-3459-478f-b0a7-50f7d4ae682e,txchen-train-task,1720874940,1720875115,finished,1720874960,1720875115,A100-SXM4-80GB,8,1,64,896,20,155
e5054a95-bb6e-418c-be6d-20f70ce2bcfe,qwen1-14B,1720875027,1720875105,finished,1720875047,1720875105,A100-SXM4-80GB,8,1,64,896,20,58
41ea3571-ea88-44e3-a14b-09e4daf15790,qwen1-14B,1720875184,1720875261,finished,1720875203,1720875261,A100-SXM4-80GB,8,1,64,896,19,58
f6572695-a514-4513-9344-5f8df1f529ec,qwen1-14B,1720875337,1720875415,finished,1720875357,1720875415,A100-SXM4-80GB,8,1,64,896,20,58
7060222c-4d6d-4637-9b69-ee19db8b4097,qwen1-14B,1720875493,1720875570,finished,1720875512,1720875570,A100-SXM4-80GB,8,1,64,896,19,58
01cc26ef-f8df-4f37-bf04-994a198b3ad5,qwen1-14B,1720875648,1720875726,finished,1720875667,1720875726,A100-SXM4-80GB,8,1,64,896,19,59
20ea2e70-f301-421d-8951-d10b0c9fffa1,qwen1-14B,1720875804,1720875883,finished,1720875824,1720875883,A100-SXM4-80GB,8,1,64,896,20,59
73ae4b2a-a9ae-47e9-bfc8-de82e90c2c67,train-0713B-lr1e-5,1720875920,1720946447,finished,1720875940,1720946447,A100-SXM4-80GB,8,1,64,896,20,70507
6108b73a-3ab4-4187-bc1a-13338982b3b7,qwen1-14B,1720875943,1720876021,finished,1720875962,1720876021,A100-SXM4-80GB,8,1,64,896,19,59
e00b8ed3-23c3-478b-9d2e-672a2e6215dd,qwen1-14B,1720876098,1720876178,finished,1720876120,1720876178,A100-SXM4-80GB,8,1,64,896,22,58
346a7c4a-c791-481d-959e-ba16ab0a205e,txchen-train-task,1720876130,1720876306,finished,1720876150,1720876306,A100-SXM4-80GB,8,1,64,896,20,156
728d11c8-7ee4-4de6-b314-baeef2f52744,qwen1-14B,1720876256,1720876335,finished,1720876276,1720876335,A100-SXM4-80GB,8,1,64,896,20,59
82016fa4-0e7f-4bff-aa08-f0b6c26a8b48,qwen1-14B,1720876414,1720876512,finished,1720876433,1720876512,A100-SXM4-80GB,8,1,64,896,19,79
b2442885-d1e9-4eb0-9559-70d6fa84d7c3,txchen-train-task,1720876541,1720876658,finished,1720876561,1720876658,A100-SXM4-80GB,8,1,64,896,20,97
09ecfd50-e926-4dcd-af12-90efc829cd42,qwen1-14B,1720876590,1720876667,finished,1720876610,1720876667,A100-SXM4-80GB,8,1,64,896,20,57
f9ae62be-083b-4822-bcde-c83dfd2d72d7,qwen1-14B,1720876745,1720876822,finished,1720876764,1720876822,A100-SXM4-80GB,8,1,64,896,19,58
6275faa6-cb90-49d9-87c5-a549ae7529b5,qwen1-14B,1720876901,1720876978,finished,1720876920,1720876978,A100-SXM4-80GB,8,1,64,896,19,58
cebea0b0-c5c3-47dc-998e-620e896cbf32,train-0713C,1720876917,1720877013,finished,1720876937,1720877013,A100-SXM4-80GB,8,1,64,896,20,76
7f8bf4a7-8643-4ace-aa7e-054fca203653,train-0713C,1720877014,1720926152,finished,1720877034,1720926152,A100-SXM4-80GB,8,1,64,896,20,49118
4e7ff32e-becd-448b-91df-1d89bcd4dfbf,qwen1-14B,1720877056,1720877134,finished,1720877075,1720877134,A100-SXM4-80GB,8,1,64,896,19,59
8f787395-1cb2-4ad5-8fc2-06ea6cf20623,qwen1-14B,1720877212,1720877308,finished,1720877231,1720877308,A100-SXM4-80GB,8,1,64,896,19,77
c2997115-0909-4276-b092-ee051bbc9fbb,tq-llm-chat-infer-1,1720877358,1720879982,finished,1720877378,1720879982,A100-SXM4-80GB,8,1,64,448,20,2604
367eafb0-3a97-4fa3-8d65-fd3b58cd02e2,qwen1-14B,1720877388,1720877466,finished,1720877407,1720877466,A100-SXM4-80GB,8,1,64,896,19,59
8b500877-2fbc-411d-86d6-6e2b1c143097,qwen1-14B,1720877545,1720877622,finished,1720877564,1720877622,A100-SXM4-80GB,8,1,64,896,19,58
46e782e6-35f6-493b-8ec7-9d038f77232e,qwen1-14B,1720877700,1720877779,finished,1720877720,1720877779,A100-SXM4-80GB,8,1,64,896,20,59
10b6cb3d-5f56-47d5-a4d1-dbdd1708d73e,qwen1-14B,1720877857,1720877955,finished,1720877876,1720877955,A100-SXM4-80GB,8,1,64,896,19,79
c31e1197-be35-4554-984e-50c1add5bb35,qwen1-14B,1720878034,1720878111,finished,1720878053,1720878111,A100-SXM4-80GB,8,1,64,896,19,58
63d79250-c762-49a6-a789-c10ea9ef2265,qwen1-14B,1720878188,1720878266,finished,1720878207,1720878266,A100-SXM4-80GB,8,1,64,896,19,59
abab5559-0a4c-40d1-9504-47de238f73a6,qwen1-14B,1720878343,1720878420,finished,1720878362,1720878420,A100-SXM4-80GB,8,1,64,896,19,58
6445dc7f-4512-4458-b151-a38f359fe140,qwen1-14B,1720878498,1720878574,finished,1720878517,1720878574,A100-SXM4-80GB,8,1,64,896,19,57
d89058a1-e1da-4566-b8f4-06937a503a6e,qwen1-14B,1720878651,1720878728,finished,1720878670,1720878728,A100-SXM4-80GB,8,1,64,896,19,58
bfa749aa-cca7-42fb-9f22-b79a3c3c77bf,qwen1-14B,1720878807,1720878904,finished,1720878826,1720878904,A100-SXM4-80GB,8,1,64,896,19,78
c246302d-c50e-492c-8a69-6e1f315ec9cb,qwen1-14B,1720878982,1720879078,finished,1720879001,1720879078,A100-SXM4-80GB,8,1,64,896,19,77
942ec91a-f55f-418f-ac50-c5c4d3c5e402,qwen1-14B,1720879155,1720879253,finished,1720879175,1720879253,A100-SXM4-80GB,8,1,64,896,20,78
6008bfcc-9391-48cc-a7a4-de21f54a46f2,qwen1-14B,1720879331,1720879409,finished,1720879350,1720879409,A100-SXM4-80GB,8,1,64,896,19,59
7982065c-120e-4cc4-b94c-9db85c26be12,qwen1-14B,1720879487,1720879566,finished,1720879508,1720879566,A100-SXM4-80GB,8,1,64,896,21,58
ded672bd-5fb5-4f70-9da7-d52a259f1144,qwen1-14B,1720879643,1720879721,finished,1720879663,1720879721,A100-SXM4-80GB,8,1,64,896,20,58
27da71d1-3f79-4abf-848e-f4a51f82d9c1,qwen1-14B,1720879798,1720879894,finished,1720879817,1720879894,A100-SXM4-80GB,8,1,64,896,19,77
baa5eb9d-8a4d-4b7d-9b01-a5f7988e6141,qwen1-14B,1720879973,1720880070,finished,1720879992,1720880070,A100-SXM4-80GB,8,1,64,896,19,78
d5450f38-b30a-493a-bbf7-01485f876877,tq-llm-chat-infer-1,1720879982,1720886827,finished,1720880001,1720886827,A100-SXM4-80GB,8,1,64,448,19,6826
cf87bc86-d3c4-40db-855d-c57ba3b90e8b,qwen1-14B,1720880148,1720880225,finished,1720880167,1720880225,A100-SXM4-80GB,8,1,64,896,19,58
e866e587-efec-46f7-839b-58528c0d3ea0,qwen1-14B,1720880303,1720880381,finished,1720880323,1720880381,A100-SXM4-80GB,8,1,64,896,20,58
3790171c-0508-4db3-b871-d715beb9b6d5,geo-05B-zero3,1720880405,1720880620,finished,1720880424,1720880620,A100-SXM4-80GB,8,1,64,896,19,196
4aa8e69d-5e59-485e-b426-3d6969c45049,qwen1-14B,1720880460,1720880539,finished,1720880480,1720880539,A100-SXM4-80GB,8,1,64,896,20,59
07ae69bc-f436-4bf5-b6ff-72bbb95bdf9b,qwen1-14B,1720880617,1720880696,finished,1720880637,1720880696,A100-SXM4-80GB,8,1,64,896,20,59
b9e8f516-2508-4655-8b23-51c210982e78,qwen1-14B,1720880774,1720880851,finished,1720880793,1720880851,A100-SXM4-80GB,8,1,64,896,19,58
ebf657ab-f242-4e12-a7be-21b9e0e411c0,qwen1-14B,1720880929,1720881006,finished,1720880948,1720881006,A100-SXM4-80GB,8,1,64,896,19,58
83fbe170-41b7-4cb7-9d9f-608ebdb11f96,qwen1-14B,1720881084,1720881161,finished,1720881103,1720881161,A100-SXM4-80GB,8,1,64,896,19,58
956ac4e1-dc6a-4a11-ace5-a9677d18d462,qwen1-14B,1720881240,1720881318,finished,1720881259,1720881318,A100-SXM4-80GB,8,1,64,896,19,59
fe1de0f0-ac5b-48bb-b8be-39a8581157c6,qwen1-14B,1720881397,1720881474,finished,1720881416,1720881474,A100-SXM4-80GB,8,1,64,896,19,58
406343d9-23d2-4264-8d85-89dd121d5ac6,geo-05B-zero3,1720881458,1721078128,finished,1720881478,1721078128,A100-SXM4-80GB,8,1,64,896,20,196650
4d1ed307-f430-40ab-9942-48949f7123b5,qwen1-14B,1720881553,1720881632,finished,1720881573,1720881632,A100-SXM4-80GB,8,1,64,896,20,59
7cacd5c1-1086-4c78-8564-30a1c34ae93d,qwen1-14B,1720881710,1720881787,finished,1720881729,1720881787,A100-SXM4-80GB,8,1,64,896,19,58
f9bd5b22-740e-4d9e-b12b-17d4d4217634,qwen1-14B,1720881866,1720881946,finished,1720881886,1720881946,A100-SXM4-80GB,8,1,64,896,20,60
05af8890-b37f-42f4-82ab-53887975f6b4,qwen1-14B,1720882024,1720882101,finished,1720882043,1720882101,A100-SXM4-80GB,8,1,64,896,19,58
417fb253-2243-47bf-a3a2-696ef2f3ca6d,qwen1-14B,1720882179,1720882277,finished,1720882199,1720882277,A100-SXM4-80GB,8,1,64,896,20,78
9c6cc454-e4f6-4847-a2b5-cdd9ca170a7c,qwen1-14B,1720882354,1720882432,finished,1720882373,1720882432,A100-SXM4-80GB,8,1,64,896,19,59
1c2dbc1b-d913-484e-a175-7d838de6e08b,qwen1-14B,1720882510,1720882588,finished,1720882530,1720882588,A100-SXM4-80GB,8,1,64,896,20,58
1d262546-da64-4848-8db3-c3c7a2430084,qwen1-14B,1720882666,1720882744,finished,1720882685,1720882744,A100-SXM4-80GB,8,1,64,896,19,59
adcea89a-479e-4119-b497-cceffb831dad,qwen1-14B,1720882823,1720882901,finished,1720882842,1720882901,A100-SXM4-80GB,8,1,64,896,19,59
091b3f23-4a3b-4d92-8aaa-ce5da7c13176,qwen1-14B,1720882980,1720883059,finished,1720883000,1720883059,A100-SXM4-80GB,8,1,64,896,20,59
206fa025-2df6-4a59-b716-9ac3ee71931f,qwen1-14B,1720883137,1720883216,finished,1720883157,1720883216,A100-SXM4-80GB,8,1,64,896,20,59
ad631705-0d9c-45c8-8caf-502aaf8b149e,qwen1-14B,1720883294,1720883392,finished,1720883314,1720883392,A100-SXM4-80GB,8,1,64,896,20,78
04b0988a-3240-4567-9426-358d85eaf9f3,qwen1-14B,1720883469,1720883547,finished,1720883489,1720883547,A100-SXM4-80GB,8,1,64,896,20,58
43e29364-ec7e-4eb8-b459-f7f77a7339df,qwen1-14B,1720883625,1720883701,finished,1720883644,1720883701,A100-SXM4-80GB,8,1,64,896,19,57
c53cface-1496-43a8-8439-cb5f8bb09ea7,qwen1-14B,1720883780,1720883857,finished,1720883800,1720883857,A100-SXM4-80GB,8,1,64,896,20,57
879bfd6e-f03c-4d4e-aae8-ae9b383587a8,qwen1-14B,1720883934,1720884012,finished,1720883954,1720884012,A100-SXM4-80GB,8,1,64,896,20,58
b641668c-ef7a-4936-a8ae-23d169fe67b0,qwen1-14B,1720884091,1720884188,finished,1720884110,1720884188,A100-SXM4-80GB,8,1,64,896,19,78
8035e24e-e0a7-4a34-8338-93e8008718a0,qwen1-14B,1720884265,1720884343,finished,1720884285,1720884343,A100-SXM4-80GB,8,1,64,896,20,58
cbbc8cb6-38a9-400d-a6ff-c73223851da7,qwen1-14B,1720884419,1720884516,finished,1720884439,1720884516,A100-SXM4-80GB,8,1,64,896,20,77
5ebc833c-4032-488b-becc-acba14eb84a4,qwen1-14B,1720884593,1720884689,finished,1720884612,1720884689,A100-SXM4-80GB,8,1,64,896,19,77
45f93c2d-8ee8-428a-b722-018065886b3a,qwen1-14B,1720884766,1720884844,finished,1720884785,1720884844,A100-SXM4-80GB,8,1,64,896,19,59
1a11c3fa-aaaf-4475-b51e-cc8ff323bc56,mixtral-8x22b-sft,1720884808,1720967186,finished,1720909720,1720967186,A100-SXM4-80GB,8,64,64,896,24912,57466
69034a64-084f-4764-820b-d43fb1a2873b,qwen1-14B,1720884921,1720884998,finished,1720884940,1720884998,A100-SXM4-80GB,8,1,64,896,19,58
18b8c2bb-b88c-469f-9c25-40a96a766352,qwen1-14B,1720885075,1720885152,finished,1720885095,1720885152,A100-SXM4-80GB,8,1,64,896,20,57
c297aa20-245c-4562-b33d-4f0721b3ddbe,qwen1-14B,1720885228,1720885307,finished,1720885248,1720885307,A100-SXM4-80GB,8,1,64,896,20,59
0c2941d1-77f2-4a84-9dc5-4c0f5aa39334,qwen1-14B,1720885385,1720885464,finished,1720885405,1720885464,A100-SXM4-80GB,8,1,64,896,20,59
948faccc-b964-43c9-bbe3-1ab8a4a6efa8,qwen1-14B,1720885542,1720885620,finished,1720885561,1720885620,A100-SXM4-80GB,8,1,64,896,19,59
94cf6456-8abd-4306-857b-2151cd6ea221,qwen1-14B,1720885696,1720885774,finished,1720885715,1720885774,A100-SXM4-80GB,8,1,64,896,19,59
631686ee-f114-4191-b0dd-d9d4c1b6c7db,qwen1-14B,1720885852,1720885930,finished,1720885872,1720885930,A100-SXM4-80GB,8,1,64,896,20,58
5aea3461-a8c8-4261-aed9-1c10a0ef181e,qwen1-14B,1720886008,1720886084,finished,1720886026,1720886084,A100-SXM4-80GB,8,1,64,896,18,58
4b698c75-dc91-4905-ab7a-6c025184bde0,qwen1-14B,1720886161,1720886238,finished,1720886181,1720886238,A100-SXM4-80GB,8,1,64,896,20,57
de5972f3-a220-49c9-b116-c139b47a9f15,qwen1-14B,1720886314,1720886389,finished,1720886333,1720886389,A100-SXM4-80GB,8,1,64,896,19,56
f66e04fe-f8ce-457c-a029-3c15c51e6518,qwen1-14B,1720886470,1720886547,finished,1720886489,1720886547,A100-SXM4-80GB,8,1,64,896,19,58
cbdb28a4-faf2-4f38-8601-c9a6ef07a7ca,qwen1-14B,1720886625,1720886702,finished,1720886645,1720886702,A100-SXM4-80GB,8,1,64,896,20,57
4cf5be0c-7f7c-49ff-89c5-fcfedf98a6a3,qwen1-14B,1720886780,1720886876,finished,1720886799,1720886876,A100-SXM4-80GB,8,1,64,896,19,77
1c1f375b-f54d-43af-9e32-0743977cca6e,qwen1-14B,1720886953,1720887050,finished,1720886973,1720887050,A100-SXM4-80GB,8,1,64,896,20,77
8572d0f2-dd81-403b-a3d8-b75dce12a2f6,qwen1-14B,1720887127,1720887203,finished,1720887146,1720887203,A100-SXM4-80GB,8,1,64,896,19,57
6a52687c-6412-481b-a29e-495694e1fa07,qwen1-14B,1720887282,1720887379,finished,1720887301,1720887379,A100-SXM4-80GB,8,1,64,896,19,78
eff0efa2-ee11-4d62-ab8a-fbe462b047eb,qwen1-14B,1720887456,1720887552,finished,1720887475,1720887552,A100-SXM4-80GB,8,1,64,896,19,77
d2dc2f0f-e033-4c11-aad7-63c9f9f3f1b8,qwen1-14B,1720887631,1720887708,finished,1720887651,1720887708,A100-SXM4-80GB,8,1,64,896,20,57
66dbffbd-c7cf-4206-8c1d-42ff876d97db,qwen1-14B,1720887784,1720887862,finished,1720887804,1720887862,A100-SXM4-80GB,8,1,64,896,20,58
7a022f2e-10e2-428e-875d-c1b1e575a795,qwen1-14B,1720887940,1720888018,finished,1720887959,1720888018,A100-SXM4-80GB,8,1,64,896,19,59
c81343d2-2eec-48c9-811e-da93f2818b1c,qwen1-14B,1720888094,1720888171,finished,1720888113,1720888171,A100-SXM4-80GB,8,1,64,896,19,58
b2400957-1e7c-466d-a32a-608124dc62ea,qwen1-14B,1720888250,1720888329,finished,1720888269,1720888329,A100-SXM4-80GB,8,1,64,896,19,60
4c6a95f0-3870-4bf6-9bba-363ac360748a,qwen1-14B,1720888407,1720888503,finished,1720888427,1720888503,A100-SXM4-80GB,8,1,64,896,20,76
9131329c-49cd-4a41-99e1-332c19dbb5de,qwen1-14B,1720888580,1720888678,finished,1720888599,1720888678,A100-SXM4-80GB,8,1,64,896,19,79
7fe1b1f0-9734-4f46-a068-5c86e0d2c1d4,qwen1-14B,1720888756,1720888851,finished,1720888774,1720888851,A100-SXM4-80GB,8,1,64,896,18,77
af607996-ac27-4af8-92ab-1116635de6c9,qwen1-14B,1720888927,1720889004,finished,1720888946,1720889004,A100-SXM4-80GB,8,1,64,896,19,58
4fddecde-acba-426c-a0b1-908891c4ba48,qwen1-14B,1720889082,1720889178,finished,1720889101,1720889178,A100-SXM4-80GB,8,1,64,896,19,77
4e84f436-af92-438b-87b5-fe9ad726e9dc,qwen1-14B,1720889256,1720889353,finished,1720889275,1720889353,A100-SXM4-80GB,8,1,64,896,19,78
b4dbd47f-a67d-4d4f-9a8f-e09234065893,qwen1-14B,1720889429,1720889507,finished,1720889448,1720889507,A100-SXM4-80GB,8,1,64,896,19,59
68168c97-69a7-4e6a-98f0-1585c8806df1,qwen1-14B,1720889583,1720889659,finished,1720889602,1720889659,A100-SXM4-80GB,8,1,64,896,19,57
370659d0-d95c-40a9-ab53-5f2a84d2f75e,qwen1-14B,1720889737,1720889836,finished,1720889757,1720889836,A100-SXM4-80GB,8,1,64,896,20,79
c5e97fe6-266e-4dc1-aa58-eb9dd8b38a3a,qwen1-14B,1720889914,1720889990,finished,1720889933,1720889990,A100-SXM4-80GB,8,1,64,896,19,57
a8f66da2-9ba2-4f03-bc05-d2df2e16918d,qwen1-14B,1720890067,1720890143,finished,1720890087,1720890143,A100-SXM4-80GB,8,1,64,896,20,56
30c26703-d1d8-4327-8502-16f3da415094,qwen1-14B,1720890222,1720890300,finished,1720890242,1720890300,A100-SXM4-80GB,8,1,64,896,20,58
7d510808-77ab-4336-bad7-bc40d3a498e9,qwen1-14B,1720890378,1720890453,finished,1720890397,1720890453,A100-SXM4-80GB,8,1,64,896,19,56
8acb5f1d-51f8-45c4-a932-9888677105b9,qwen1-14B,1720890531,1720890609,finished,1720890550,1720890609,A100-SXM4-80GB,8,1,64,896,19,59
fd331ffe-6443-448c-96e6-dd8d78488691,qwen1-14B,1720890685,1720890762,finished,1720890705,1720890762,A100-SXM4-80GB,8,1,64,896,20,57
daa93370-a677-4226-b953-999966f7af08,qwen1-14B,1720890840,1720890935,finished,1720890859,1720890935,A100-SXM4-80GB,8,1,64,896,19,76
9c4354b4-cbc1-48ec-98a2-b22d6040c0f6,qwen1-14B,1720891012,1720891089,finished,1720891032,1720891089,A100-SXM4-80GB,8,1,64,896,20,57
a23766f9-9752-4c34-aba0-dcde6fe08072,qwen1-14B,1720891165,1720891261,finished,1720891184,1720891261,A100-SXM4-80GB,8,1,64,896,19,77
bd4b7bf7-a25a-4c1d-9ff1-8aaf8abd1363,qwen1-14B,1720891338,1720891414,finished,1720891357,1720891414,A100-SXM4-80GB,8,1,64,896,19,57
098e3216-a589-48a6-adc0-ee4b99bb4efd,qwen1-14B,1720891491,1720891567,finished,1720891509,1720891567,A100-SXM4-80GB,8,1,64,896,18,58
39dcfa25-50d0-4a76-b33f-2b100071ea87,qwen1-14B,1720891644,1720891741,finished,1720891664,1720891741,A100-SXM4-80GB,8,1,64,896,20,77
ec5082c0-f170-4416-ad12-f1d33e9e3b51,qwen1-14B,1720891818,1720891914,finished,1720891838,1720891914,A100-SXM4-80GB,8,1,64,896,20,76
8ed7217b-7762-4c50-b8f1-2ca2c120ec7e,qwen1-14B,1720891989,1720892065,finished,1720892008,1720892065,A100-SXM4-80GB,8,1,64,896,19,57
7233e555-ec25-4c1e-ae8c-a1e6406fd5e0,zxx-new,1720892142,1720893340,finished,1720892202,1720893340,A100-SXM4-80GB,8,4,64,896,60,1138
f9f7b263-d4ac-4472-ae24-ed56b259215e,qwen1-14B,1720892144,1720892223,finished,1720892163,1720892223,A100-SXM4-80GB,8,1,64,896,19,60
bb0d4747-d49c-40dd-a4c4-730a78e35426,qwen1-14B,1720892303,1720892381,finished,1720892323,1720892381,A100-SXM4-80GB,8,1,64,896,20,58
0e021147-ba5d-4a1b-a087-994d4763d9ab,qwen1-14B,1720892457,1720892534,finished,1720892477,1720892534,A100-SXM4-80GB,8,1,64,896,20,57
7ca088c8-0271-4190-bbc1-6eb7fc5c8497,qwen1-14B,1720892612,1720892689,finished,1720892631,1720892689,A100-SXM4-80GB,8,1,64,896,19,58
6523afe1-4949-4990-9083-8f4c7cb335c8,qwen1-14B,1720892765,1720892842,finished,1720892784,1720892842,A100-SXM4-80GB,8,1,64,896,19,58
17fae8f6-0e26-4d1b-9c11-f2a7c15fe7f8,qwen1-14B,1720892918,1720892995,finished,1720892937,1720892995,A100-SXM4-80GB,8,1,64,896,19,58
ffe51df8-346d-4026-8cab-e9befe8ec020,qwen1-14B,1720893072,1720893147,finished,1720893091,1720893147,A100-SXM4-80GB,8,1,64,896,19,56
a1bf5f05-65d4-48aa-9216-259f8d55afa8,qwen1-14B,1720893224,1720893303,finished,1720893244,1720893303,A100-SXM4-80GB,8,1,64,896,20,59
a65e15b5-6c80-412a-ac9a-d8788e6f3608,qwen1-14B,1720893380,1720893458,finished,1720893400,1720893458,A100-SXM4-80GB,8,1,64,896,20,58
af049e55-c179-424c-bc38-6ce4d21e2783,qwen1-14B,1720893535,1720893612,finished,1720893554,1720893612,A100-SXM4-80GB,8,1,64,896,19,58
75a79dc4-8620-4d3c-8c88-77c0ca1042b8,qwen1-14B,1720893691,1720893789,finished,1720893711,1720893789,A100-SXM4-80GB,8,1,64,896,20,78
11c6ee54-cf89-4223-aeaf-9ec1773d91ce,qwen1-14B,1720893865,1720893962,finished,1720893885,1720893962,A100-SXM4-80GB,8,1,64,896,20,77
b1980620-e61a-4332-81e9-9f1f97001a5b,qwen1-14B,1720894040,1720894118,finished,1720894059,1720894118,A100-SXM4-80GB,8,1,64,896,19,59
512a1155-ff7d-4465-b20a-e7747f94642e,qwen1-14B,1720894195,1720894271,finished,1720894214,1720894271,A100-SXM4-80GB,8,1,64,896,19,57
c5410d29-276e-4830-b920-7d3dc3e5cab7,qwen1-14B,1720894346,1720894422,finished,1720894365,1720894422,A100-SXM4-80GB,8,1,64,896,19,57
cc5bce76-a48c-4718-82f0-25ec72eab4a7,qwen1-14B,1720894498,1720894574,finished,1720894517,1720894574,A100-SXM4-80GB,8,1,64,896,19,57
04c18135-9539-4968-90cf-e9cf390ed30f,qwen1-14B,1720894651,1720894727,finished,1720894670,1720894727,A100-SXM4-80GB,8,1,64,896,19,57
64c19f57-eb0c-4678-a055-77153e33b5ce,qwen1-14B,1720894805,1720894901,finished,1720894825,1720894901,A100-SXM4-80GB,8,1,64,896,20,76
3a32276a-4137-4eed-a1c7-f9c50e38f2d1,qwen1-14B,1720894978,1720895074,finished,1720894997,1720895074,A100-SXM4-80GB,8,1,64,896,19,77
9ef84699-e333-4433-97f2-23e0f3243b00,qwen1-14B,1720895150,1720895228,finished,1720895169,1720895228,A100-SXM4-80GB,8,1,64,896,19,59
de2a4cc2-6773-4790-91b4-9ae5c19d2aeb,qwen1-14B,1720895305,1720895383,finished,1720895324,1720895383,A100-SXM4-80GB,8,1,64,896,19,59
4ad3e4c1-60b0-4bfa-b384-96f271a63ceb,qwen1-14B,1720895460,1720895538,finished,1720895480,1720895538,A100-SXM4-80GB,8,1,64,896,20,58
f4fdf8b9-ef30-46d3-b946-a0a2ea96b87d,qwen1-14B,1720895616,1720895694,finished,1720895635,1720895694,A100-SXM4-80GB,8,1,64,896,19,59
fab5ab3a-1175-4fd9-bc9d-35450c78bd5e,qwen1-14B,1720895772,1720895850,finished,1720895792,1720895850,A100-SXM4-80GB,8,1,64,896,20,58
c3b7a328-51a1-4d34-ab3e-675358c27b67,qwen1-14B,1720895929,1720896024,finished,1720895948,1720896024,A100-SXM4-80GB,8,1,64,896,19,76
52cd5522-3fa4-4be9-9890-dbd0da003a29,qwen1-14B,1720896101,1720896178,finished,1720896120,1720896178,A100-SXM4-80GB,8,1,64,896,19,58
e37ad95c-c319-4630-8fc9-1c789bdf9f29,qwen1-14B,1720896254,1720896331,finished,1720896273,1720896331,A100-SXM4-80GB,8,1,64,896,19,58
56573f21-b235-4b6f-98ab-ea323773ee37,qwen1-14B,1720896407,1720896483,finished,1720896426,1720896483,A100-SXM4-80GB,8,1,64,896,19,57
f634f9a6-19fe-4573-979e-c339fde8f5d1,qwen1-14B,1720896559,1720896637,finished,1720896579,1720896637,A100-SXM4-80GB,8,1,64,896,20,58
12eca0b0-4abe-410f-b0af-19197b3957bb,qwen1-14B,1720896713,1720896791,finished,1720896732,1720896791,A100-SXM4-80GB,8,1,64,896,19,59
b5039064-c71d-419b-9ce6-81a6a8c07d76,qwen1-14B,1720896867,1720896943,finished,1720896886,1720896943,A100-SXM4-80GB,8,1,64,896,19,57
e996f664-0e0d-4ce6-b4cd-0274d9ced9bb,qwen1-14B,1720897019,1720897097,finished,1720897039,1720897097,A100-SXM4-80GB,8,1,64,896,20,58
ef94c11d-6fcc-4231-b748-9974e08986a5,qwen1-14B,1720897175,1720897253,finished,1720897195,1720897253,A100-SXM4-80GB,8,1,64,896,20,58
7afd6ac0-e10a-4a4f-aea4-96563eb60d37,qwen1-14B,1720897329,1720897406,finished,1720897348,1720897406,A100-SXM4-80GB,8,1,64,896,19,58
988d0fa9-9330-4cff-a700-49376e12baaf,qwen1-14B,1720897482,1720897559,finished,1720897501,1720897559,A100-SXM4-80GB,8,1,64,896,19,58
4b43378a-31fa-4da8-951e-54abc4044d08,qwen1-14B,1720897635,1720897712,finished,1720897654,1720897712,A100-SXM4-80GB,8,1,64,896,19,58
78c07806-b566-4102-aa4b-3bceecb9ca07,qwen1-14B,1720897790,1720897886,finished,1720897809,1720897886,A100-SXM4-80GB,8,1,64,896,19,77
5253a75b-34a2-47b5-96f5-716c8b7fc629,qwen1-14B,1720897962,1720898038,finished,1720897981,1720898038,A100-SXM4-80GB,8,1,64,896,19,57
59969635-e7f4-48f2-b146-596eeee4f262,qwen1-14B,1720898115,1720898191,finished,1720898134,1720898191,A100-SXM4-80GB,8,1,64,896,19,57
26298b64-f965-4d74-89d6-6ecc8f6a6013,qwen1-14B,1720898267,1720898344,finished,1720898286,1720898344,A100-SXM4-80GB,8,1,64,896,19,58
d0fe6eb8-d1b8-4571-b763-e7a7f7293a2e,qwen1-14B,1720898421,1720898497,finished,1720898440,1720898497,A100-SXM4-80GB,8,1,64,896,19,57
8ff29c81-1170-4be2-a650-beada7019374,qwen1-14B,1720898574,1720898651,finished,1720898594,1720898651,A100-SXM4-80GB,8,1,64,896,20,57
82db58e2-8af4-48b8-905e-b1b77ee6eb09,qwen1-14B,1720898728,1720898805,finished,1720898747,1720898805,A100-SXM4-80GB,8,1,64,896,19,58
1d26fbf9-44ed-496b-bf2b-fe99f756fde6,qwen1-14B,1720898883,1720898960,finished,1720898902,1720898960,A100-SXM4-80GB,8,1,64,896,19,58
d1d7e724-243c-4fe4-bf91-6909df6ec67c,qwen1-14B,1720899037,1720899133,finished,1720899056,1720899133,A100-SXM4-80GB,8,1,64,896,19,77
5be2c5b6-b1e6-41f9-89db-76b2a0ca43bb,qwen1-14B,1720899210,1720899287,finished,1720899229,1720899287,A100-SXM4-80GB,8,1,64,896,19,58
68fd866d-4824-426e-8f4a-f52e29bb742d,qwen1-14B,1720899365,1720899461,finished,1720899384,1720899461,A100-SXM4-80GB,8,1,64,896,19,77
35fd56d3-5906-4f30-a645-fbae7019dcf2,qwen1-14B,1720899537,1720899614,finished,1720899557,1720899614,A100-SXM4-80GB,8,1,64,896,20,57
77418bad-825f-4c94-9c87-389a2245df54,qwen1-14B,1720899691,1720899768,finished,1720899710,1720899768,A100-SXM4-80GB,8,1,64,896,19,58
39092751-e7b2-4d74-ad71-c7cd433b740e,qwen1-14B,1720899845,1720899922,finished,1720899865,1720899922,A100-SXM4-80GB,8,1,64,896,20,57
ba04882f-aeff-42bd-8d50-eac50e9739c9,qwen1-14B,1720899999,1720900096,finished,1720900018,1720900096,A100-SXM4-80GB,8,1,64,896,19,78
e85e2f08-4833-40c8-866d-7f32da7ce0a7,qwen1-14B,1720900172,1720900268,finished,1720900191,1720900268,A100-SXM4-80GB,8,1,64,896,19,77
4f598eeb-8ade-4b17-b6a5-1ce44d939512,qwen1-14B,1720900345,1720900423,finished,1720900365,1720900423,A100-SXM4-80GB,8,1,64,896,20,58
4b7621d7-04a4-40f9-95dc-9df470084725,qwen1-14B,1720900501,1720900596,finished,1720900520,1720900596,A100-SXM4-80GB,8,1,64,896,19,76
70b06b50-a074-4b50-a19c-177330401d9d,qwen1-14B,1720900673,1720900768,finished,1720900692,1720900768,A100-SXM4-80GB,8,1,64,896,19,76
8bb65206-fff8-496b-8718-6b700a6d7cc1,qwen1-14B,1720900847,1720900943,finished,1720900866,1720900943,A100-SXM4-80GB,8,1,64,896,19,77
e5ad8b30-7acb-4df0-914c-b551dc87068d,qwen1-14B,1720901020,1720901096,finished,1720901039,1720901096,A100-SXM4-80GB,8,1,64,896,19,57
abb571a4-7ac6-48b8-9f33-d46a9d81e39c,qwen1-14B,1720901173,1720901249,finished,1720901192,1720901249,A100-SXM4-80GB,8,1,64,896,19,57
354debc4-4e83-46e8-85d3-1bc439f2d861,qwen1-14B,1720901325,1720901402,finished,1720901344,1720901402,A100-SXM4-80GB,8,1,64,896,19,58
8dab2397-d786-4723-8a38-7cd92a2fb04e,qwen1-14B,1720901478,1720901556,finished,1720901498,1720901556,A100-SXM4-80GB,8,1,64,896,20,58
e0e10779-5139-478b-b81b-6e020679bad8,qwen1-14B,1720901632,1720901709,finished,1720901652,1720901709,A100-SXM4-80GB,8,1,64,896,20,57
753a85bf-bb52-45b2-a104-4ad3c57ac134,qwen1-14B,1720901786,1720901860,finished,1720901804,1720901860,A100-SXM4-80GB,8,1,64,896,18,56
51841786-1cf9-41d8-9bea-3fa02ebb8c25,qwen1-14B,1720901936,1720902012,finished,1720901955,1720902012,A100-SXM4-80GB,8,1,64,896,19,57
b8d79141-ce6d-46f9-ac77-c93903db8a55,qwen1-14B,1720902088,1720902164,finished,1720902107,1720902164,A100-SXM4-80GB,8,1,64,896,19,57
9464544b-4309-4f48-a5ae-650390d521b1,qwen1-14B,1720902240,1720902318,finished,1720902259,1720902318,A100-SXM4-80GB,8,1,64,896,19,59
2e74af0e-e083-4f8d-8810-883362ce819e,qwen1-14B,1720902395,1720902470,finished,1720902414,1720902470,A100-SXM4-80GB,8,1,64,896,19,56
71f6a90e-e68d-417c-b02b-ef767be17af8,qwen1-14B,1720902548,1720902624,finished,1720902567,1720902624,A100-SXM4-80GB,8,1,64,896,19,57
2d132097-4248-46c6-a622-22739e19ab4a,qwen1-14B,1720902701,1720902778,finished,1720902721,1720902778,A100-SXM4-80GB,8,1,64,896,20,57
40477c0b-7668-4125-a19b-59058b8da6eb,qwen1-14B,1720902855,1720902931,finished,1720902874,1720902931,A100-SXM4-80GB,8,1,64,896,19,57
c15abe88-e8ed-44c4-9441-2053d39981fd,qwen1-14B,1720903008,1720903084,finished,1720903027,1720903084,A100-SXM4-80GB,8,1,64,896,19,57
55652b13-9cae-4929-a40b-ed83a99622a9,qwen1-14B,1720903162,1720903239,finished,1720903182,1720903239,A100-SXM4-80GB,8,1,64,896,20,57
3c50a460-dbde-4900-a91c-aa8a0e5ed14a,qwen1-14B,1720903315,1720903391,finished,1720903335,1720903391,A100-SXM4-80GB,8,1,64,896,20,56
8f35be1a-4646-40e8-b7a3-8814991d617a,qwen1-14B,1720903468,1720903545,finished,1720903488,1720903545,A100-SXM4-80GB,8,1,64,896,20,57
947a6e25-433c-491c-aa9f-4f5b7dbb7b84,qwen1-14B,1720903622,1720903699,finished,1720903641,1720903698,A100-SXM4-80GB,8,1,64,896,19,57
d386ef2f-d88b-4797-aaad-1d8ea0827005,qwen1-14B,1720903775,1720903852,finished,1720903794,1720903852,A100-SXM4-80GB,8,1,64,896,19,58
8941794a-e839-43bd-9aa9-a0d9f24841c5,qwen1-14B,1720903928,1720904024,finished,1720903947,1720904024,A100-SXM4-80GB,8,1,64,896,19,77
e296da09-02ef-449c-9e54-1b1aaff58e3b,qwen1-14B,1720904102,1720904181,finished,1720904122,1720904181,A100-SXM4-80GB,8,1,64,896,20,59
48115b3d-2c67-466c-aaf4-6d919bb95433,qwen1-14B,1720904258,1720904334,finished,1720904277,1720904334,A100-SXM4-80GB,8,1,64,896,19,57
e195f07e-6c76-4b87-8451-1e906d05f1af,qwen1-14B,1720904410,1720904486,finished,1720904429,1720904486,A100-SXM4-80GB,8,1,64,896,19,57
f9737560-00f9-4213-bec1-eb784fa6a4de,qwen1-14B,1720904562,1720904638,finished,1720904581,1720904638,A100-SXM4-80GB,8,1,64,896,19,57
65b94b69-fcf2-457f-9482-273ca7dd91ef,qwen1-14B,1720904716,1720904792,finished,1720904735,1720904792,A100-SXM4-80GB,8,1,64,896,19,57
70282805-2261-40fa-a1d3-dc8c589cd91d,qwen1-14B,1720904868,1720904945,finished,1720904887,1720904945,A100-SXM4-80GB,8,1,64,896,19,58
120f8a4f-db5c-41d8-a4a4-4618f1519b7f,qwen1-14B,1720905022,1720905099,finished,1720905041,1720905099,A100-SXM4-80GB,8,1,64,896,19,58
b8ef2e68-cf55-449f-bee8-914e15d9d768,qwen1-14B,1720905176,1720905252,finished,1720905196,1720905252,A100-SXM4-80GB,8,1,64,896,20,56
7b5dfcb9-b307-4e04-b744-91ec54aceeb3,qwen1-14B,1720905329,1720905405,finished,1720905348,1720905405,A100-SXM4-80GB,8,1,64,896,19,57
e544afe1-11bd-454e-ae66-cdcdf2126d64,qwen1-14B,1720905483,1720905560,finished,1720905502,1720905560,A100-SXM4-80GB,8,1,64,896,19,58
c05cf438-8337-4df8-85be-60c367dd2964,qwen1-14B,1720905637,1720905713,finished,1720905656,1720905713,A100-SXM4-80GB,8,1,64,896,19,57
a65ef200-d89f-4df3-b148-1b79ddf02761,qwen1-14B,1720905791,1720905868,finished,1720905810,1720905868,A100-SXM4-80GB,8,1,64,896,19,58
76326186-4543-4aee-89e2-76dae9c1e0fd,qwen1-14B,1720905945,1720906022,finished,1720905964,1720906022,A100-SXM4-80GB,8,1,64,896,19,58
3023305e-9091-4295-a505-2c5e0a0f002c,qwen1-14B,1720906098,1720906173,finished,1720906117,1720906173,A100-SXM4-80GB,8,1,64,896,19,56
d6c70f33-f3fd-4c31-a444-25f74e3e39fc,qwen1-14B,1720906250,1720906326,finished,1720906269,1720906326,A100-SXM4-80GB,8,1,64,896,19,57
626f88ae-ee25-4c46-8d33-d79d8aa3fb37,qwen1-14B,1720906403,1720906480,finished,1720906422,1720906480,A100-SXM4-80GB,8,1,64,896,19,58
cc43e9cc-8910-48e7-8090-06e1f27117ff,qwen1-14B,1720906556,1720906632,finished,1720906575,1720906632,A100-SXM4-80GB,8,1,64,896,19,57
fe2f3ee2-9153-4453-8354-e5d88a635457,qwen1-14B,1720906708,1720906785,finished,1720906727,1720906785,A100-SXM4-80GB,8,1,64,896,19,58
c19b3cf7-13cf-4ec6-8ebc-9e52e6b19122,qwen1-14B,1720906862,1720906939,finished,1720906882,1720906939,A100-SXM4-80GB,8,1,64,896,20,57
dba8431a-2ab1-4d81-bd1a-1678d4e4db92,qwen1-14B,1720907015,1720907090,finished,1720907034,1720907090,A100-SXM4-80GB,8,1,64,896,19,56
36d26d47-ef55-4ac6-869e-514dd0aad0d9,qwen1-14B,1720907166,1720907241,finished,1720907185,1720907241,A100-SXM4-80GB,8,1,64,896,19,56
faa6cfd3-26eb-4f1d-8ecd-d9f810497c54,qwen1-14B,1720907318,1720907414,finished,1720907338,1720907414,A100-SXM4-80GB,8,1,64,896,20,76
4d68c262-3c8b-47ea-b5f5-bd779197c013,qwen1-14B,1720907490,1720907565,finished,1720907509,1720907565,A100-SXM4-80GB,8,1,64,896,19,56
4b32e81b-7759-41fe-9722-125507d5825e,qwen1-14B,1720907640,1720907717,finished,1720907660,1720907717,A100-SXM4-80GB,8,1,64,896,20,57
620cc0ce-411a-4750-8c7a-0b7b9d6c81cd,qwen1-14B,1720907795,1720907872,finished,1720907814,1720907872,A100-SXM4-80GB,8,1,64,896,19,58
84918956-29bd-4d95-81f5-33729a77a063,qwen1-14B,1720907948,1720908027,finished,1720907968,1720908027,A100-SXM4-80GB,8,1,64,896,20,59
16880f0d-06ec-4e7d-ab78-d6332724d53f,qwen1-14B,1720908104,1720908181,finished,1720908124,1720908181,A100-SXM4-80GB,8,1,64,896,20,57
23cbe36f-b3d1-4a34-85bf-14d7a0c7d092,qwen1-14B,1720908258,1720908335,finished,1720908278,1720908335,A100-SXM4-80GB,8,1,64,896,20,57
653e2b96-ce52-4a44-987b-523708a1f31f,qwen1-14B,1720908412,1720908489,finished,1720908431,1720908489,A100-SXM4-80GB,8,1,64,896,19,58
4a0aaaa2-7985-498c-8fe7-473365969398,qwen1-14B,1720908566,1720908642,finished,1720908584,1720908642,A100-SXM4-80GB,8,1,64,896,18,58
4c1c9c93-e918-47d1-bccb-0aeaf5e1b829,qwen1-14B,1720908719,1720908795,finished,1720908738,1720908795,A100-SXM4-80GB,8,1,64,896,19,57
7151765f-c526-4192-a7c4-9d682ae78ba0,qwen1-14B,1720908873,1720908950,finished,1720908892,1720908950,A100-SXM4-80GB,8,1,64,896,19,58
c4e96505-76b1-4abb-989c-9367d8c77342,qwen1-14B,1720909027,1720909121,finished,1720909046,1720909121,A100-SXM4-80GB,8,1,64,896,19,75
d7288a2d-9ca9-4f73-a14a-2e120d09f0ef,qwen1-14B,1720909200,1720909296,finished,1720909219,1720909296,A100-SXM4-80GB,8,1,64,896,19,77
5d0a3b98-d56e-4f37-aaff-0bb13b1df3ed,qwen1-14B,1720909372,1720909448,finished,1720909391,1720909448,A100-SXM4-80GB,8,1,64,896,19,57
fd768884-a6a6-4391-83fb-7167f0d1760b,qwen1-14B,1720909525,1720909601,finished,1720909544,1720909601,A100-SXM4-80GB,8,1,64,896,19,57
b86bf245-c938-4d96-9751-5e18e506b8ff,qwen1-14B,1720909678,1720909781,finished,1720909697,1720909781,A100-SXM4-80GB,8,1,64,896,19,84
288ceb2e-10d0-4d85-8453-8a5a117ec7d3,qwen1-14B,1720909857,1720909933,finished,1720909876,1720909933,A100-SXM4-80GB,8,1,64,896,19,57
88b31145-1931-4ca8-83d2-a3f681064ace,qwen1-14B,1720910010,1720910086,finished,1720910029,1720910086,A100-SXM4-80GB,8,1,64,896,19,57
75038bd3-f5ad-4887-90ca-65015be03750,qwen1-14B,1720910164,1720910240,finished,1720910183,1720910240,A100-SXM4-80GB,8,1,64,896,19,57
53b737de-6b51-4164-8474-bd0f66bd7bd0,qwen1-14B,1720910317,1720910394,finished,1720910336,1720910394,A100-SXM4-80GB,8,1,64,896,19,58
a96dc546-6334-4233-9ecb-ea760169b52c,qwen1-14B,1720910471,1720910546,finished,1720910490,1720910546,A100-SXM4-80GB,8,1,64,896,19,56
5ac1b0ec-3e75-4948-ab4c-224c9f7bf6ff,qwen1-14B,1720910624,1720910701,finished,1720910643,1720910701,A100-SXM4-80GB,8,1,64,896,19,58
3c672a58-cb65-455a-b2d2-c0a5a37b7b59,qwen1-14B,1720910777,1720910853,finished,1720910796,1720910853,A100-SXM4-80GB,8,1,64,896,19,57
69961457-c352-43da-bdb3-eecdbe803ac1,qwen1-14B,1720910930,1720911007,finished,1720910949,1720911007,A100-SXM4-80GB,8,1,64,896,19,58
e526152b-3a35-4a05-a06f-75a6a064eddb,qwen1-14B,1720911084,1720911159,finished,1720911103,1720911159,A100-SXM4-80GB,8,1,64,896,19,56
76e46ea0-bb1e-4e95-88f1-e7138549fefd,qwen1-14B,1720911236,1720911332,finished,1720911255,1720911332,A100-SXM4-80GB,8,1,64,896,19,77
f81f31b6-fa24-4b9f-8319-a3a55c3ae1e7,qwen1-14B,1720911410,1720911488,finished,1720911429,1720911488,A100-SXM4-80GB,8,1,64,896,19,59
eaeb5a55-6e27-4288-9b59-5d5a80f7f118,qwen1-14B,1720911564,1720911641,finished,1720911583,1720911641,A100-SXM4-80GB,8,1,64,896,19,58
23301c76-1ff4-426c-9ac9-bf73ce8a233a,qwen1-14B,1720911718,1720911795,finished,1720911737,1720911795,A100-SXM4-80GB,8,1,64,896,19,58
7e1aef42-9acf-4cd9-a40a-ade4b1643861,qwen1-14B,1720911872,1720911948,finished,1720911891,1720911948,A100-SXM4-80GB,8,1,64,896,19,57
3b5601f3-1b72-477e-af38-0bd9d61bae9b,qwen1-14B,1720912022,1720912116,finished,1720912041,1720912116,A100-SXM4-80GB,8,1,64,896,19,75
32ab3936-0fc4-4892-a429-ffcd083ba7a2,qwen1-14B,1720912192,1720912268,finished,1720912211,1720912268,A100-SXM4-80GB,8,1,64,896,19,57
63f66377-49dc-416f-94b7-38bd97be3091,qwen1-14B,1720912345,1720912420,finished,1720912364,1720912420,A100-SXM4-80GB,8,1,64,896,19,56
816ddd5a-08ba-43fc-a872-e0e03f28bf74,qwen1-14B,1720912496,1720912572,finished,1720912515,1720912572,A100-SXM4-80GB,8,1,64,896,19,57
16fd159a-d366-405f-9a48-07d661e899ca,qwen1-14B,1720912648,1720912742,finished,1720912667,1720912742,A100-SXM4-80GB,8,1,64,896,19,75
f843421f-09f5-44a7-a4a7-fd8217e801a9,qwen1-14B,1720912819,1720912895,finished,1720912838,1720912895,A100-SXM4-80GB,8,1,64,896,19,57
90ccfdbc-5000-47ee-8a40-db525186bac7,qwen1-14B,1720912973,1720913049,finished,1720912992,1720913049,A100-SXM4-80GB,8,1,64,896,19,57
c7a53405-9173-48f4-bbf7-94127e1d749d,qwen1-14B,1720913127,1720913204,finished,1720913147,1720913204,A100-SXM4-80GB,8,1,64,896,20,57
243da3ea-9dcf-47bb-b6aa-f1230b7f8a7f,qwen1-14B,1720913282,1720913358,finished,1720913301,1720913358,A100-SXM4-80GB,8,1,64,896,19,57
9736cd2b-c79a-4490-b5f1-e0a29ac9776f,qwen1-14B,1720913433,1720913508,finished,1720913452,1720913508,A100-SXM4-80GB,8,1,64,896,19,56
bec90155-0cbc-4b7d-9a95-9b8d8735e8f6,qwen1-14B,1720913588,1720913664,finished,1720913607,1720913664,A100-SXM4-80GB,8,1,64,896,19,57
8c650231-69b2-4d6f-be3d-cdf39a720b88,qwen1-14B,1720913740,1720913816,finished,1720913760,1720913816,A100-SXM4-80GB,8,1,64,896,20,56
fbfea7d7-41c8-45bb-ad68-121a49eed486,qwen1-14B,1720913893,1720913968,finished,1720913912,1720913968,A100-SXM4-80GB,8,1,64,896,19,56
ab1d705a-5e03-4c14-8f2c-14ebd8f2cedf,qwen1-14B,1720914046,1720914122,finished,1720914065,1720914122,A100-SXM4-80GB,8,1,64,896,19,57
cbee84ec-32da-4acc-8d4e-acd009552268,qwen1-14B,1720914199,1720914276,finished,1720914218,1720914276,A100-SXM4-80GB,8,1,64,896,19,58
0b1c4f2b-3831-40f1-b28c-1da9049da805,qwen1-14B,1720914352,1720914446,finished,1720914371,1720914446,A100-SXM4-80GB,8,1,64,896,19,75
f0b19da5-1293-4a52-845d-b2de35444cb7,qwen1-14B,1720914522,1720914597,finished,1720914540,1720914597,A100-SXM4-80GB,8,1,64,896,18,57
1baf9645-73ff-4e92-8e85-7466388bf40c,qwen1-14B,1720914674,1720914750,finished,1720914693,1720914750,A100-SXM4-80GB,8,1,64,896,19,57
515ea67f-4d19-4087-bf67-ba7a8b234172,qwen1-14B,1720914827,1720914903,finished,1720914846,1720914903,A100-SXM4-80GB,8,1,64,896,19,57
c940574d-5783-4b54-a72f-68dd74f7d11a,qwen1-14B,1720914980,1720915057,finished,1720914999,1720915057,A100-SXM4-80GB,8,1,64,896,19,58
cf1d74a5-8bdd-4523-8df5-92e21ef59398,qwen1-14B,1720915134,1720915211,finished,1720915153,1720915211,A100-SXM4-80GB,8,1,64,896,19,58
41ef1d94-eb9c-4dc6-b6a7-0ca198dd27a3,qwen1-14B,1720915290,1720915385,finished,1720915310,1720915385,A100-SXM4-80GB,8,1,64,896,20,75
82292f41-1786-4d7f-8a1f-3319d7ef8023,qwen1-14B,1720915461,1720915537,finished,1720915480,1720915537,A100-SXM4-80GB,8,1,64,896,19,57
7ee8f7d8-5863-4e43-8c87-9cc23a967ef7,qwen1-14B,1720915613,1720915690,finished,1720915632,1720915690,A100-SXM4-80GB,8,1,64,896,19,58
c9550184-d467-43e0-85bf-1b01f7c1b1f3,qwen1-14B,1720915766,1720915843,finished,1720915785,1720915843,A100-SXM4-80GB,8,1,64,896,19,58
e14d1ab6-506f-426b-9cf2-48470776a5d9,qwen1-14B,1720915920,1720915996,finished,1720915939,1720915996,A100-SXM4-80GB,8,1,64,896,19,57
608c2e65-16a6-41b9-9cc9-b114b998d8c6,qwen1-14B,1720916073,1720916149,finished,1720916093,1720916149,A100-SXM4-80GB,8,1,64,896,20,56
b2ae9371-c688-4fc5-b43c-bf39b3e6f3ba,qwen1-14B,1720916227,1720916303,finished,1720916246,1720916303,A100-SXM4-80GB,8,1,64,896,19,57
cd1ebd60-e9f2-455f-8bd1-0e0fb12a7084,qwen1-14B,1720916380,1720916456,finished,1720916399,1720916456,A100-SXM4-80GB,8,1,64,896,19,57
07827f8a-8cd3-4d7f-9b3d-75378124cc54,qwen1-14B,1720916534,1720916611,finished,1720916553,1720916611,A100-SXM4-80GB,8,1,64,896,19,58
1c4b3915-c838-40f1-857f-c619195952bd,qwen1-14B,1720916687,1720916765,finished,1720916706,1720916765,A100-SXM4-80GB,8,1,64,896,19,59
d080f19e-6622-4d30-9e19-e6a61c30a035,qwen1-14B,1720916842,1720916919,finished,1720916861,1720916919,A100-SXM4-80GB,8,1,64,896,19,58
eed686cd-66e4-4e30-98a2-c4d5a07b8444,qwen1-14B,1720916997,1720917073,finished,1720917016,1720917073,A100-SXM4-80GB,8,1,64,896,19,57
88d3a9cb-d3c5-4868-800f-c6417a177790,qwen1-14B,1720917151,1720917227,finished,1720917170,1720917227,A100-SXM4-80GB,8,1,64,896,19,57
864dfebf-361b-4c6f-b67a-eb36f425eb46,qwen1-14B,1720917303,1720917382,finished,1720917323,1720917382,A100-SXM4-80GB,8,1,64,896,20,59
4aef832b-637a-4580-8ce1-597a08e4cb6c,qwen1-14B,1720917459,1720917537,finished,1720917478,1720917537,A100-SXM4-80GB,8,1,64,896,19,59
c1f30c5e-8d70-4821-9417-02cfbb221950,qwen1-14B,1720917613,1720917709,finished,1720917633,1720917709,A100-SXM4-80GB,8,1,64,896,20,76
44100bf3-d44d-44eb-9c17-e56385f258b0,qwen1-14B,1720917787,1720917882,finished,1720917807,1720917882,A100-SXM4-80GB,8,1,64,896,20,75
549f74e6-cd83-48d6-9515-0666fbd38be4,qwen1-14B,1720917960,1720918036,finished,1720917979,1720918036,A100-SXM4-80GB,8,1,64,896,19,57
0bc328aa-fead-489d-b6c9-f1debc77df16,qwen1-14B,1720918114,1720918189,finished,1720918132,1720918189,A100-SXM4-80GB,8,1,64,896,18,57
ec3b156b-8080-43e2-b1af-ce055b810b61,qwen1-14B,1720918266,1720918343,finished,1720918286,1720918343,A100-SXM4-80GB,8,1,64,896,20,57
7b50dfaa-49ef-43d1-b3e9-8d5fee481c8e,qwen1-14B,1720918420,1720918497,finished,1720918439,1720918497,A100-SXM4-80GB,8,1,64,896,19,58
7acb1029-24e1-4aea-bd65-b5a4c39132bd,qwen1-14B,1720918574,1720918650,finished,1720918593,1720918650,A100-SXM4-80GB,8,1,64,896,19,57
13f94343-fa13-4c8f-91b4-8063bd57d95e,qwen1-14B,1720918727,1720918805,finished,1720918747,1720918805,A100-SXM4-80GB,8,1,64,896,20,58
465bd8b7-c2cd-4cc2-b676-8d5f7f8931e8,qwen1-14B,1720918881,1720918959,finished,1720918900,1720918959,A100-SXM4-80GB,8,1,64,896,19,59
ad543d09-d1f4-4785-abc2-823cd678a433,qwen1-14B,1720919038,1720919133,finished,1720919057,1720919133,A100-SXM4-80GB,8,1,64,896,19,76
9a457bdc-e015-4022-9d56-f1f20e29809d,qwen1-14B,1720919210,1720919287,finished,1720919229,1720919287,A100-SXM4-80GB,8,1,64,896,19,58
1d493872-d307-480a-9cb6-5f4d82aed4f2,qwen1-14B,1720919363,1720919460,finished,1720919382,1720919460,A100-SXM4-80GB,8,1,64,896,19,78
86c421fb-6c71-4fcc-8d16-17d527573f05,qwen1-14B,1720919537,1720919634,finished,1720919556,1720919634,A100-SXM4-80GB,8,1,64,896,19,78
d61aecf6-0e73-44f8-bab2-9b516e7ae71a,qwen1-14B,1720919711,1720919807,finished,1720919730,1720919807,A100-SXM4-80GB,8,1,64,896,19,77
591756c1-1444-4c18-9163-29e9463d9e0f,qwen1-14B,1720919883,1720919961,finished,1720919902,1720919961,A100-SXM4-80GB,8,1,64,896,19,59
66299613-0b5b-4c4f-9688-e7657bb4b1d1,qwen1-14B,1720920037,1720920114,finished,1720920056,1720920114,A100-SXM4-80GB,8,1,64,896,19,58
66ab75c4-dbb1-4218-b16f-7e37479a1328,qwen1-14B,1720920190,1720920267,finished,1720920209,1720920267,A100-SXM4-80GB,8,1,64,896,19,58
34c79a31-6eef-474e-a33e-cca39cdd56f6,qwen1-14B,1720920343,1720920420,finished,1720920362,1720920420,A100-SXM4-80GB,8,1,64,896,19,58
e059242e-9d93-4467-8be7-757fd50a1d94,qwen1-14B,1720920496,1720920574,finished,1720920515,1720920574,A100-SXM4-80GB,8,1,64,896,19,59
ac0bb3ff-8b5a-43e2-b265-d2116095cc34,qwen1-14B,1720920650,1720920727,finished,1720920669,1720920727,A100-SXM4-80GB,8,1,64,896,19,58
19565590-08af-42ed-a057-45c67049b9ee,qwen1-14B,1720920804,1720920880,finished,1720920823,1720920880,A100-SXM4-80GB,8,1,64,896,19,57
3d3f67af-9674-409a-9b57-a49fed52faf2,qwen1-14B,1720920956,1720921033,finished,1720920975,1720921033,A100-SXM4-80GB,8,1,64,896,19,58
fa36b4a5-7410-42f7-aed1-473a465dcfc6,qwen1-14B,1720921109,1720921185,finished,1720921128,1720921185,A100-SXM4-80GB,8,1,64,896,19,57
ae031db4-3bfb-4954-9d32-b676e93f3a72,qwen1-14B,1720921261,1720921338,finished,1720921280,1720921338,A100-SXM4-80GB,8,1,64,896,19,58
0fea09a8-74a6-43d2-96a6-ed454ff3ffa9,qwen1-14B,1720921414,1720921492,finished,1720921434,1720921492,A100-SXM4-80GB,8,1,64,896,20,58
c2915e7e-108c-441f-a02f-826bfb9544b3,qwen1-14B,1720921568,1720921644,finished,1720921587,1720921644,A100-SXM4-80GB,8,1,64,896,19,57
07a488ec-6121-4c7c-89ef-e19c9fcdbf35,geo-72B-zero3,1720921665,1721143311,finished,1720921725,1721143311,A100-SXM4-80GB,8,8,64,896,60,221586
e67e87f3-2829-49dd-9fa4-32774bf9a3b4,qwen1-14B,1720921722,1720921801,finished,1720921744,1720921801,A100-SXM4-80GB,8,1,64,896,22,57
a1b9bf0a-6260-4ff7-a735-bd74499afd97,qwen1-14B,1720921879,1720921956,finished,1720921898,1720921956,A100-SXM4-80GB,8,1,64,896,19,58
3518c499-ac7d-467f-94ec-b80f78584013,qwen1-14B,1720922031,1720922107,finished,1720922051,1720922107,A100-SXM4-80GB,8,1,64,896,20,56
3d9e0d7f-0b8d-4048-a532-e5e5b8c8f77e,qwen1-14B,1720922184,1720922259,finished,1720922202,1720922259,A100-SXM4-80GB,8,1,64,896,18,57
839fdb72-e6cf-491f-92a9-c85a7475ba7e,qwen1-14B,1720922337,1720922414,finished,1720922357,1720922414,A100-SXM4-80GB,8,1,64,896,20,57
9929828e-02bd-4af7-a943-0408791973d2,qwen1-14B,1720922490,1720922567,finished,1720922508,1720922567,A100-SXM4-80GB,8,1,64,896,18,59
9e5d905e-3795-4e74-9bbc-17912c1c34d3,qwen1-14B,1720922643,1720922720,finished,1720922662,1720922720,A100-SXM4-80GB,8,1,64,896,19,58
64a11764-b0a2-4f74-9083-6747854bc08a,qwen1-14B,1720922796,1720922872,finished,1720922816,1720922872,A100-SXM4-80GB,8,1,64,896,20,56
fdc87a4f-e75d-4dd4-a56e-f1bca1ca8057,qwen1-14B,1720922948,1720923024,finished,1720922967,1720923024,A100-SXM4-80GB,8,1,64,896,19,57
9e7ffcd7-8c6d-4999-854a-f36e93472843,qwen1-14B,1720923101,1720923176,finished,1720923120,1720923176,A100-SXM4-80GB,8,1,64,896,19,56
5e31327b-cc65-4c08-a29c-dbb218622106,qwen1-14B,1720923254,1720923350,finished,1720923272,1720923350,A100-SXM4-80GB,8,1,64,896,18,78
cfc5a226-833d-41b1-82f4-41eea1257083,qwen1-14B,1720923426,1720923503,finished,1720923445,1720923503,A100-SXM4-80GB,8,1,64,896,19,58
b4004b5a-ba21-4ada-b11b-6567e2745cc1,qwen1-14B,1720923580,1720923675,finished,1720923599,1720923675,A100-SXM4-80GB,8,1,64,896,19,76
c49fa3f9-661a-4f88-813f-e1b119561e81,qwen1-5-7b-chat-lp40-geo25b-8e56c-auto,1720923740,1720925622,finished,1720923760,1720925622,A100-SXM4-80GB,8,1,64,448,20,1862
5a5f91fe-6802-4f71-987d-307b1fbb1e48,qwen1-14B,1720923754,1720923851,finished,1720923773,1720923851,A100-SXM4-80GB,8,1,64,896,19,78
99a7fb68-f748-45aa-8e20-fb885de79d37,qwen1-5-7b-chat-29673-auto,1720923817,1720925583,finished,1720923838,1720925583,A100-SXM4-80GB,8,1,64,448,21,1745
001c5e78-41d9-4f3e-9f06-f7b8cdf59967,qwen1-5-7b-chat-lp40-geo25b-226fd-auto,1720923859,1720952457,finished,1720923879,1720952457,A100-SXM4-80GB,8,1,64,448,20,28578
b2cb34a1-d5f8-47ca-b7d1-a978b2b3d51c,qwen1-14B,1720923930,1720928752,finished,1720928500,1720928752,A100-SXM4-80GB,8,1,64,896,4570,252
67f16755-2d52-4178-8bb7-34b815eb63ba,qwen1-5-7b-chat-1d045-auto,1720923937,1720951021,finished,1720925641,1720951021,A100-SXM4-80GB,8,1,64,448,1704,25380
160a6870-709e-4272-b6ae-9fb10c63658c,geogpt-s2-sft1-8m,1720924091,1720928468,finished,1720925602,1720928468,A100-SXM4-80GB,8,1,64,448,1511,2866
c28a4b9c-c170-472d-a066-3cd9f55a5cec,geogpt-s2-sft1-8m-c,1720924130,1721081933,finished,1720928759,1721081933,A100-SXM4-80GB,8,1,64,448,4629,153174
8afbe0c7-622a-44c3-b7bf-c010d18d2988,geo-base-e16,1720924404,1721101421,finished,1720924462,1721101421,A100-SXM4-80GB,8,28,64,448,58,176959
c34186ca-a31a-46ea-b83c-9b2c60a76ee2,zxx-new,1720925536,1720925846,finished,1720925555,1720925846,A100-SXM4-80GB,8,1,64,896,19,291
e3177a5f-a7d3-449d-8e19-6f771372e7f8,zxx-new,1720926173,1720926268,finished,1720926192,1720926268,A100-SXM4-80GB,8,1,64,896,19,76
1c41d84c-5506-46c7-bb55-38a09ccd68d8,zxx-new,1720926461,1720926614,finished,1720926479,1720926614,A100-SXM4-80GB,8,1,64,896,18,135
a3c61a5b-2ae6-4b32-9134-d4013d707dad,zxx-new,1720927328,1720927482,finished,1720927347,1720927482,A100-SXM4-80GB,8,1,64,896,19,135
8167e494-2fd0-4a2a-bd1f-b6872d0902fd,qwen2-72b-instruct-lp84-6bgeo,1720928128,1720936090,finished,1720928188,1720936090,A100-SXM4-80GB,8,20,64,448,60,7902
76da3a5c-e072-4428-bdde-ee81fd144325,qwen1-14B,1720928830,1720938048,finished,1720937969,1720938048,A100-SXM4-80GB,8,1,64,896,9139,79
91079f59-da44-4e93-918e-b3eda971bfa5,train-0714,1720930480,1721006756,finished,1720930500,1721006756,A100-SXM4-80GB,8,1,64,896,20,76256
2ae8ed2e-226e-498d-bdf8-3f5a10ab8369,geogpt-lxz-2-9m-mix-data-llama3-8b,1720930820,1720975407,finished,1720930878,1720975407,A100-SXM4-80GB,8,8,64,448,58,44529
fc72cba8-f991-43d1-beec-24655eb92d83,run-reward-model,1720933002,1720935297,finished,1720933023,1720935297,A100-SXM4-80GB,8,1,64,448,21,2274
10425937-6b56-4c90-a787-e40c994e421c,llama3-70b-0714-dpo,1720933103,1720936745,finished,1720936128,1720936745,A100-SXM4-80GB,8,8,64,448,3025,617
8121f827-8135-4855-a188-dfa608b6d583,run-reward-model,1720936551,1720936798,finished,1720936571,1720936798,A100-SXM4-80GB,8,1,64,448,20,227
d347ac53-0d2a-4168-8b45-3e7a6173eaf7,qwen2-moe-instruct-shumo-e116a-auto,1720937278,1720940083,finished,1720938052,1720940083,A100-SXM4-80GB,8,1,64,896,774,2031
5b864959-efa3-4f2c-9acf-d1c0bbf9b33c,qwen1-14B,1720938126,1720940177,finished,1720940118,1720940177,A100-SXM4-80GB,8,1,64,896,1992,59
d6353faa-07bf-4f66-85f8-102ecdbcec4d,run-reward-model,1720938303,1720938554,finished,1720938323,1720938554,A100-SXM4-80GB,8,1,64,448,20,231
90c91b16-6d78-4e98-aed9-045e5352897b,run-reward-model,1720939038,1720940382,finished,1720939058,1720940382,A100-SXM4-80GB,8,1,64,448,20,1324
7fde1d5d-69a5-451a-a2c6-c9c1812675ec,tqme-vllm-base,1720940247,1720943344,finished,1720940368,1720943344,A100-SXM4-80GB,8,1,64,448,121,2976
8239abc5-f135-434c-807e-da541b24cbc1,qw7b-tcpt-lr-2e5-hw-sft-30w-e1-0a8b2-auto,1720940249,1720941629,finished,1720940269,1720941629,A100-SXM4-80GB,8,1,64,448,20,1360
1a44848e-1904-4b8c-86b9-080d70e6a75d,qwen1-14B,1720940259,1720940358,finished,1720940278,1720940358,A100-SXM4-80GB,8,1,64,896,19,80
7469b4b7-7069-47ad-b09d-87eadf1a3644,qw7b-tcpt-lr-8e5-hw-sft-30w-e1-2523f-auto,1720940328,1720941792,finished,1720940349,1720941792,A100-SXM4-80GB,8,1,64,448,21,1443
b1deef3b-00c0-4e1b-8c60-3bbc2bddbd56,qw7b-tcpt-lr-2e5-hw-cpt-30w-e1-d5546-auto,1720940390,1720942374,finished,1720940411,1720942374,A100-SXM4-80GB,8,1,64,448,21,1963
bf66156f-884e-4ad1-89e1-c941d4bcf4c7,qwen1-14B,1720940439,1720943530,finished,1720943452,1720943530,A100-SXM4-80GB,8,1,64,896,3013,78
268e11f7-d0b9-44e1-8b83-2dfbd58b86a8,qw7b-tcpt-lr-8e5-hw-cpt-30w-e1-443fb-auto,1720940469,1720942414,finished,1720940490,1720942414,A100-SXM4-80GB,8,1,64,448,21,1924
2a458a3b-a874-4dd4-838e-22d1f1cc7ccf,qw7b-tcpt-lr-2e5-hw-2stage-30w-68e67-auto,1720940509,1720943109,finished,1720941650,1720943109,A100-SXM4-80GB,8,1,64,448,1141,1459
25b0d925-cbfe-4528-86bb-266b2be901a6,tq-llm-chat-infer-1,1720940944,1720943422,finished,1720943363,1720943422,A100-SXM4-80GB,8,1,64,448,2419,59
329fb754-f29b-4844-90cc-a25213275d66,qw7b-tcpt-lr-8e5-hw-2stage-30w-608e5-auto,1720941852,1720943246,finished,1720941874,1720943246,A100-SXM4-80GB,8,1,64,448,22,1372
c1654eb1-447f-45db-9259-4d8e3b3b43a1,tqme-vllm-base,1720943344,1720944568,finished,1720943539,1720944568,A100-SXM4-80GB,8,1,64,448,195,1029
e148e35f-43ee-49e4-a670-83846c3afa79,qwen1-14B,1720943608,1720943802,finished,1720943726,1720943802,A100-SXM4-80GB,8,1,64,896,118,76
12efb5f4-6914-4162-b737-203d13eb2425,qwen1-14B,1720943879,1720943956,finished,1720943899,1720943956,A100-SXM4-80GB,8,1,64,896,20,57
7f44e359-d9bb-433f-84b8-032ab3b2f68a,qwen1-14B,1720944034,1720944111,finished,1720944053,1720944111,A100-SXM4-80GB,8,1,64,896,19,58
6e219ea0-f61d-496d-917c-025a2bcd5365,qwen1-14B,1720944190,1720944267,finished,1720944209,1720944267,A100-SXM4-80GB,8,1,64,896,19,58
ccb1f29b-1902-455d-b73f-6d326d8da05d,qwen1-14B,1720944344,1720944422,finished,1720944364,1720944422,A100-SXM4-80GB,8,1,64,896,20,58
ca0270de-e665-4a87-a41c-d507a5f44e9c,qwen1-14B,1720944498,1720944577,finished,1720944519,1720944577,A100-SXM4-80GB,8,1,64,896,21,58
513322a1-bee1-4a00-8be8-eeb17e5ab484,qwen1-14B,1720944654,1720944731,finished,1720944673,1720944731,A100-SXM4-80GB,8,1,64,896,19,58
218d41e3-1909-43db-b30a-37d89351a3ee,qwen1-14B,1720944808,1720944908,finished,1720944831,1720944908,A100-SXM4-80GB,8,1,64,896,23,77
f23a0139-8406-452f-b968-2c0738678f54,qwen1-14B,1720944985,1720945063,finished,1720945004,1720945063,A100-SXM4-80GB,8,1,64,896,19,59
dfd0108d-2c8f-4cd9-874e-fe79c4b7dcaa,tqme-vllm-base,1720945073,1721104375,finished,1720945093,1721104375,A100-SXM4-80GB,8,1,64,448,20,159282
5ee3a490-6718-47e3-a7d7-19f0cc55ff18,qwen1-14B,1720945141,1720945237,finished,1720945160,1720945237,A100-SXM4-80GB,8,1,64,896,19,77
e2ea6ccd-0b76-4100-8da9-7a56b6a82e2d,qwen1-14B,1720945314,1720945410,finished,1720945334,1720945410,A100-SXM4-80GB,8,1,64,896,20,76
7b5e220b-4b21-4a83-845c-d677c38751c0,qwen1-14B,1720945488,1720945585,finished,1720945507,1720945585,A100-SXM4-80GB,8,1,64,896,19,78
e2cb0492-76d7-4682-96d9-c60ad57dc067,qwen1-14B,1720945662,1720945760,finished,1720945681,1720945760,A100-SXM4-80GB,8,1,64,896,19,79
9af88a02-4ba5-402f-b639-5d0cd7b9a29b,qwen1-14B,1720945837,1720945913,finished,1720945856,1720945913,A100-SXM4-80GB,8,1,64,896,19,57
c23c9460-9a50-4e49-907d-ed5b7af7929f,qwen1-14B,1720945989,1720946083,finished,1720946008,1720946083,A100-SXM4-80GB,8,1,64,896,19,75
753e8f86-75c0-411b-ba23-5fa7e0d89956,qwen1-14B,1720946161,1720946237,finished,1720946180,1720946237,A100-SXM4-80GB,8,1,64,896,19,57
0d99dbb5-6b4b-46e5-86d8-5d7c1a9b7c09,qwen1-14B,1720946314,1720946392,finished,1720946333,1720946392,A100-SXM4-80GB,8,1,64,896,19,59
58cd37ac-32e5-4702-8ada-d6d0b3d8ccad,train-0713B-lr1e-5,1720946447,1720946526,finished,1720946467,1720946526,A100-SXM4-80GB,8,1,64,896,20,59
beed3892-680b-458b-b7f4-07c88f43f18a,qwen1-14B,1720946470,1720946548,finished,1720946490,1720946548,A100-SXM4-80GB,8,1,64,896,20,58
ecc629ea-2f63-48b6-8d41-b24b9bd2d5f0,qwen1-14B,1720946625,1720946700,finished,1720946644,1720946700,A100-SXM4-80GB,8,1,64,896,19,56
ddd982a1-25c1-4e45-bc63-dea70898fa60,qwen1-14B,1720946776,1720946872,finished,1720946795,1720946872,A100-SXM4-80GB,8,1,64,896,19,77
622c750a-0c18-4f71-a2e6-b034ebb47e55,train-0713B-lr1e-5,1720946889,1720946967,finished,1720946908,1720946967,A100-SXM4-80GB,8,1,64,896,19,59
30de6e2e-98bf-421d-8b36-2dbe2f68117a,qwen1-14B,1720946950,1720947028,finished,1720946970,1720947028,A100-SXM4-80GB,8,1,64,896,20,58
3dd95fc5-ab99-4c20-9e6f-82c68bf53520,qwen1-14B,1720947106,1720947185,finished,1720947126,1720947185,A100-SXM4-80GB,8,1,64,896,20,59
348ce29a-0083-4ce2-acd6-a2c92a3aa852,qwen2-72b-lp84-6bgeo-589e9-auto,1720947152,1720952417,finished,1720947172,1720952417,A100-SXM4-80GB,8,1,64,448,20,5245
2a5e2a1a-f873-4262-ab96-330212c34c46,train-0713B-lr1e-5,1720947182,1720947259,finished,1720947201,1720947259,A100-SXM4-80GB,8,1,64,896,19,58
4eb25134-4c64-4fff-a2d1-1080d35bdb3b,qwen1-14B,1720947262,1720947340,finished,1720947281,1720947340,A100-SXM4-80GB,8,1,64,896,19,59
a9158b09-203f-4eee-b8eb-1c3babe5fa47,train-0713C,1720947298,1720947395,finished,1720947318,1720947395,A100-SXM4-80GB,8,1,64,896,20,77
f281ec4b-d88e-490b-a812-31f51a05cda9,qwen1-14B,1720947417,1720947494,finished,1720947437,1720947494,A100-SXM4-80GB,8,1,64,896,20,57
998d301f-ef47-4b1a-bf5b-b24bddb79497,train-0713C,1720947512,1720947589,finished,1720947531,1720947589,A100-SXM4-80GB,8,1,64,896,19,58
061953f8-35de-48d3-b508-2cceb1ca9f99,qwen1-14B,1720947572,1720947649,finished,1720947591,1720947649,A100-SXM4-80GB,8,1,64,896,19,58
ce377315-83ca-4fd7-8bd9-5e2dc4361060,qwen1-14B,1720947726,1720947823,finished,1720947746,1720947823,A100-SXM4-80GB,8,1,64,896,20,77
89fc82a5-6136-4548-a34c-5753dde66e7a,qwen1-14B,1720947900,1720947977,finished,1720947920,1720947977,A100-SXM4-80GB,8,1,64,896,20,57
1a1c05d9-25ca-4d60-aadf-ad5d453de5a9,qwen1-14B,1720948054,1720948132,finished,1720948073,1720948132,A100-SXM4-80GB,8,1,64,896,19,59
316ab305-4619-426c-85b8-e39ac20a5cf7,dataset,1720948090,1720948518,finished,1720948110,1720948518,A100-SXM4-80GB,4,1,32,448,20,408
bd2ac13e-b23f-49b2-ab07-81799db76e60,qwen1-14B,1720948212,1720948289,finished,1720948231,1720948289,A100-SXM4-80GB,8,1,64,896,19,58
3f2042f5-4159-4e50-b25b-0ae085999600,qwen1-14B,1720948366,1720948443,finished,1720948385,1720948443,A100-SXM4-80GB,8,1,64,896,19,58
a6be7b20-92ea-49ef-a17e-a62e35353b2a,qwen1-14B,1720948521,1720948599,finished,1720948540,1720948599,A100-SXM4-80GB,8,1,64,896,19,59
035d6807-ab6d-43eb-83c0-262385397c6b,qwen1-14B,1720948677,1720948755,finished,1720948697,1720948755,A100-SXM4-80GB,8,1,64,896,20,58
046245d8-c4ae-4d76-ae97-1944301d3c62,dataset,1720948752,1720948831,finished,1720948771,1720948831,A100-SXM4-80GB,4,1,32,448,19,60
e3eeb0df-dc41-4e37-b3d5-831397e9a117,qwen1-14B,1720948834,1720948930,finished,1720948853,1720948930,A100-SXM4-80GB,8,1,64,896,19,77
9054e7fa-60a1-4ae8-b60d-4e34816c6cd9,citysora-modelv4-cele-ppm-65-512-from-200k256,1720948856,1720949654,finished,1720948895,1720949654,A100-SXM4-80GB,8,4,64,896,39,759
bad279da-374b-4d02-bc33-df61575f7145,qwen1-14B,1720949008,1720949106,finished,1720949028,1720949106,A100-SXM4-80GB,8,1,64,896,20,78
8ceae705-413a-4282-9ed3-d31c4bef81da,qwen1-14B,1720949184,1720949262,finished,1720949204,1720949262,A100-SXM4-80GB,8,1,64,896,20,58
8156c57b-a48d-46ed-9edb-c47c0976dfbc,qwen1-14B,1720949342,1720949420,finished,1720949361,1720949420,A100-SXM4-80GB,8,1,64,896,19,59
dbd428da-ed15-4bf6-b312-532f11af370d,qwen1-14B,1720949497,1720949572,finished,1720949516,1720949572,A100-SXM4-80GB,8,1,64,896,19,56
3aacea72-a8bb-4d0d-8120-8a64c0ba949d,qwen1-14B,1720949652,1720949731,finished,1720949672,1720949731,A100-SXM4-80GB,8,1,64,896,20,59
944a5383-d20d-4e30-acde-136e4f3a6f10,citysora-modelv4-cele-ppm-65-512-from-200k256,1720949655,1721021318,finished,1720949714,1721021318,A100-SXM4-80GB,8,4,64,896,59,71604
35a48b0d-3811-4e5f-9bc2-16b8aed5c695,dataset,1720949767,1720949844,finished,1720949786,1720949844,A100-SXM4-80GB,4,1,32,448,19,58
a060c609-56d7-4c00-9738-9a93f19bcc56,qwen1-14B,1720949808,1720949885,finished,1720949827,1720949885,A100-SXM4-80GB,8,1,64,896,19,58
8a2814a0-175f-4b73-86d1-8f92d5c1f58a,qwen1-14B,1720949962,1720950040,finished,1720949982,1720950040,A100-SXM4-80GB,8,1,64,896,20,58
da22dbe7-170a-4455-9f19-e07b56120762,dataset,1720950076,1720950152,finished,1720950095,1720950152,A100-SXM4-80GB,4,1,32,448,19,57
d66502f5-beee-46a7-83a3-e5171aca40b8,qwen1-14B,1720950116,1720950193,finished,1720950136,1720950193,A100-SXM4-80GB,8,1,64,896,20,57
6562e791-1a22-49de-b926-35e995c0eac0,qwen1-14B,1720950271,1720950348,finished,1720950291,1720950348,A100-SXM4-80GB,8,1,64,896,20,57
748fc18e-fd8f-426a-8f6d-407ba077fcf6,train-0713,1720950421,1720952612,finished,1720950441,1720952612,A100-SXM4-80GB,8,1,64,896,20,2171
f0d320ee-ffd5-415a-9a00-4c74718fc70e,qwen1-14B,1720950424,1720950502,finished,1720950443,1720950502,A100-SXM4-80GB,8,1,64,896,19,59
23dd2001-1bf1-42e8-bf10-9c17bba20910,qwen1-14B,1720950588,1720950665,finished,1720950608,1720950665,A100-SXM4-80GB,8,1,64,896,20,57
a7f958dd-8147-43e0-93ef-2699693b9813,qwen1-14B,1720950742,1720950819,finished,1720950761,1720950819,A100-SXM4-80GB,8,1,64,896,19,58
aa497f3d-f955-46db-b903-2b5644a41bf7,qwen1-14B,1720950897,1720950994,finished,1720950916,1720950994,A100-SXM4-80GB,8,1,64,896,19,78
e9e7c371-5494-40ba-b42b-31c4f2fb7411,qwen1-14B,1720951072,1720951167,finished,1720951091,1720951167,A100-SXM4-80GB,8,1,64,896,19,76
bba3d680-4124-44ae-8fc3-365e3c7ebdc1,qwen1-14B,1720951246,1720951342,finished,1720951266,1720951342,A100-SXM4-80GB,8,1,64,896,20,76
f5a72268-9746-49c1-9712-a9a5dde8b41d,qwen1-14B,1720951419,1720951495,finished,1720951438,1720951495,A100-SXM4-80GB,8,1,64,896,19,57
8e5f1f58-418f-41a6-922a-c9c8047a173b,qwen1-14B,1720951572,1720951649,finished,1720951592,1720951649,A100-SXM4-80GB,8,1,64,896,20,57
a6d0c1df-ae27-4e89-bfe6-b9c8a4b6c16c,llama3-70b-0714-dpo,1720951715,1720952339,finished,1720951754,1720952339,A100-SXM4-80GB,8,16,64,448,39,585
519d4f52-caa8-4f20-beca-7dfae5ae5a54,qwen1-14B,1720951728,1720951832,finished,1720951747,1720951832,A100-SXM4-80GB,8,1,64,896,19,85
27e6f4a4-3066-4e6d-a448-5996a3a76047,qwen1-14B,1720951909,1720951986,finished,1720951928,1720951986,A100-SXM4-80GB,8,1,64,896,19,58
24492b26-253d-4c52-a4ae-b3ce8edaf1c7,qwen1-14B,1720952061,1720952139,finished,1720952081,1720952139,A100-SXM4-80GB,8,1,64,896,20,58
e189172f-f069-4942-86c4-370c8e684c90,qwen1-14B,1720952216,1720952313,finished,1720952236,1720952313,A100-SXM4-80GB,8,1,64,896,20,77
ab277635-d721-4ccf-8db2-0aa474c0726b,qwen1-14B,1720952390,1720952469,finished,1720952411,1720952469,A100-SXM4-80GB,8,1,64,896,21,58
a81ca6de-78fa-4205-aafa-770736f5719e,llama3-70b-0714-dpo,1720952535,1720954068,finished,1720952597,1720954068,A100-SXM4-80GB,8,16,64,448,62,1471
00dcb734-95f2-4104-aa73-3c81a4151ae1,qwen2-72b-lp84-6bgeo-589e9-auto,1720952536,1720993475,finished,1720952557,1720993475,A100-SXM4-80GB,8,1,64,448,21,40918
aecb0726-d8e4-4a8e-9455-40b1fe7e8b2c,qwen1-14B,1720952550,1720952653,finished,1720952590,1720952653,A100-SXM4-80GB,8,1,64,896,40,63
e11868d5-ea12-4249-88c5-9d2710d0af8a,qwen1-5-7b-chat-lp40-geo25b-226fd-auto,1720952557,1720983308,finished,1720952577,1720983308,A100-SXM4-80GB,8,1,64,448,20,30731
0d7e0406-6681-4240-8040-49494bea8ce0,qwen1-14B,1720952730,1720952807,finished,1720952750,1720952807,A100-SXM4-80GB,8,1,64,896,20,57
f6151a31-b21e-4545-879a-0d10fc3b1bd8,qwen1-14B,1720952882,1720952981,finished,1720952902,1720952981,A100-SXM4-80GB,8,1,64,896,20,79
d8500427-f466-4add-a734-5fa5fb7f1e6b,qwen1-14B,1720953058,1720953135,finished,1720953077,1720953135,A100-SXM4-80GB,8,1,64,896,19,58
52f635f9-ceeb-4834-8f5f-4ca8ab6aed00,train-0713,1720953132,1720953210,finished,1720953152,1720953210,A100-SXM4-80GB,8,1,64,896,20,58
20d84f21-bc6d-4884-99fb-001662a7bd69,qwen1-14B,1720953213,1720953290,finished,1720953232,1720953290,A100-SXM4-80GB,8,1,64,896,19,58
4ee61893-7b9e-4b8b-a324-13369da430b1,qwen1-14B,1720953366,1720953443,finished,1720953385,1720953443,A100-SXM4-80GB,8,1,64,896,19,58
c5daac0a-e055-4684-a58d-50a8ebb6d132,train-0713,1720953421,1720953499,finished,1720953440,1720953499,A100-SXM4-80GB,8,1,64,896,19,59
7c800d54-e1ab-4c94-b2e3-ab59a4f604dd,qwen1-14B,1720953522,1720953598,finished,1720953541,1720953598,A100-SXM4-80GB,8,1,64,896,19,57
ad938ef0-cdb1-48cf-9f00-b079adbe66b0,qwen1-14B,1720953676,1720953754,finished,1720953696,1720953754,A100-SXM4-80GB,8,1,64,896,20,58
007d61e9-3275-43a8-8e93-0e5ac67a4933,train-0713,1720953712,1720953789,finished,1720953731,1720953789,A100-SXM4-80GB,8,1,64,896,19,58
fbdf1375-34b5-4553-8bc4-283ca557faa6,qwen1-14B,1720953830,1720953907,finished,1720953849,1720953907,A100-SXM4-80GB,8,1,64,896,19,58
2f70430e-c2f9-41a7-b8aa-7d285e0a45f3,qwen1-14B,1720953985,1720954081,finished,1720954004,1720954081,A100-SXM4-80GB,8,1,64,896,19,77
3a6df2f2-58e0-45c4-898d-f41affbd7223,qwen1-14B,1720954158,1720954234,finished,1720954177,1720954234,A100-SXM4-80GB,8,1,64,896,19,57
1b98d5fa-e627-4c9a-83f7-91318b726914,qwen1-14B,1720954309,1720954386,finished,1720954328,1720954386,A100-SXM4-80GB,8,1,64,896,19,58
0be18e84-7095-430f-9eff-3baf29f40524,qwen1-14B,1720954463,1720954540,finished,1720954481,1720954540,A100-SXM4-80GB,8,1,64,896,18,59
87e70076-b4f0-4073-a889-cebbee9d3a07,qwen1-14B,1720954617,1720954693,finished,1720954636,1720954693,A100-SXM4-80GB,8,1,64,896,19,57
bba2adec-caeb-4dbe-8421-e9e69f89de30,qwen1-14B,1720954772,1720954853,finished,1720954791,1720954853,A100-SXM4-80GB,8,1,64,896,19,62
f0de833b-76a9-4da6-a691-e4e51695ae3d,llama3-70b-0714-dpo,1720954840,1720956432,finished,1720954898,1720956432,A100-SXM4-80GB,8,16,64,448,58,1534
65a837f9-0599-485b-8731-e0e2351a8958,train-0713,1720954914,1720955030,finished,1720954933,1720955030,A100-SXM4-80GB,8,1,64,896,19,97
ebbac0fc-8ed0-4db2-b908-ed7b6e8b9d34,qwen1-14B,1720954936,1720955014,finished,1720954955,1720955014,A100-SXM4-80GB,8,1,64,896,19,59
df608364-a4f4-41d3-8778-b03368018259,qwen1-14B,1720955092,1720955188,finished,1720955111,1720955188,A100-SXM4-80GB,8,1,64,896,19,77
4d83d2b9-2457-44d9-9537-44e2e34245da,train-0713,1720955127,1720955204,finished,1720955147,1720955204,A100-SXM4-80GB,8,1,64,896,20,57
ec58dc98-9cd0-488d-af49-6a804e0fd464,qwen1-14B,1720955265,1720955362,finished,1720955285,1720955362,A100-SXM4-80GB,8,1,64,896,20,77
71eee98b-6a0e-4d7b-8d96-72f1f1e83a47,qwen1-14B,1720955439,1720955517,finished,1720955458,1720955517,A100-SXM4-80GB,8,1,64,896,19,59
9c8f7353-f204-404a-8deb-664fc41f9fda,train-0713,1720955475,1720955592,finished,1720955495,1720955592,A100-SXM4-80GB,8,1,64,896,20,97
bb6466d0-99c8-4cd2-b882-a6a747c7d1bc,qwen1-14B,1720955595,1720955671,finished,1720955614,1720955671,A100-SXM4-80GB,8,1,64,896,19,57
fbad901a-3ff3-41cc-bbf3-52209bbe01ef,train-0713,1720955707,1720955783,finished,1720955727,1720955783,A100-SXM4-80GB,8,1,64,896,20,56
9197aed5-49ef-4fc5-92ef-37105a3a5dd3,qwen1-14B,1720955748,1720955825,finished,1720955767,1720955825,A100-SXM4-80GB,8,1,64,896,19,58
7321630a-767a-4404-97e7-fac3f54dbcf9,qwen1-14B,1720955902,1720955978,finished,1720955920,1720955978,A100-SXM4-80GB,8,1,64,896,18,58
0069bddd-1196-4274-b145-2d45526e6606,train-0713,1720956015,1720956092,finished,1720956035,1720956092,A100-SXM4-80GB,8,1,64,896,20,57
72e461ae-be2d-4ee1-a4fd-823b05a6eba5,qwen1-14B,1720956057,1720956133,finished,1720956076,1720956133,A100-SXM4-80GB,8,1,64,896,19,57
ebb57813-fd02-49bf-9cb4-c7510a6041e2,Mixtral-8x22B-Instruct-shumo-8eaa6-auto,1720956099,1721009051,finished,1720956118,1721009051,A100-SXM4-80GB,8,1,64,896,19,52933
b513341e-3d60-4378-9953-cef567021726,qwen1-14B,1720956209,1720956287,finished,1720956229,1720956287,A100-SXM4-80GB,8,1,64,896,20,58
dbac0211-4c60-4516-866c-c957b2717d0b,DeepSeek-V2-Chat-shumo-7e45b-auto,1720956233,1721008168,finished,1720956252,1721008168,A100-SXM4-80GB,8,1,64,896,19,51916
e95ff76f-9f2d-4630-b6a3-d9b761ee0f20,qwen1-14B,1720956366,1720956445,finished,1720956385,1720956445,A100-SXM4-80GB,8,1,64,896,19,60
5254a096-47e5-43e4-a253-e5494754ae33,llama3-70b-0714-dpo,1720956433,1720958045,finished,1720956491,1720958045,A100-SXM4-80GB,8,16,64,448,58,1554
6629605b-ceee-4997-93d1-2457804bbf7d,train-0713,1720956481,1720956564,finished,1720956506,1720956564,A100-SXM4-80GB,8,1,64,896,25,58
3a6df9e4-972e-492e-95fe-ce80cb7f3f1e,qwen1-14B,1720956528,1720956606,finished,1720956547,1720956606,A100-SXM4-80GB,8,1,64,896,19,59
0fbac93b-c24e-4c5f-9076-e950a8870537,qwen1-14B,1720956684,1720956761,finished,1720956703,1720956761,A100-SXM4-80GB,8,1,64,896,19,58
07091f8f-6332-432b-aca3-7f083d800492,qwen1-14B,1720956837,1720956914,finished,1720956857,1720956914,A100-SXM4-80GB,8,1,64,896,20,57
7518b5e0-cc71-4e6d-b17d-0c437342acef,train-0713,1720956854,1720956969,finished,1720956873,1720956969,A100-SXM4-80GB,8,1,64,896,19,96
5939cdd2-34b5-4a9f-b801-a4f57ca9bef3,qwen1-14B,1720956991,1720957068,finished,1720957011,1720957068,A100-SXM4-80GB,8,1,64,896,20,57
c5c9dfbe-480f-42cd-ab3b-03c573f8ee59,qwen1-14B,1720957146,1720957244,finished,1720957166,1720957244,A100-SXM4-80GB,8,1,64,896,20,78
e51e5a18-82d4-43a5-8049-a5dd667ce690,train-0713,1720957202,1720957377,finished,1720957222,1720957377,A100-SXM4-80GB,8,1,64,896,20,155
98ca1972-24bf-4925-b989-cf8ab45a685f,qwen1-14B,1720957322,1720957417,finished,1720957341,1720957417,A100-SXM4-80GB,8,1,64,896,19,76
2e554351-29e9-4d2c-8f21-2ea504a3f684,train-0713,1720957492,1720957608,finished,1720957511,1720957608,A100-SXM4-80GB,8,1,64,896,19,97
bdaf9dd2-62b4-40dc-a851-d539fb461f3f,qwen1-14B,1720957495,1720957592,finished,1720957514,1720957592,A100-SXM4-80GB,8,1,64,896,19,78
6c0123b9-360e-4d11-bb6c-1edbdd6cd801,qwen1-14B,1720957668,1720957765,finished,1720957688,1720957765,A100-SXM4-80GB,8,1,64,896,20,77
55161ec8-6ada-486c-b5c7-d65f7cd9ae9f,train-0713,1720957723,1720958035,finished,1720957743,1720958035,A100-SXM4-80GB,8,1,64,896,20,292
b7c8807f-f571-458e-af50-168e868e58f3,qwen1-14B,1720957842,1720957919,finished,1720957861,1720957919,A100-SXM4-80GB,8,1,64,896,19,58
a98fbe22-2e94-48db-af07-8478366be7c3,qwen1-14B,1720957999,1720958076,finished,1720958018,1720958076,A100-SXM4-80GB,8,1,64,896,19,58
c0499aef-3ccd-4dc2-88d9-5b943ceb85e1,train-0713,1720958035,1720962095,finished,1720958054,1720962095,A100-SXM4-80GB,8,1,64,896,19,4041
3f192d26-e6af-49b2-87eb-92e746b555df,llama3-70b-0714-dpo,1720958045,1720958982,finished,1720958083,1720958982,A100-SXM4-80GB,8,16,64,448,38,899
39949f7a-a866-4332-9437-fd9ef3af090e,qwen1-14B,1720958160,1720958238,finished,1720958179,1720958238,A100-SXM4-80GB,8,1,64,896,19,59
dab8b511-021f-4e42-a97e-b780ae266b53,qwen1-14B,1720958315,1720958393,finished,1720958334,1720958393,A100-SXM4-80GB,8,1,64,896,19,59
dd700f2c-4f0f-4c2c-aa69-153f2d1e9cfe,qwen1-14B,1720958471,1720958548,finished,1720958490,1720958548,A100-SXM4-80GB,8,1,64,896,19,58
3c79da5f-c835-4aa1-8a1f-12addcb1a0fd,qwen1-14B,1720958625,1720958701,finished,1720958644,1720958701,A100-SXM4-80GB,8,1,64,896,19,57
ebd759b0-dbb6-4a1d-92bf-df43bfecc2b8,qwen1-14B,1720958779,1720958856,finished,1720958798,1720958856,A100-SXM4-80GB,8,1,64,896,19,58
c121209a-293c-4aee-a543-1a667daaf465,qwen1-14B,1720958934,1720959034,finished,1720958956,1720959034,A100-SXM4-80GB,8,1,64,896,22,78
653285ac-67cf-4211-ae8a-57235308504b,llama3-70b-0714-dpo,1720958982,1720964507,finished,1720959041,1720964507,A100-SXM4-80GB,8,16,64,448,59,5466
47a7ca00-62f6-4527-9e69-6d0b6c875b31,qwen1-14B,1720959117,1720959193,finished,1720959136,1720959193,A100-SXM4-80GB,8,1,64,896,19,57
bc4fa4c9-34c3-4ffd-aecb-e9ccba1b1005,qwen1-14B,1720959270,1720959348,finished,1720959290,1720959348,A100-SXM4-80GB,8,1,64,896,20,58
33a64978-3a5f-4e9a-9dfe-9a7a6d130c91,qwen1-14B,1720959425,1720959500,finished,1720959443,1720959500,A100-SXM4-80GB,8,1,64,896,18,57
7ec05073-56db-40e2-a852-7836a5e3090c,qwen1-14B,1720959576,1720959653,finished,1720959595,1720959653,A100-SXM4-80GB,8,1,64,896,19,58
7c29c123-ada1-4924-ac9a-55ed403481d8,qwen1-14B,1720959730,1720959807,finished,1720959749,1720959807,A100-SXM4-80GB,8,1,64,896,19,58
6a86ac09-4dc5-4fab-91d2-92948155a9a3,qwen1-14B,1720959883,1720959961,finished,1720959902,1720959961,A100-SXM4-80GB,8,1,64,896,19,59
6559d5d2-09cf-4850-9543-475c0e865cfb,qwen1-14B,1720960039,1720960115,finished,1720960058,1720960115,A100-SXM4-80GB,8,1,64,896,19,57
fbe58113-50a6-47f3-b6fd-d3e498ff3b7e,qwen1-14B,1720960193,1720960289,finished,1720960212,1720960289,A100-SXM4-80GB,8,1,64,896,19,77
84b0a2bc-07ae-4e0d-a4c7-a8b2f0d7b235,qwen1-14B,1720960366,1720960461,finished,1720960385,1720960461,A100-SXM4-80GB,8,1,64,896,19,76
427e1678-04f5-4f78-a432-fd27572ff3fa,qwen1-14B,1720960538,1720960616,finished,1720960557,1720960616,A100-SXM4-80GB,8,1,64,896,19,59
689e90e7-d90a-4e55-92e1-466aa9011773,qwen1-14B,1720960692,1720960768,finished,1720960711,1720960768,A100-SXM4-80GB,8,1,64,896,19,57
b9370e84-767a-408a-86a9-128829d7b12b,qwen1-14B,1720960846,1720960923,finished,1720960865,1720960923,A100-SXM4-80GB,8,1,64,896,19,58
c08865b0-1d56-492d-abb8-deff7dbb66ba,qwen1-14B,1720961000,1720961095,finished,1720961019,1720961095,A100-SXM4-80GB,8,1,64,896,19,76
0cd674bc-d79d-49a7-b525-a6a8eff8f0ae,qwen1-14B,1720961172,1720961249,finished,1720961191,1720961249,A100-SXM4-80GB,8,1,64,896,19,58
de555c2b-1db2-461d-84a0-8a99e69626f4,qwen1-14B,1720961327,1720961423,finished,1720961347,1720961423,A100-SXM4-80GB,8,1,64,896,20,76
7a1017d6-6db1-43f9-b863-fed851e8917e,qwen1-14B,1720961500,1720961596,finished,1720961520,1720961596,A100-SXM4-80GB,8,1,64,896,20,76
38013ec6-04be-40fe-888a-a5e615f35832,qwen1-14B,1720961674,1720961752,finished,1720961693,1720961752,A100-SXM4-80GB,8,1,64,896,19,59
8d1801bf-b8c9-48ca-b6a8-ef7bddd03a0a,qwen1-14B,1720961830,1720961906,finished,1720961849,1720961906,A100-SXM4-80GB,8,1,64,896,19,57
f119a320-55d7-45b9-ad1d-d01ab4283f0f,qwen1-14B,1720961983,1720962078,finished,1720962002,1720962078,A100-SXM4-80GB,8,1,64,896,19,76
a6fd2061-139c-4e2b-b263-101b6cc1bc1d,qwen1-14B,1720962157,1720962233,finished,1720962176,1720962233,A100-SXM4-80GB,8,1,64,896,19,57
a499d28c-af45-4efa-b668-bb8f641e2a44,qwen1-14B,1720962309,1720962386,finished,1720962329,1720962386,A100-SXM4-80GB,8,1,64,896,20,57
bf9b74fd-b992-4c4a-8827-1460cd94e279,qwen1-14B,1720962463,1720962559,finished,1720962482,1720962559,A100-SXM4-80GB,8,1,64,896,19,77
2c80fcb5-bbc2-434e-9023-49932b043e0a,qwen1-14B,1720962636,1720962714,finished,1720962655,1720962714,A100-SXM4-80GB,8,1,64,896,19,59
7323f905-8ee3-4843-ab2b-bdf19cd04365,qwen1-14B,1720962792,1720962887,finished,1720962811,1720962887,A100-SXM4-80GB,8,1,64,896,19,76
1f49e83c-14b7-4a6d-8670-8bf480fbb6e0,qwen1-14B,1720962964,1720963040,finished,1720962983,1720963040,A100-SXM4-80GB,8,1,64,896,19,57
23707d8c-93bc-4d92-8059-a48838e63f49,qwen1-14B,1720963117,1720963194,finished,1720963136,1720963194,A100-SXM4-80GB,8,1,64,896,19,58
63fc8d24-636b-47dd-b068-14788a71e53b,qwen1-14B,1720963271,1720963349,finished,1720963290,1720963349,A100-SXM4-80GB,8,1,64,896,19,59
0b6cd45d-6e81-4eca-9940-412fc614616b,qwen1-14B,1720963427,1720963525,finished,1720963446,1720963525,A100-SXM4-80GB,8,1,64,896,19,79
502c4810-12fa-4f53-ab9e-e8f1719e95be,qwen1-14B,1720963603,1720963681,finished,1720963622,1720963681,A100-SXM4-80GB,8,1,64,896,19,59
b15bddca-35f9-4a57-95ac-da3083803f2c,qwen1-14B,1720963759,1720963838,finished,1720963779,1720963838,A100-SXM4-80GB,8,1,64,896,20,59
f1a5c58f-73b3-4f93-a132-2a0571b8129a,qwen1-14B,1720963917,1720964012,finished,1720963936,1720964012,A100-SXM4-80GB,8,1,64,896,19,76
81a49eb8-8233-48d7-b4e1-26b9e6106010,qwen1-14B,1720964088,1720964166,finished,1720964108,1720964166,A100-SXM4-80GB,8,1,64,896,20,58
099160ad-3aca-464d-9227-24618ca205be,qwen1-14B,1720964245,1720964344,finished,1720964265,1720964344,A100-SXM4-80GB,8,1,64,896,20,79
93857af1-fa37-402f-b036-a3ccf3cc0453,qwen1-14B,1720964422,1720964500,finished,1720964441,1720964500,A100-SXM4-80GB,8,1,64,896,19,59
995b060b-e594-4362-944d-eab9425f96e9,qwen1-14B,1720964578,1720964674,finished,1720964597,1720964674,A100-SXM4-80GB,8,1,64,896,19,77
b466337e-1a8b-4f52-aa95-2e9f7ca69905,tq-llm-chat-infer-1,1720964703,1720965600,finished,1720964723,1720965600,A100-SXM4-80GB,8,1,64,448,20,877
128faf4a-1d92-41f3-bca1-9fe62ab8d32c,qwen1-14B,1720964752,1720964830,finished,1720964772,1720964830,A100-SXM4-80GB,8,1,64,896,20,58
8f20abc2-20c3-4d9c-b043-f1fcc15c41d9,train-0714B,1720964865,1720965098,finished,1720964885,1720965098,A100-SXM4-80GB,8,1,64,896,20,213
f82bec69-9f0b-43b0-94be-4df1d5ceeaf5,qwen1-14B,1720964908,1720964985,finished,1720964927,1720964985,A100-SXM4-80GB,8,1,64,896,19,58
ffdea1ca-86c3-496c-a2e5-788d73799dac,qwen1-14B,1720965062,1720965140,finished,1720965081,1720965140,A100-SXM4-80GB,8,1,64,896,19,59
09b03424-6800-4e93-afdd-dc59d4ea6f76,qwen1-14B,1720965218,1720965317,finished,1720965238,1720965317,A100-SXM4-80GB,8,1,64,896,20,79
e5955df4-3f5b-4794-9cc2-8bed1dfff65e,train-0714B,1720965255,1720966945,finished,1720965274,1720966945,A100-SXM4-80GB,8,1,64,896,19,1671
a379db1c-7662-482b-96b8-3b28958e4583,qwen1-14B,1720965395,1720965492,finished,1720965414,1720965492,A100-SXM4-80GB,8,1,64,896,19,78
e14ff77e-7760-422e-9ca2-112cc26d0c84,qwen1-14B,1720965571,1720965653,finished,1720965590,1720965653,A100-SXM4-80GB,8,1,64,896,19,63
08b2c42c-6c48-47aa-9e91-d7dc5c41be57,qwen1-14B,1720965730,1720965825,finished,1720965749,1720965825,A100-SXM4-80GB,8,1,64,896,19,76
167641e7-4f1c-4b9e-be4c-3ce9e8668f87,qwen1-14B,1720965902,1720965978,finished,1720965921,1720965978,A100-SXM4-80GB,8,1,64,896,19,57
28f905a4-13c3-486d-b939-bdf8f94a64e5,qwen1-14B,1720966054,1720966150,finished,1720966073,1720966150,A100-SXM4-80GB,8,1,64,896,19,77
89edba98-2e0d-4b41-af88-91b911815ef0,tq-llm-chat-infer-1,1720966220,1720985759,finished,1720966240,1720985759,A100-SXM4-80GB,8,1,64,448,20,19519
910d682f-3215-49b4-9d50-b1626881dac3,qwen1-14B,1720966230,1720966327,finished,1720966250,1720966327,A100-SXM4-80GB,8,1,64,896,20,77
9ff5944f-184d-482a-a9e3-3104b714a097,qwen1-14B,1720966404,1720966482,finished,1720966424,1720966482,A100-SXM4-80GB,8,1,64,896,20,58
28c37aaf-7b6a-4e93-907c-13cdd2bbfb61,qwen1-14B,1720966558,1720966635,finished,1720966578,1720966635,A100-SXM4-80GB,8,1,64,896,20,57
8f8e31d7-e62c-42b8-87bb-3a90e8ada1c1,qwen1-14B,1720966713,1720966791,finished,1720966733,1720966791,A100-SXM4-80GB,8,1,64,896,20,58
2d8047d0-a9cd-4cca-a291-900c47df656c,qwen1-14B,1720966869,1720966948,finished,1720966889,1720966948,A100-SXM4-80GB,8,1,64,896,20,59
1a268559-8716-4ac3-b3e4-d00269480ea0,qwen1-14B,1720967026,1720967103,finished,1720967045,1720967103,A100-SXM4-80GB,8,1,64,896,19,58
e735f5b4-dbd8-45d7-a8cc-9e8520daacb8,qwen1-14B,1720967182,1720967311,finished,1720967202,1720967311,A100-SXM4-80GB,8,1,64,896,20,109
0d74effa-1ec6-49c9-b5b5-864dc6e1ae55,mixtral-8x22b-sft,1720967276,1721020905,finished,1720967315,1721020905,A100-SXM4-80GB,8,64,64,896,39,53590
a81ada65-0948-4b94-a433-2d3276d54d9a,qwen1-14B,1720967416,1720967493,finished,1720967435,1720967493,A100-SXM4-80GB,8,1,64,896,19,58
b09a2c21-a8b4-4747-84f5-9395f3448d5c,qwen1-14B,1720967572,1720967650,finished,1720967591,1720967650,A100-SXM4-80GB,8,1,64,896,19,59
69fcbc11-c23b-49ef-9bf5-b3a88be7ee3d,qwen1-14B,1720967728,1720967805,finished,1720967748,1720967805,A100-SXM4-80GB,8,1,64,896,20,57
137837bf-2cd4-45bb-8bf9-f35f3c939ff5,qwen1-14B,1720967883,1720967959,finished,1720967902,1720967959,A100-SXM4-80GB,8,1,64,896,19,57
af7169bf-d288-4499-b143-e3b7ef4689ee,qwen1-14B,1720968038,1720968115,finished,1720968057,1720968115,A100-SXM4-80GB,8,1,64,896,19,58
e7cec906-ba1c-4704-ba56-4cf540ef2b20,train-0714B,1720968074,1721050874,finished,1720968093,1721050874,A100-SXM4-80GB,8,1,64,896,19,82781
1f8b1dc0-43ca-4b79-984c-8786ea657b97,qwen1-14B,1720968192,1720968270,finished,1720968212,1720968270,A100-SXM4-80GB,8,1,64,896,20,58
cd6a23c6-d613-4b1e-94f2-ea39c649c3a8,qwen1-14B,1720968347,1720968424,finished,1720968367,1720968424,A100-SXM4-80GB,8,1,64,896,20,57
cba0b348-bb1f-476b-a416-80e2c8c5632d,qwen1-14B,1720968502,1720968599,finished,1720968521,1720968599,A100-SXM4-80GB,8,1,64,896,19,78
56fc2486-96d4-443e-976f-5c6e8abc58ec,qwen1-14B,1720968676,1720968773,finished,1720968695,1720968773,A100-SXM4-80GB,8,1,64,896,19,78
6a5c792f-038c-4c15-a081-a8a40b45d381,qwen1-14B,1720968851,1720968931,finished,1720968871,1720968931,A100-SXM4-80GB,8,1,64,896,20,60
eeb9437b-1f60-48e7-9677-90f40de737cd,qwen1-14B,1720969009,1720969087,finished,1720969028,1720969087,A100-SXM4-80GB,8,1,64,896,19,59
b0d1f135-2524-4eba-9a8a-1c5471bfc56e,qwen1-14B,1720969165,1720969243,finished,1720969184,1720969243,A100-SXM4-80GB,8,1,64,896,19,59
f82b9fcb-f8b2-4325-9e0e-5a20010a4946,qwen1-14B,1720969321,1720969399,finished,1720969341,1720969399,A100-SXM4-80GB,8,1,64,896,20,58
9fdff5f6-1637-48c0-9948-b38c3e7c4720,qwen1-14B,1720969476,1720969553,finished,1720969495,1720969553,A100-SXM4-80GB,8,1,64,896,19,58
fdbb3452-9624-4e0a-bb98-16b733bd6df9,qwen1-14B,1720969631,1720969707,finished,1720969650,1720969707,A100-SXM4-80GB,8,1,64,896,19,57
d01fc253-9e5f-4b0a-8c1e-6ebf15ad1ae3,qwen1-14B,1720969784,1720969862,finished,1720969803,1720969862,A100-SXM4-80GB,8,1,64,896,19,59
c00b8eea-8606-40aa-9097-35dff868e150,qwen1-14B,1720969940,1720970036,finished,1720969960,1720970036,A100-SXM4-80GB,8,1,64,896,20,76
d7133a2e-8f68-4a63-aaf6-dc0d26053a64,qwen1-14B,1720970112,1720970190,finished,1720970132,1720970190,A100-SXM4-80GB,8,1,64,896,20,58
c8dd70dd-ebc3-4140-8ec1-a2547894395e,qwen1-14B,1720970268,1720970346,finished,1720970288,1720970346,A100-SXM4-80GB,8,1,64,896,20,58
82fce910-845d-403b-829f-4a0d53cdb76c,qwen1-14B,1720970424,1720970521,finished,1720970443,1720970521,A100-SXM4-80GB,8,1,64,896,19,78
f873e19b-3d29-48f5-b514-f9dce861c0a6,qwen1-14B,1720970599,1720970677,finished,1720970619,1720970677,A100-SXM4-80GB,8,1,64,896,20,58
7dcdf7ab-a704-48a5-8943-58635e337670,qwen1-14B,1720970754,1720970852,finished,1720970774,1720970852,A100-SXM4-80GB,8,1,64,896,20,78
0b74d863-c16f-48b4-aa22-0f9829b33367,qwen1-14B,1720970929,1720971007,finished,1720970948,1720971007,A100-SXM4-80GB,8,1,64,896,19,59
06b544b8-221b-4058-823b-92cbc0f41417,qwen1-14B,1720971085,1720971163,finished,1720971105,1720971163,A100-SXM4-80GB,8,1,64,896,20,58
b240b708-5ede-4948-b145-1c1dd6c1942e,qwen1-14B,1720971241,1720971338,finished,1720971260,1720971338,A100-SXM4-80GB,8,1,64,896,19,78
b04f5065-306f-4a26-aa90-ffab9da5e11d,qwen1-14B,1720971416,1720971495,finished,1720971436,1720971495,A100-SXM4-80GB,8,1,64,896,20,59
6dd22c50-0f76-411b-bf81-dc41a69e9405,qwen1-14B,1720971573,1720971652,finished,1720971593,1720971652,A100-SXM4-80GB,8,1,64,896,20,59
2cd3c5fa-c612-4fe6-bf6c-6b3287888079,qwen1-14B,1720971730,1720971807,finished,1720971749,1720971807,A100-SXM4-80GB,8,1,64,896,19,58
47dc583f-bdca-47c8-b017-9ac062fcbbc4,qwen1-14B,1720971884,1720971980,finished,1720971903,1720971980,A100-SXM4-80GB,8,1,64,896,19,77
92cc2ad6-7e9e-40c3-8656-8f6728a812df,qwen1-14B,1720972058,1720972136,finished,1720972077,1720972136,A100-SXM4-80GB,8,1,64,896,19,59
683dae97-3752-40b7-bb7d-ea86f66fdc7a,qwen1-14B,1720972213,1720972292,finished,1720972233,1720972292,A100-SXM4-80GB,8,1,64,896,20,59
02838ff8-cc6a-46fc-b861-3d6744cad8f0,qwen1-14B,1720972370,1720972448,finished,1720972389,1720972448,A100-SXM4-80GB,8,1,64,896,19,59
4a7cdb4e-65e3-4fa4-a50d-8b42fc64ed18,qwen1-14B,1720972528,1720972626,finished,1720972547,1720972626,A100-SXM4-80GB,8,1,64,896,19,79
0fa2c080-cc3b-4d84-b482-f51b99310be1,qwen1-14B,1720972704,1720972783,finished,1720972724,1720972783,A100-SXM4-80GB,8,1,64,896,20,59
79d12644-a40e-48d1-b95e-1406f264648b,qwen1-14B,1720972867,1720972944,finished,1720972886,1720972944,A100-SXM4-80GB,8,1,64,896,19,58
67a92a62-4d95-407d-ae7d-fe5a8f8236b8,qwen1-14B,1720973021,1720973118,finished,1720973040,1720973118,A100-SXM4-80GB,8,1,64,896,19,78
ecc83b7c-ff00-454b-be08-2f06913996ad,qwen1-14B,1720973198,1720973296,finished,1720973217,1720973296,A100-SXM4-80GB,8,1,64,896,19,79
7433723c-f942-4f1c-ada6-3c58c4b5f4ef,qwen1-14B,1720973374,1720973453,finished,1720973394,1720973453,A100-SXM4-80GB,8,1,64,896,20,59
39273057-19de-4a2e-8cea-d8deccd9ea98,qwen1-14B,1720973531,1720973610,finished,1720973551,1720973610,A100-SXM4-80GB,8,1,64,896,20,59
2da90b82-e7a8-4f80-8d71-b5f066dd05b4,qwen1-14B,1720973689,1720973767,finished,1720973708,1720973767,A100-SXM4-80GB,8,1,64,896,19,59
a42c3733-3a47-4562-b923-969e23032446,qwen1-14B,1720973845,1720973923,finished,1720973864,1720973923,A100-SXM4-80GB,8,1,64,896,19,59
14a25424-33f4-4fc8-bf35-91a97ce5b445,qwen1-14B,1720974001,1720974079,finished,1720974020,1720974079,A100-SXM4-80GB,8,1,64,896,19,59
b8d78080-8297-4f8b-8687-43d30e572415,qwen1-14B,1720974156,1720974254,finished,1720974176,1720974254,A100-SXM4-80GB,8,1,64,896,20,78
ba2e7880-3c60-4889-bd65-5cc4584a736a,qwen1-14B,1720974332,1720974410,finished,1720974351,1720974410,A100-SXM4-80GB,8,1,64,896,19,59
bcff5474-3073-44d0-b09b-3232b0919a2f,qwen1-14B,1720974487,1720974565,finished,1720974506,1720974565,A100-SXM4-80GB,8,1,64,896,19,59
2b21760f-de67-43d4-8f97-5b12cffd7151,qwen1-14B,1720974643,1720974740,finished,1720974662,1720974740,A100-SXM4-80GB,8,1,64,896,19,78
b7667ca6-5878-4a4f-b1de-c70e61abfd50,qwen1-14B,1720974819,1720974897,finished,1720974838,1720974897,A100-SXM4-80GB,8,1,64,896,19,59
7d53a64b-dac8-4c12-adc7-911fdda32d55,qwen1-14B,1720974975,1720975053,finished,1720974995,1720975053,A100-SXM4-80GB,8,1,64,896,20,58
355ddd11-1847-4d9e-a623-cc65268bf79d,qwen1-14B,1720975131,1720975211,finished,1720975151,1720975211,A100-SXM4-80GB,8,1,64,896,20,60
45b2e8f2-b48f-4d1b-a65c-5e4f3bb52126,qwen1-14B,1720975289,1720975366,finished,1720975309,1720975366,A100-SXM4-80GB,8,1,64,896,20,57
50824b5c-48c7-4d6b-925f-9ed6ccfaddac,qwen1-14B,1720975442,1720975519,finished,1720975461,1720975519,A100-SXM4-80GB,8,1,64,896,19,58
b1b9ae4a-f596-42e6-ae4d-ef28b1f86d06,qwen1-14B,1720975597,1720975676,finished,1720975617,1720975676,A100-SXM4-80GB,8,1,64,896,20,59
60da1f4e-67df-4342-9f64-4c59463d071e,qwen1-14B,1720975754,1720975832,finished,1720975774,1720975832,A100-SXM4-80GB,8,1,64,896,20,58
c5dc40fd-ebb0-42b5-b943-c2646aa481c0,qwen1-14B,1720975911,1720975989,finished,1720975930,1720975989,A100-SXM4-80GB,8,1,64,896,19,59
195ee147-37cb-418a-ae1c-8e4ae778f16f,qwen1-14B,1720976067,1720976145,finished,1720976086,1720976145,A100-SXM4-80GB,8,1,64,896,19,59
79961757-4b77-4cf8-810b-6e13fd31f33e,qwen1-14B,1720976223,1720976300,finished,1720976242,1720976300,A100-SXM4-80GB,8,1,64,896,19,58
4e8a3b80-fa25-47b6-911f-e61bc81496d5,qwen1-14B,1720976378,1720976477,finished,1720976398,1720976477,A100-SXM4-80GB,8,1,64,896,20,79
3d97e087-e029-4a1a-b9b7-337d60823cb5,qwen1-14B,1720976556,1720976635,finished,1720976576,1720976635,A100-SXM4-80GB,8,1,64,896,20,59
71fce969-3639-4760-9151-757579a6cc34,qwen1-14B,1720976714,1720976792,finished,1720976733,1720976792,A100-SXM4-80GB,8,1,64,896,19,59
7342bbf5-6db2-4be0-b889-0ff005031ae8,qwen1-14B,1720976871,1720976967,finished,1720976890,1720976967,A100-SXM4-80GB,8,1,64,896,19,77
ca7b66a6-68a1-4c53-a0a3-f4b82311d837,qwen1-14B,1720977046,1720977124,finished,1720977065,1720977124,A100-SXM4-80GB,8,1,64,896,19,59
060576fc-93cc-4f87-a3ac-6fd2bae98a86,qwen1-14B,1720977200,1720977277,finished,1720977219,1720977277,A100-SXM4-80GB,8,1,64,896,19,58
877d416d-0d89-4aa7-a91a-9c9b2482a2b4,qwen1-14B,1720977356,1720977434,finished,1720977376,1720977434,A100-SXM4-80GB,8,1,64,896,20,58
d4978565-c18c-4583-b052-a55645b4ff26,qwen1-14B,1720977511,1720977588,finished,1720977531,1720977588,A100-SXM4-80GB,8,1,64,896,20,57
a2296cf5-e182-4ce3-9ab0-3f2217332235,qwen1-14B,1720977666,1720977743,finished,1720977685,1720977743,A100-SXM4-80GB,8,1,64,896,19,58
caa3acf8-dfde-4e34-91bb-7f1827d00240,qwen1-14B,1720977821,1720977899,finished,1720977841,1720977899,A100-SXM4-80GB,8,1,64,896,20,58
e6fe86db-b0b7-41fc-9574-8a328c8aff2a,qwen1-14B,1720977977,1720978074,finished,1720977997,1720978074,A100-SXM4-80GB,8,1,64,896,20,77
167a8ee6-3136-45d4-9b19-b632a9549b00,qwen1-14B,1720978151,1720978229,finished,1720978170,1720978229,A100-SXM4-80GB,8,1,64,896,19,59
c3bbecb0-9962-4cef-a3ed-e1d96ac27782,qwen1-14B,1720978307,1720978385,finished,1720978327,1720978385,A100-SXM4-80GB,8,1,64,896,20,58
74ce0714-b57c-4c27-b378-e84ce8b9c9f5,qwen1-14B,1720978464,1720978561,finished,1720978484,1720978561,A100-SXM4-80GB,8,1,64,896,20,77
b20e3773-a56e-4205-8969-18847e42015d,qwen1-14B,1720978639,1720978736,finished,1720978658,1720978736,A100-SXM4-80GB,8,1,64,896,19,78
415b0f8e-727e-4c88-bad6-491e401d0918,qwen1-14B,1720978815,1720978892,finished,1720978834,1720978892,A100-SXM4-80GB,8,1,64,896,19,58
09ff9e7c-7785-447f-985b-f3fbf77cb4ed,qwen1-14B,1720978970,1720979048,finished,1720978990,1720979048,A100-SXM4-80GB,8,1,64,896,20,58
0fc3181a-5cbd-4f19-98ee-e6feed4d86dd,qwen1-14B,1720979127,1720979205,finished,1720979147,1720979205,A100-SXM4-80GB,8,1,64,896,20,58
56aff3e8-df24-4a7a-847e-40a47050033a,geo-seesaw-sft-code-alpaca-ultra-eval-test,1720979130,1721183125,finished,1720979150,1721183125,A100-SXM4-80GB,8,1,64,896,20,203975
2c7c1c56-3c6f-4f5d-be7e-aa07290eebce,qwen1-14B,1720979282,1720979379,finished,1720979302,1720979379,A100-SXM4-80GB,8,1,64,896,20,77
daa1371f-16c6-4d10-860a-29c82ea46ba7,qwen1-14B,1720979456,1720979533,finished,1720979476,1720979533,A100-SXM4-80GB,8,1,64,896,20,57
752bc9c0-b9a4-4acb-9a1c-44349c43eeff,qwen1-14B,1720979612,1720979690,finished,1720979631,1720979690,A100-SXM4-80GB,8,1,64,896,19,59
6ca8f52e-32e0-4d4e-b04b-409c54acadc8,qwen1-14B,1720979769,1720979846,finished,1720979788,1720979846,A100-SXM4-80GB,8,1,64,896,19,58
d207ba94-a054-48ca-aed1-c348aa45c2c1,qwen1-14B,1720979923,1720980005,finished,1720979943,1720980005,A100-SXM4-80GB,8,1,64,896,20,62
b2c55f50-55f9-434b-92f0-cfd853d60adf,geogpt-prompt-tuning-tg-infer2,1720979995,1721013766,finished,1720980018,1721013766,A100-SXM4-80GB,8,1,64,448,23,33748
16bc9154-444b-4b70-97c4-36a17d8f60ed,geogpt-prompt-tuning-tg-infer1,1720980018,1721029479,finished,1721013907,1721029479,A100-SXM4-80GB,8,1,64,448,33889,15572
e35b1095-25fe-44c1-b95f-db3816a4ca71,qwen1-14B,1720980088,1720980167,finished,1720980108,1720980167,A100-SXM4-80GB,8,1,64,896,20,59
795c4421-275d-4c19-84bd-6c939b1026d6,qwen1-14B,1720980245,1720980343,finished,1720980265,1720980343,A100-SXM4-80GB,8,1,64,896,20,78
07b3721b-d34b-4c08-b582-a0a1365a7184,qwen1-14B,1720980422,1720980500,finished,1720980442,1720980500,A100-SXM4-80GB,8,1,64,896,20,58
fbb185b7-60cf-489f-a3c0-c57672b74eb6,qwen1-14B,1720980579,1720980657,finished,1720980598,1720980657,A100-SXM4-80GB,8,1,64,896,19,59
dfadc1eb-b69f-4655-bd8e-14da3b052d46,qwen1-14B,1720980733,1720980830,finished,1720980752,1720980830,A100-SXM4-80GB,8,1,64,896,19,78
0c2cc3ec-0d5b-413c-8288-349fccbf32cd,qwen1-14B,1720980908,1720980986,finished,1720980928,1720980986,A100-SXM4-80GB,8,1,64,896,20,58
cf58038e-c231-4459-a134-e9ddfdfe9e99,qwen1-14B,1720981064,1720981142,finished,1720981084,1720981142,A100-SXM4-80GB,8,1,64,896,20,58
fe7c785a-776f-4fc4-a76a-0fbc13e3c070,qwen1-14B,1720981219,1720981296,finished,1720981238,1720981296,A100-SXM4-80GB,8,1,64,896,19,58
29acf614-5f07-4898-a8d5-d75f268b3c82,qwen1-14B,1720981374,1720981453,finished,1720981394,1720981453,A100-SXM4-80GB,8,1,64,896,20,59
feedbcdf-1ed8-4eaa-a4f3-639a80b86991,qwen1-14B,1720981531,1720981610,finished,1720981551,1720981610,A100-SXM4-80GB,8,1,64,896,20,59
3ac64ac2-9dee-4804-8470-c173ca75f698,qwen1-14B,1720981687,1720981783,finished,1720981706,1720981783,A100-SXM4-80GB,8,1,64,896,19,77
c13d6793-eb71-4f18-8621-6fd8e168ad4f,qwen1-14B,1720981861,1720981957,finished,1720981880,1720981957,A100-SXM4-80GB,8,1,64,896,19,77
f0d506dd-e294-496d-9b4a-8fcf39f40743,qwen1-14B,1720982034,1720982131,finished,1720982053,1720982131,A100-SXM4-80GB,8,1,64,896,19,78
c8f46226-02bb-4ee3-a46c-fdc7ca964fb5,qwen1-14B,1720982209,1720982287,finished,1720982229,1720982287,A100-SXM4-80GB,8,1,64,896,20,58
067245c6-bca5-4c59-970e-9c57daf7ebb1,qwen1-14B,1720982365,1720982444,finished,1720982385,1720982444,A100-SXM4-80GB,8,1,64,896,20,59
48306a1e-f689-4f5c-bb1f-6b9231b23270,qwen1-14B,1720982522,1720982600,finished,1720982542,1720982600,A100-SXM4-80GB,8,1,64,896,20,58
adc1827a-2834-4be7-895f-5a9b25d1ea46,qwen1-14B,1720982679,1720982773,finished,1720982698,1720982773,A100-SXM4-80GB,8,1,64,896,19,75
9704ab08-1992-4ccc-b819-7c8ba71bc283,qwen1-14B,1720982851,1720982928,finished,1720982870,1720982928,A100-SXM4-80GB,8,1,64,896,19,58
133964d2-e472-4b64-a39a-fc3dd8dfcde6,qwen1-14B,1720983007,1720983085,finished,1720983026,1720983085,A100-SXM4-80GB,8,1,64,896,19,59
ea27e90a-14a5-4485-bc2d-7b4d30f60a2f,qwen1-14B,1720983164,1720983242,finished,1720983184,1720983242,A100-SXM4-80GB,8,1,64,896,20,58
adb9e1a2-8b89-4b86-b6ad-4c13dc7119d0,qwen1-14B,1720983321,1720983399,finished,1720983340,1720983399,A100-SXM4-80GB,8,1,64,896,19,59
f3065dc0-2a91-4ea4-8c5c-8a88f1ac07c2,qwen1-14B,1720983475,1720983571,finished,1720983494,1720983571,A100-SXM4-80GB,8,1,64,896,19,77
1f7b469e-aa93-4d40-8824-2ecca7c8386d,qwen1-14B,1720983649,1720983727,finished,1720983668,1720983727,A100-SXM4-80GB,8,1,64,896,19,59
4fc7a8e7-ca58-4f77-b682-1e90601c2498,qwen1-14B,1720983804,1720983902,finished,1720983824,1720983902,A100-SXM4-80GB,8,1,64,896,20,78
ef72b13e-fdf4-4e0a-81d6-e59b1b21ad7b,qwen1-14B,1720983981,1720984059,finished,1720984000,1720984059,A100-SXM4-80GB,8,1,64,896,19,59
ae1d70d4-269a-4069-bbab-3a34bb6fd4c3,qwen1-14B,1720984136,1720984235,finished,1720984156,1720984235,A100-SXM4-80GB,8,1,64,896,20,79
665f5f32-5a0e-48e6-acb7-fb507f8e0116,qwen1-14B,1720984313,1720984410,finished,1720984332,1720984410,A100-SXM4-80GB,8,1,64,896,19,78
c5eb0ad8-084f-4cde-a359-2e96712f3175,qwen1-14B,1720984488,1720984565,finished,1720984507,1720984565,A100-SXM4-80GB,8,1,64,896,19,58
1d2b2570-e3ef-4ff8-b105-9e41bd363114,qwen1-14B,1720984642,1720984740,finished,1720984662,1720984740,A100-SXM4-80GB,8,1,64,896,20,78
f671cf72-149d-4191-9445-e2513dd87741,qwen1-14B,1720984817,1720984894,finished,1720984837,1720984894,A100-SXM4-80GB,8,1,64,896,20,57
71d3e67c-a7d0-498a-945f-5b0b3b0186f1,qwen1-14B,1720984972,1720985050,finished,1720984991,1720985050,A100-SXM4-80GB,8,1,64,896,19,59
6bfb12d3-cbb5-41ad-97b7-08e81d2e4cab,qwen1-14B,1720985128,1720985207,finished,1720985148,1720985207,A100-SXM4-80GB,8,1,64,896,20,59
81fe8c10-0e39-416d-9f5f-1d9111d48569,qwen1-14B,1720985285,1720985362,finished,1720985305,1720985362,A100-SXM4-80GB,8,1,64,896,20,57
cb284d12-70de-4860-a1a3-5cccc241bba8,qwen1-14B,1720985439,1720985517,finished,1720985459,1720985517,A100-SXM4-80GB,8,1,64,896,20,58
f49bea8a-492a-472d-a3dd-11082e114c3d,qwen1-14B,1720985595,1720985672,finished,1720985614,1720985672,A100-SXM4-80GB,8,1,64,896,19,58
97cba17a-48e8-40c4-8fe2-2c9f9d8d6ea0,qwen1-14B,1720985750,1720985848,finished,1720985770,1720985848,A100-SXM4-80GB,8,1,64,896,20,78
b8e423f8-c9cf-4c6e-bd5b-3e909d9e9f7e,qwen1-14B,1720985926,1720986005,finished,1720985946,1720986005,A100-SXM4-80GB,8,1,64,896,20,59
3ecfa1b4-c636-4851-b160-d3790632d81a,qwen1-14B,1720986085,1720986180,finished,1720986104,1720986180,A100-SXM4-80GB,8,1,64,896,19,76
40f13764-2e50-4015-a27c-e5b3f5d74690,qwen1-14B,1720986257,1720986354,finished,1720986276,1720986354,A100-SXM4-80GB,8,1,64,896,19,78
72108800-68fe-453a-8337-98aa7748edc8,qwen1-14B,1720986431,1720986508,finished,1720986451,1720986508,A100-SXM4-80GB,8,1,64,896,20,57
39beaf54-f015-4279-8ae6-037715d5766e,qwen1-14B,1720986586,1720986665,finished,1720986606,1720986665,A100-SXM4-80GB,8,1,64,896,20,59
65597350-6cc9-4158-8087-18c2b99406fe,qwen1-14B,1720986742,1720986819,finished,1720986761,1720986819,A100-SXM4-80GB,8,1,64,896,19,58
280869cd-5372-4b58-be65-b85d510d2575,qwen1-14B,1720986897,1720986975,finished,1720986917,1720986975,A100-SXM4-80GB,8,1,64,896,20,58
a6f1f7ff-c952-4192-a4ad-035829a24a7f,qwen1-14B,1720987052,1720987129,finished,1720987071,1720987129,A100-SXM4-80GB,8,1,64,896,19,58
c8b6c190-26db-42cd-b1a1-750c366cfdde,qwen1-14B,1720987207,1720987286,finished,1720987228,1720987286,A100-SXM4-80GB,8,1,64,896,21,58
cd85f84a-a392-4cef-a461-be44e10349bb,qwen1-14B,1720987363,1720987462,finished,1720987383,1720987462,A100-SXM4-80GB,8,1,64,896,20,79
70360a10-803b-4841-9b39-4ceebb66e642,qwen1-14B,1720987540,1720987637,finished,1720987559,1720987637,A100-SXM4-80GB,8,1,64,896,19,78
184fd0b5-41da-44fe-98be-4f0bf8250b65,qwen1-14B,1720987716,1720987795,finished,1720987735,1720987795,A100-SXM4-80GB,8,1,64,896,19,60
48960290-7a8d-4d4b-90b3-cb1a9401e540,qwen1-14B,1720987873,1720987952,finished,1720987894,1720987952,A100-SXM4-80GB,8,1,64,896,21,58
cf81811a-d400-4ce8-b4a6-d9feb20b8d16,qwen1-14B,1720988029,1720988108,finished,1720988049,1720988108,A100-SXM4-80GB,8,1,64,896,20,59
07d50340-ed24-42da-be3a-f20c8dd9bbb6,qwen1-14B,1720988186,1720988282,finished,1720988205,1720988282,A100-SXM4-80GB,8,1,64,896,19,77
77be2577-4932-4909-8b5d-d705aa6cb5eb,qwen1-14B,1720988359,1720988437,finished,1720988378,1720988437,A100-SXM4-80GB,8,1,64,896,19,59
3be109f7-dea6-4a97-8223-0bf78f58bb36,qwen1-14B,1720988515,1720988612,finished,1720988534,1720988612,A100-SXM4-80GB,8,1,64,896,19,78
41b73267-fa6d-4e09-890d-cea7efaf52d4,qwen1-14B,1720988690,1720988769,finished,1720988710,1720988769,A100-SXM4-80GB,8,1,64,896,20,59
140a48a9-c15b-422e-8f40-b43df0d3b431,qwen1-14B,1720988847,1720988926,finished,1720988867,1720988926,A100-SXM4-80GB,8,1,64,896,20,59
61596bbc-de66-49a1-8058-13738277160f,qwen1-14B,1720989003,1720989100,finished,1720989022,1720989100,A100-SXM4-80GB,8,1,64,896,19,78
2fe6912c-df39-4e9e-9007-1f5d52526030,qwen1-14B,1720989176,1720989273,finished,1720989195,1720989273,A100-SXM4-80GB,8,1,64,896,19,78
15c6cfcd-75d9-4a2d-975e-7c7ff175ab33,qwen1-14B,1720989350,1720989448,finished,1720989370,1720989448,A100-SXM4-80GB,8,1,64,896,20,78
31d87196-6147-41a5-8fc8-d0aac71e712c,qwen1-14B,1720989525,1720989601,finished,1720989544,1720989601,A100-SXM4-80GB,8,1,64,896,19,57
9c0df6b2-aaf6-457f-989f-c9a5ca36bea2,qwen1-14B,1720989679,1720989777,finished,1720989699,1720989777,A100-SXM4-80GB,8,1,64,896,20,78
d03fc515-4c98-4711-bd7b-11e8ea58863b,qwen1-14B,1720989856,1720989933,finished,1720989876,1720989933,A100-SXM4-80GB,8,1,64,896,20,57
1307b9cc-5828-4771-abab-18baada129e8,qwen1-14B,1720990010,1720990087,finished,1720990029,1720990087,A100-SXM4-80GB,8,1,64,896,19,58
9ae3d7dd-de5f-4874-8136-b74b44cf5dcd,qwen1-14B,1720990165,1720990243,finished,1720990184,1720990243,A100-SXM4-80GB,8,1,64,896,19,59
2f90035f-099e-4be8-a05e-6fd82b75057f,qwen1-14B,1720990321,1720990416,finished,1720990340,1720990416,A100-SXM4-80GB,8,1,64,896,19,76
4a62dea6-676c-4e73-ba3f-02434a60f42f,qwen1-14B,1720990492,1720990571,finished,1720990512,1720990571,A100-SXM4-80GB,8,1,64,896,20,59
5e5868ed-d8ca-4d0c-a3cf-580653b6066e,qwen1-14B,1720990649,1720990746,finished,1720990668,1720990746,A100-SXM4-80GB,8,1,64,896,19,78
139a8929-fa2a-4b73-baa3-9fedaebc739b,qwen1-14B,1720990825,1720990903,finished,1720990844,1720990903,A100-SXM4-80GB,8,1,64,896,19,59
13ca325d-b6e2-4c31-ba5a-14e7cb5c2338,qwen1-14B,1720990981,1720991059,finished,1720991001,1720991059,A100-SXM4-80GB,8,1,64,896,20,58
9953adee-54ad-4aa7-af6c-7778d32120d9,qwen1-14B,1720991136,1720991213,finished,1720991156,1720991213,A100-SXM4-80GB,8,1,64,896,20,57
7ae33d16-c5c6-4963-9908-3e3229e457ee,qwen1-14B,1720991292,1720991390,finished,1720991311,1720991390,A100-SXM4-80GB,8,1,64,896,19,79
7c1a4ca8-a55f-4d63-a4a4-b673ee718cd2,qwen1-14B,1720991468,1720991543,finished,1720991487,1720991543,A100-SXM4-80GB,8,1,64,896,19,56
b5ed8cca-3b03-490a-a756-136e23c38ca9,qwen1-14B,1720991620,1720991697,finished,1720991639,1720991697,A100-SXM4-80GB,8,1,64,896,19,58
30602d79-ac6e-4d37-bd30-f455c6caff11,qwen1-14B,1720991775,1720991852,finished,1720991794,1720991852,A100-SXM4-80GB,8,1,64,896,19,58
5c205644-216b-469b-98aa-12f17d4a0778,qwen1-14B,1720991929,1720992006,finished,1720991949,1720992006,A100-SXM4-80GB,8,1,64,896,20,57
69a4ebbd-860f-4b20-b251-18c6397fe077,qwen1-14B,1720992084,1720992161,finished,1720992103,1720992161,A100-SXM4-80GB,8,1,64,896,19,58
28cc9943-77c0-4f67-868c-4b95cda49ea9,qwen1-14B,1720992238,1720992317,finished,1720992258,1720992317,A100-SXM4-80GB,8,1,64,896,20,59
a6149f59-ac23-471a-801b-f6b88a3df497,qwen1-14B,1720992395,1720992493,finished,1720992414,1720992493,A100-SXM4-80GB,8,1,64,896,19,79
7689ba3e-6de9-425a-b620-5e6cec000af1,qwen1-14B,1720992571,1720992649,finished,1720992590,1720992649,A100-SXM4-80GB,8,1,64,896,19,59
cb78ea10-bccb-40b4-8c27-e486b2b609cb,qwen1-14B,1720992728,1720992805,finished,1720992747,1720992805,A100-SXM4-80GB,8,1,64,896,19,58
e0317e42-efbf-4870-b8c6-6ba605c130f2,qwen1-14B,1720992883,1720992960,finished,1720992902,1720992960,A100-SXM4-80GB,8,1,64,896,19,58
bca1a555-d413-4ce2-b0b6-c1e72599e7b8,qwen1-14B,1720993038,1720993136,finished,1720993058,1720993136,A100-SXM4-80GB,8,1,64,896,20,78
13cd1b7f-bd60-4ebf-84c1-a42f74c51ee2,qwen1-14B,1720993215,1720993312,finished,1720993234,1720993312,A100-SXM4-80GB,8,1,64,896,19,78
38820911-cda9-4026-aad2-9e42979aff82,qwen1-14B,1720993390,1720993468,finished,1720993410,1720993468,A100-SXM4-80GB,8,1,64,896,20,58
4121ed9c-4e99-4ad0-8142-b366f7a6302f,qwen1-14B,1720993544,1720993622,finished,1720993563,1720993622,A100-SXM4-80GB,8,1,64,896,19,59
aba71776-f9c5-4303-ad92-e64efa7d3be3,qwen1-14B,1720993699,1720993776,finished,1720993718,1720993776,A100-SXM4-80GB,8,1,64,896,19,58
f988c150-5982-4b32-9691-20268c279da7,qwen1-14B,1720993853,1720993931,finished,1720993872,1720993931,A100-SXM4-80GB,8,1,64,896,19,59
a9c76c63-f5fd-429b-b500-8590af6c78de,qwen1-14B,1720994008,1720994085,finished,1720994028,1720994085,A100-SXM4-80GB,8,1,64,896,20,57
d9b6c331-7775-4d5d-9197-ab1d565a5d18,qwen1-14B,1720994162,1720994239,finished,1720994181,1720994239,A100-SXM4-80GB,8,1,64,896,19,58
cd2fab64-87d2-457f-8bd6-8812137fa0cf,qwen1-14B,1720994315,1720994392,finished,1720994334,1720994392,A100-SXM4-80GB,8,1,64,896,19,58
060a230e-9a45-443b-b3d8-e6ae55794899,qwen1-14B,1720994470,1720994546,finished,1720994489,1720994546,A100-SXM4-80GB,8,1,64,896,19,57
492dfe50-b3e0-4b5f-9bcf-6041fd54bb99,qwen1-14B,1720994624,1720994700,finished,1720994643,1720994700,A100-SXM4-80GB,8,1,64,896,19,57
bd04e364-e6e3-414c-a30f-98ba5b193b7e,qwen1-14B,1720994778,1720994856,finished,1720994797,1720994856,A100-SXM4-80GB,8,1,64,896,19,59
a31a261b-6524-457e-8dfd-9a5ceccd9931,qwen1-14B,1720994934,1720995010,finished,1720994953,1720995010,A100-SXM4-80GB,8,1,64,896,19,57
9bf06c85-ab4a-4988-9862-aaf0d2295680,qwen1-14B,1720995088,1720995184,finished,1720995107,1720995184,A100-SXM4-80GB,8,1,64,896,19,77
78cb3f02-f7d6-4317-a28e-b150d3ab83e8,qwen1-14B,1720995262,1720995341,finished,1720995282,1720995341,A100-SXM4-80GB,8,1,64,896,20,59
c7755035-cd34-451b-8886-c01911af4cd3,qwen1-14B,1720995418,1720995495,finished,1720995438,1720995495,A100-SXM4-80GB,8,1,64,896,20,57
4b73c221-7542-4170-93bc-bff9ebe42a6b,qwen1-14B,1720995573,1720995669,finished,1720995593,1720995669,A100-SXM4-80GB,8,1,64,896,20,76
6802e273-7b39-4c59-ac37-d508cf8465c7,qwen1-14B,1720995745,1720995822,finished,1720995764,1720995822,A100-SXM4-80GB,8,1,64,896,19,58
ffe14542-5534-4441-b9e2-24c41ed616f3,qwen1-14B,1720995898,1720995976,finished,1720995918,1720995976,A100-SXM4-80GB,8,1,64,896,20,58
bdb43763-04dd-46b0-98a4-b0d02479d9f7,qwen1-14B,1720996053,1720996149,finished,1720996073,1720996149,A100-SXM4-80GB,8,1,64,896,20,76
cf49ba47-a42f-4fb4-949d-5e56e02f3a3c,qwen1-14B,1720996225,1720996302,finished,1720996245,1720996302,A100-SXM4-80GB,8,1,64,896,20,57
1f9331a0-50f6-44a1-8104-526fc9deb9ff,qwen1-14B,1720996378,1720996456,finished,1720996398,1720996456,A100-SXM4-80GB,8,1,64,896,20,58
6e772ed3-64d3-48b7-bef0-9253f316412c,qwen1-14B,1720996534,1720996630,finished,1720996553,1720996630,A100-SXM4-80GB,8,1,64,896,19,77
0cfda8b0-fac9-431a-84ed-59113722c04a,qwen1-14B,1720996707,1720996783,finished,1720996727,1720996783,A100-SXM4-80GB,8,1,64,896,20,56
7b713468-e9cb-4f48-818a-cfbada4803fa,qwen1-14B,1720996861,1720996937,finished,1720996879,1720996937,A100-SXM4-80GB,8,1,64,896,18,58
d442f6d9-aa64-4590-b0ed-15f79d2644f9,qwen1-14B,1720997014,1720997092,finished,1720997034,1720997092,A100-SXM4-80GB,8,1,64,896,20,58
2e847170-2595-4af8-883b-159dd9944ce2,qwen1-14B,1720997169,1720997246,finished,1720997188,1720997246,A100-SXM4-80GB,8,1,64,896,19,58
e9827322-fbcb-4b5f-b1da-75a59b91fcc0,qwen1-14B,1720997323,1720997402,finished,1720997342,1720997402,A100-SXM4-80GB,8,1,64,896,19,60
92b7674b-e35c-4952-b891-a1ec2c2c1a03,qwen1-14B,1720997479,1720997557,finished,1720997499,1720997557,A100-SXM4-80GB,8,1,64,896,20,58
0e4e3697-a33c-46db-b714-33f5fc11d8cb,qwen1-14B,1720997634,1720997712,finished,1720997653,1720997712,A100-SXM4-80GB,8,1,64,896,19,59
2e7cedfd-c163-4f1e-ad6b-cd41cb8c9c39,qwen1-14B,1720997790,1720997867,finished,1720997809,1720997867,A100-SXM4-80GB,8,1,64,896,19,58
2237a5f2-e45c-4c77-be82-3dcf4c9a6a35,qwen1-14B,1720997944,1720998021,finished,1720997964,1720998021,A100-SXM4-80GB,8,1,64,896,20,57
dc8152f3-5ef9-43c3-a48d-86c1e488a4f9,qwen1-14B,1720998099,1720998177,finished,1720998118,1720998177,A100-SXM4-80GB,8,1,64,896,19,59
d4bb1da9-491e-4c91-81ba-0b48740adb41,qwen1-14B,1720998256,1720998333,finished,1720998275,1720998333,A100-SXM4-80GB,8,1,64,896,19,58
8476717a-e48e-44d0-aad0-faa0084d1c67,qwen1-14B,1720998410,1720998487,finished,1720998429,1720998487,A100-SXM4-80GB,8,1,64,896,19,58
b922334e-5f60-4ec3-9d05-0c43152cdadf,qwen1-14B,1720998565,1720998642,finished,1720998584,1720998642,A100-SXM4-80GB,8,1,64,896,19,58
7f9e1be0-6908-4c15-92eb-543d38fc2b46,qwen1-14B,1720998720,1720998795,finished,1720998739,1720998795,A100-SXM4-80GB,8,1,64,896,19,56
c5f8b096-8d74-45b8-a220-576f6b778ab5,qwen1-14B,1720998871,1720998948,finished,1720998891,1720998948,A100-SXM4-80GB,8,1,64,896,20,57
7fff1091-1329-42d3-9473-5de8c52f9a1b,qwen1-14B,1720999026,1720999103,finished,1720999045,1720999103,A100-SXM4-80GB,8,1,64,896,19,58
29a8d8bc-9bbc-4ad0-ac88-da06f59014a9,qwen1-14B,1720999180,1720999257,finished,1720999199,1720999257,A100-SXM4-80GB,8,1,64,896,19,58
7b9880b7-6567-4ce6-8c8f-e6eb7a87fcf6,qwen1-14B,1720999334,1720999410,finished,1720999353,1720999410,A100-SXM4-80GB,8,1,64,896,19,57
84ad1dc2-591e-4b8f-9ffd-cbe8827707ab,qwen1-14B,1720999487,1720999564,finished,1720999506,1720999564,A100-SXM4-80GB,8,1,64,896,19,58
5b52cc96-2c51-43c1-8b90-77adc12f29e4,qwen1-14B,1720999642,1720999719,finished,1720999661,1720999719,A100-SXM4-80GB,8,1,64,896,19,58
e36f3b6c-ff86-40dc-8fda-0ad6068f848f,qwen1-14B,1720999797,1720999873,finished,1720999816,1720999873,A100-SXM4-80GB,8,1,64,896,19,57
f9041ad1-e8ce-41a0-b426-4dfd60762aab,qwen1-14B,1720999950,1721000045,finished,1720999969,1721000045,A100-SXM4-80GB,8,1,64,896,19,76
68b058a4-77cb-445c-bc7f-85dd94508725,qwen1-14B,1721000122,1721000200,finished,1721000141,1721000200,A100-SXM4-80GB,8,1,64,896,19,59
078f9eb5-9f0d-4cbc-a505-9a37ac0e95c2,qwen1-14B,1721000277,1721000375,finished,1721000297,1721000375,A100-SXM4-80GB,8,1,64,896,20,78
41bb5ffe-fa36-45fd-a6de-0c36c8eb4d1f,qwen1-14B,1721000451,1721000526,finished,1721000470,1721000526,A100-SXM4-80GB,8,1,64,896,19,56
3c442854-ed7c-4fb5-bbab-d7183dacffe2,qwen1-14B,1721000600,1721000676,finished,1721000619,1721000676,A100-SXM4-80GB,8,1,64,896,19,57
a0fc9062-39ae-4418-ae0c-d6faa7d92b36,qwen1-14B,1721000755,1721000832,finished,1721000774,1721000832,A100-SXM4-80GB,8,1,64,896,19,58
7f38fa3f-7d40-40e8-8af1-aae006a94494,qwen1-14B,1721000910,1721000988,finished,1721000929,1721000988,A100-SXM4-80GB,8,1,64,896,19,59
10fd0565-d7ce-4c8d-8213-83e007e97668,qwen1-14B,1721001066,1721001143,finished,1721001085,1721001143,A100-SXM4-80GB,8,1,64,896,19,58
89ac382b-c9a2-4824-9518-183d90c670c9,qwen1-14B,1721001220,1721001298,finished,1721001240,1721001298,A100-SXM4-80GB,8,1,64,896,20,58
82f5380c-cb1c-4312-b4c4-c502b2c8b73f,qwen1-14B,1721001374,1721001451,finished,1721001393,1721001451,A100-SXM4-80GB,8,1,64,896,19,58
ea67a839-a119-4f7d-9555-f89d42ca740e,qwen1-14B,1721001529,1721001627,finished,1721001548,1721001627,A100-SXM4-80GB,8,1,64,896,19,79
ca173a58-cb8b-4efd-9988-4a756ba91d34,qwen1-14B,1721001704,1721001781,finished,1721001724,1721001781,A100-SXM4-80GB,8,1,64,896,20,57
2775a14d-a73c-4cd0-a0c8-da87af6dca47,qwen1-14B,1721001858,1721001934,finished,1721001877,1721001934,A100-SXM4-80GB,8,1,64,896,19,57
45529837-30ff-4d8b-8c4b-f7cab8f9898c,qwen1-14B,1721002011,1721002105,finished,1721002030,1721002105,A100-SXM4-80GB,8,1,64,896,19,75
c0abbefc-0e14-46d9-9fc0-a2633a6930f7,qwen1-14B,1721002183,1721002281,finished,1721002203,1721002281,A100-SXM4-80GB,8,1,64,896,20,78
da7d7890-ba3d-4e99-ab98-e6c48fcc05af,qwen1-14B,1721002358,1721002433,finished,1721002376,1721002433,A100-SXM4-80GB,8,1,64,896,18,57
0efb7a45-ed6f-4eac-9a5a-9edf0a57ab50,qwen1-14B,1721002509,1721002586,finished,1721002528,1721002586,A100-SXM4-80GB,8,1,64,896,19,58
6fc1fab9-b71d-44ae-a261-fd589c7e25c9,qwen1-14B,1721002662,1721002739,finished,1721002681,1721002739,A100-SXM4-80GB,8,1,64,896,19,58
6743fd30-5ac1-4343-89d6-df16825da62a,qwen1-14B,1721002816,1721002894,finished,1721002836,1721002894,A100-SXM4-80GB,8,1,64,896,20,58
797fe93b-3af5-497e-a1d7-08e0e645fb3e,qwen1-14B,1721002970,1721003047,finished,1721002989,1721003047,A100-SXM4-80GB,8,1,64,896,19,58
8e91f0fa-de77-4bc4-b3e2-10fbd884aab5,qwen1-14B,1721003125,1721003203,finished,1721003144,1721003203,A100-SXM4-80GB,8,1,64,896,19,59
b5d79035-c6bc-468a-8ef1-530eb3d7b5fd,qwen1-14B,1721003280,1721003356,finished,1721003299,1721003356,A100-SXM4-80GB,8,1,64,896,19,57
8eda0956-fa00-44c8-a899-dc160849790c,qwen1-14B,1721003432,1721003508,finished,1721003451,1721003508,A100-SXM4-80GB,8,1,64,896,19,57
1d34130a-d21e-4a1c-b898-74b565e08183,qwen1-14B,1721003586,1721003663,finished,1721003605,1721003663,A100-SXM4-80GB,8,1,64,896,19,58
430f52a2-4962-48d6-a187-02c5198c803e,qwen1-14B,1721003738,1721003815,finished,1721003757,1721003815,A100-SXM4-80GB,8,1,64,896,19,58
2e56a174-6b8e-4256-bc1d-a6b1f8a50460,qwen1-14B,1721003891,1721003968,finished,1721003910,1721003968,A100-SXM4-80GB,8,1,64,896,19,58
4949f9e5-bf66-4e40-9090-61a0f923f68f,qwen1-14B,1721004046,1721004124,finished,1721004066,1721004124,A100-SXM4-80GB,8,1,64,896,20,58
b36e3d1b-1c1d-46f3-9ee2-e50a7b0f0a63,qwen1-14B,1721004200,1721004276,finished,1721004220,1721004276,A100-SXM4-80GB,8,1,64,896,20,56
a9458247-a565-4098-b34c-8d64d9c98360,qwen1-14B,1721004352,1721004448,finished,1721004372,1721004448,A100-SXM4-80GB,8,1,64,896,20,76
44a32118-9db6-4ecf-9306-14f1f8a724af,qwen1-14B,1721004525,1721004601,finished,1721004544,1721004601,A100-SXM4-80GB,8,1,64,896,19,57
36b4e2f4-9d6e-4737-8665-72858846f7f5,qwen1-14B,1721004678,1721004773,finished,1721004697,1721004773,A100-SXM4-80GB,8,1,64,896,19,76
6450f944-debe-46b9-88be-92c1b627231a,qwen1-14B,1721004850,1721004927,finished,1721004869,1721004927,A100-SXM4-80GB,8,1,64,896,19,58
8d3c5a0b-8cd2-47a4-a003-cd3cdbacd8fd,qwen1-14B,1721005005,1721005084,finished,1721005025,1721005084,A100-SXM4-80GB,8,1,64,896,20,59
2945df2d-6104-46d9-8af3-7c1c92069f26,qwen1-14B,1721005161,1721005237,finished,1721005180,1721005237,A100-SXM4-80GB,8,1,64,896,19,57
e284bae3-ec16-4548-a923-acb03c36fcb6,qwen1-14B,1721005314,1721005410,finished,1721005333,1721005410,A100-SXM4-80GB,8,1,64,896,19,77
c0899f40-4dd4-4d59-8a5d-b2519d127b21,llama-factory-long-sp-pt-test,1721005370,1721006086,finished,1721005390,1721006086,A100-SXM4-80GB,8,1,64,448,20,696
e3f9e79a-dc73-451e-a188-ad3464a75fc9,qwen1-14B,1721005486,1721005564,finished,1721005505,1721005564,A100-SXM4-80GB,8,1,64,896,19,59
58a58a04-d031-4314-851a-e8f2b20503d3,llama3-8b-sft81k-lora-copy,1721005622,1721007667,finished,1721006297,1721007667,A100-SXM4-80GB,8,4,64,448,675,1370
1ec959ad-4d0e-4cc0-b252-dbfd5d9268c9,qwen1-14B,1721005642,1721005721,finished,1721005662,1721005721,A100-SXM4-80GB,8,1,64,896,20,59
389b56ab-8e71-4bd4-a948-8a6e0395ad19,qwen1-14B,1721005799,1721005876,finished,1721005819,1721005876,A100-SXM4-80GB,8,1,64,896,20,57
8346d6eb-e7f7-47c3-814a-54d12fc90631,llama-multi,1721005877,1721006242,finished,1721005896,1721006242,A100-SXM4-80GB,8,1,64,448,19,346
2d8aa4b5-9bf2-4ded-b5c8-4aeb5a022ced,qwen1-14B,1721005954,1721006031,finished,1721005973,1721006031,A100-SXM4-80GB,8,1,64,896,19,58
27ce5aa5-bead-4a90-9216-39f11dd1dc53,llama-factory-long-sp-pt-test,1721006086,1721006240,finished,1721006106,1721006240,A100-SXM4-80GB,8,1,64,448,20,134
31349557-0a59-44de-a2f0-9dae69aee030,qwen1-14B,1721006107,1721006183,finished,1721006126,1721006183,A100-SXM4-80GB,8,1,64,896,19,57
0a8d7322-4050-4a8e-ad7e-0f9076f0227d,qwen1-14B,1721006241,1721006341,finished,1721006260,1721006341,A100-SXM4-80GB,8,1,64,896,19,81
30c30e11-9cbb-43a5-97d6-4c84bcd59ea4,llama-factory-zj-test,1721006259,1721007847,finished,1721006317,1721007847,A100-SXM4-80GB,8,8,64,896,58,1530
1a5328ae-23fc-4bba-95d3-36b526ec1a5c,llama-actsave,1721006321,1721006699,finished,1721006342,1721006699,A100-SXM4-80GB,8,1,64,448,21,357
a1063fe6-3d3e-4d67-98be-c3dcab411bb2,geo-mod-05b-test,1721006402,1721008303,finished,1721006422,1721008303,A100-SXM4-80GB,8,1,64,448,20,1881
fad88ff4-768d-428e-b75a-84775ea6f38f,qwen1-14B,1721006419,1721006503,finished,1721006439,1721006503,A100-SXM4-80GB,8,1,64,896,20,64
59e75952-2d6f-4e15-b6c9-fa475978cb78,geogpt-llama3-lp84-sft,1721006491,1721131700,finished,1721006548,1721131700,A100-SXM4-80GB,8,32,64,448,57,125152
23a29d5a-f1f2-40a6-892a-0a5da1ba5db3,qwen2-72b-instruct-lp84-6bgeo,1721006580,1721010265,finished,1721006621,1721010265,A100-SXM4-80GB,8,20,64,448,41,3644
93e6db23-b6d4-4b35-ad31-5fc1376dbb17,qwen1-14B,1721006594,1721006719,finished,1721006640,1721006719,A100-SXM4-80GB,8,1,64,896,46,79
b6ba0ba9-b190-4c9f-96bf-5fb8bfffc833,geogpt-finetuning-yxs,1721006769,1721029562,finished,1721029500,1721029562,A100-SXM4-80GB,8,1,64,896,22731,62
d06c48db-2046-4994-abef-882888261cee,qwen1-14B,1721006798,1721006876,finished,1721006817,1721006876,A100-SXM4-80GB,8,1,64,896,19,59
41ababd7-8ed4-4d17-8a0d-1ae985eeea07,train-0715,1721006814,1721034038,finished,1721006834,1721034038,A100-SXM4-80GB,8,1,64,896,20,27204
40467b51-1f7c-4a16-af5b-e9a49498bc45,llama3-70b-0714-dpo-b06d1-auto,1721006863,1721010326,finished,1721006883,1721010326,A100-SXM4-80GB,8,1,64,448,20,3443
d8255ddb-296c-4f35-a380-13a8147dfb34,qwen1-14B,1721006952,1721007030,finished,1721006972,1721007030,A100-SXM4-80GB,8,1,64,896,20,58
8c545885-3519-4f59-ac3c-f3fbaa5ddc83,llama3-70b-0714-dpo-8a081-auto,1721006979,1721024958,finished,1721006999,1721024958,A100-SXM4-80GB,8,1,64,448,20,17959
506c25e5-6d40-4627-9166-17f5d1854032,qwen1-14B,1721007105,1721007371,finished,1721007124,1721007371,A100-SXM4-80GB,8,1,64,896,19,247
5a55e9b3-d1c3-4686-8d48-fbbc0b6d8ae0,llama-actsave,1721007352,1721007868,finished,1721007372,1721007868,A100-SXM4-80GB,8,1,64,448,20,496
1c0b8794-b7ee-4151-9601-e4768e71f9cc,qwen1-14B,1721007449,1721007530,finished,1721007468,1721007530,A100-SXM4-80GB,8,1,64,896,19,62
c2cf88ad-f6ad-49d2-8438-36b994c7b1cf,reranker-inference11,1721007486,1721180568,finished,1721007507,1721180568,A100-SXM4-80GB,8,1,64,448,21,173061
9144b2a0-ff29-47d1-8492-66678e1ed3c7,reranker-inference,1721007505,1721180590,finished,1721007528,1721180590,A100-SXM4-80GB,8,1,64,448,23,173062
bbc93121-b3ae-4616-a429-ad56633e3148,reranker-base,1721007506,1721180590,finished,1721007528,1721180590,A100-SXM4-80GB,8,1,64,896,22,173062
ab950ff0-32ba-41f8-b8c0-0505cfc442c5,qwen1-14B,1721007609,1721007709,finished,1721007630,1721007709,A100-SXM4-80GB,8,1,64,896,21,79
b5823673-7f5d-46b9-b3fd-3c7414760da8,zxx-new,1721007648,1721008460,finished,1721007668,1721008460,A100-SXM4-80GB,8,1,64,896,20,792
115852c3-4973-4923-9528-7827e61361ae,llama3-8b-sft81k-lora-copy,1721007667,1721008083,finished,1721007707,1721008083,A100-SXM4-80GB,8,4,64,448,40,376
a42bbb19-ddd4-41ec-91d9-3f7e80d37727,gpt-megatron,1721007725,1721008141,finished,1721008081,1721008141,A100-SXM4-80GB,8,16,64,448,356,60
d6125499-d71f-4c22-a81a-1fa0e9925660,slimorca-mtm1-func-14b,1721007753,1721022508,finished,1721007773,1721022508,A100-SXM4-80GB,8,1,64,448,20,14735
b9bf6be2-12fd-4dc9-8e68-42d52eb8af7e,qwen1-14B,1721007788,1721007868,finished,1721007809,1721007868,A100-SXM4-80GB,8,1,64,896,21,59
e7ab41a7-3634-44de-97a9-2b6fc3f9946c,qwen1-14B,1721007946,1721008024,finished,1721007965,1721008024,A100-SXM4-80GB,8,1,64,896,19,59
d0bb105a-9439-4c8a-9816-36390a088d91,llama-actsave,1721008005,1721011898,finished,1721008025,1721011898,A100-SXM4-80GB,8,1,64,448,20,3873
3cb8d1fa-5b09-4399-acaa-05eaab6d9576,slimorca-mtm1-fucfilt-14b,1721008049,1721022508,finished,1721008069,1721022508,A100-SXM4-80GB,8,1,64,448,20,14439
04dc193f-a0f2-482c-99f8-ee7971009ec4,qwen1-14B,1721008105,1721008183,finished,1721008124,1721008183,A100-SXM4-80GB,8,1,64,896,19,59
bb11f175-c4b6-4e00-ae68-00b83f4a3290,qwen1-14B,1721008261,1721008340,finished,1721008281,1721008340,A100-SXM4-80GB,8,1,64,896,20,59
f2b81231-9224-4ba0-a17d-9d991811859e,zzb,1721008319,1721008459,finished,1721008360,1721008459,A100-SXM4-80GB,8,2,64,896,41,99
07ba1cae-89ae-4c5c-81bd-785cf5e9dc3f,tq-llm-chat-infer-1,1721008391,1721008722,finished,1721008410,1721008722,A100-SXM4-80GB,8,1,64,448,19,312
76f713e9-1bb2-4957-846d-2b59c709257c,qwen1-14B,1721008420,1721008501,finished,1721008441,1721008501,A100-SXM4-80GB,8,1,64,896,21,60
a9209390-7335-41d6-89d9-e30b7519045b,llama3-extra-infer,1721008459,1721008940,finished,1721008479,1721008940,A100-SXM4-80GB,8,1,64,448,20,461
bee96423-6492-4863-9259-d4468206a29f,qwen1-14B,1721008582,1721008686,finished,1721008602,1721008686,A100-SXM4-80GB,8,1,64,896,20,84
94d927c6-015d-462a-9e3c-935bc473ce06,sfr-embedding,1721008620,1721009667,finished,1721008641,1721009667,A100-SXM4-80GB,8,1,64,448,21,1026
6a47a4b7-41d4-48c0-80dd-b5433a94e25c,gpt-megatron,1721008639,1721011811,finished,1721008703,1721011811,A100-SXM4-80GB,8,16,64,448,64,3108
7f479a10-6537-455b-b0c0-c5c2a857af86,zxx-new,1721008642,1721009226,finished,1721008663,1721009226,A100-SXM4-80GB,8,1,64,896,21,563
cf42a985-75c1-464a-933f-1466d79c1792,DeepSeek-V2-Chat-shumo-7e45b-auto,1721008669,1721009353,finished,1721008690,1721009353,A100-SXM4-80GB,8,1,64,896,21,663
feddc86b-efeb-4b13-aa18-9d0541add122,tq-llm-chat-infer-1,1721008722,1721009400,finished,1721008748,1721009400,A100-SXM4-80GB,8,1,64,448,26,652
b3e3f9a5-3b37-4349-b51b-f1fe4ce4722b,zzb,1721008734,1721008983,finished,1721008758,1721008983,A100-SXM4-80GB,8,2,64,896,24,225
f0449eb1-ca8a-4a5b-acef-e9cad5f67e02,qwen1-14B,1721008779,1721009809,finished,1721008799,1721009809,A100-SXM4-80GB,8,1,64,896,20,1010
ad5b97c6-8fe3-4da5-b44b-251e10e030e7,zzb,1721008984,1721009786,finished,1721009085,1721009786,A100-SXM4-80GB,8,2,64,896,101,701
6c14cbba-4ca1-4529-b401-3fad6dc3de36,sql-spider-qy-llama,1721009108,1721009591,finished,1721009129,1721009591,A100-SXM4-80GB,8,1,64,896,21,462
b7661b20-c8a3-46f2-971f-f73f5e8764d8,sfr-embedding,1721009667,1721014139,finished,1721009688,1721014139,A100-SXM4-80GB,8,1,64,448,21,4451
4e9c2d00-7894-4486-ab68-0b1616129cc5,geo-sae-test,1721009673,1721011414,finished,1721009693,1721011414,A100-SXM4-80GB,8,1,64,896,20,1721
079d52c7-bd99-45cc-be9a-7d93301581b4,geogpt-tq-llm-sft-yxs,1721009798,1721013887,finished,1721013787,1721013887,A100-SXM4-80GB,8,1,64,896,3989,100
71ac8b11-8d98-4458-9aad-549828e50ff8,qwen1-14B,1721009888,1721009969,finished,1721009909,1721009969,A100-SXM4-80GB,8,1,64,896,21,60
436871ee-48cb-4e90-9c0c-bd8fe8a78ace,m8x22b-sft-test-91700-auto,1721009993,1721012926,finished,1721010013,1721012926,A100-SXM4-80GB,8,1,64,448,20,2913
7517539c-d40f-490a-a6e4-d2692dea3aed,qwen1-14B,1721010049,1721010498,finished,1721010069,1721010498,A100-SXM4-80GB,8,1,64,896,20,429
926c480d-305d-4c6b-a896-817168ddc2cd,m8x7b-sft-2ep-dpo-eb4f8-auto,1721010074,1721011117,finished,1721010095,1721011117,A100-SXM4-80GB,8,1,64,448,21,1022
92947731-1422-4264-a118-5e1147a5210a,zjllm-sci-llama-3-7b,1721010186,1721010513,finished,1721010206,1721010513,A100-SXM4-80GB,8,1,64,448,20,307
4d0b4e6a-1727-4820-a7e1-4e5cf2a9358d,qwen2-72b-instruct-lp84-6bgeo,1721010265,1721226533,finished,1721020985,1721226533,A100-SXM4-80GB,8,20,64,448,10720,205548
5302e6dd-a20a-4f09-a564-3ce28aebd24d,zjllm-sci-llama-3-7b,1721010514,1721010847,finished,1721010534,1721010847,A100-SXM4-80GB,8,1,64,448,20,313
d07ea5c1-c946-4625-b1a6-d358d48a0b0a,qwen1-14B,1721010579,1721010662,finished,1721010598,1721010662,A100-SXM4-80GB,8,1,64,896,19,64
98d67f76-b8b1-4f6e-a1a3-5a662b4b5001,zzb,1721010661,1721011389,finished,1721010724,1721011389,A100-SXM4-80GB,8,2,64,896,63,665
ca29dc78-da24-45e2-a43d-a6d80afc46e7,sparsity-10-18-dp-0612-bfc56-auto,1721010687,1721025643,finished,1721010709,1721025643,A100-SXM4-80GB,8,1,64,448,22,14934
7d2f320d-d162-4819-9106-186dc703f9b7,sparsity-0-18-dp-0612-97f3d-auto,1721010688,1721025323,finished,1721010709,1721025323,A100-SXM4-80GB,8,1,64,448,21,14614
fdd49d07-822b-4f06-bd8c-18852820ab29,qwen1-14B,1721010746,1721011014,finished,1721010768,1721011014,A100-SXM4-80GB,8,1,64,896,22,246
bde3002c-654a-4028-81b5-663984ff0b31,tq-llm-chat-infer-1,1721010798,1721116892,finished,1721010821,1721116892,A100-SXM4-80GB,4,1,32,448,23,106071
1dd17185-b9fd-45bb-a178-4fa0dfabc49b,sparsity-8-dp-0612-5928a-auto,1721010814,1721022296,finished,1721010835,1721022296,A100-SXM4-80GB,8,1,64,448,21,11461
b27e2c5f-f3e8-491a-986e-89f14c7a6e0a,zjllm-sci-llama-3-7b,1721010847,1721011405,finished,1721010869,1721011405,A100-SXM4-80GB,8,1,64,448,22,536
cdaeef8b-966f-4f57-b1e3-ed68fcc6e993,sparsity-9-dp-0612-b0129-auto,1721010857,1721022338,finished,1721010878,1721022338,A100-SXM4-80GB,8,1,64,448,21,11460
09c6f96e-6fa1-48bd-a594-06c1321c7ecb,sparsity-0-18-dp-0612-4c173-auto,1721010898,1721026956,finished,1721010918,1721026956,A100-SXM4-80GB,8,1,64,448,20,16038
10d02f7f-af11-4578-9571-90004c76d9a0,qwen1-14B,1721011092,1721011171,finished,1721011112,1721011171,A100-SXM4-80GB,8,1,64,896,20,59
f45a1737-cd03-4fc3-b09a-c9ebe6ee37ec,DeepSeek-V2-Chat-shumo-7e45b-auto,1721011176,1721012211,finished,1721011196,1721012211,A100-SXM4-80GB,8,1,64,896,20,1015
70e4ffd4-2fb6-4d9e-a7d8-1e803b89bb89,qwen1-14B,1721011251,1721011331,finished,1721011271,1721011331,A100-SXM4-80GB,8,1,64,896,20,60
a10eda0b-9eaa-46b7-a5da-63fe42be4cf9,sql-spider-qy-llama,1721011254,1721011920,finished,1721011274,1721011920,A100-SXM4-80GB,8,1,64,896,20,646
67f55ba7-ef75-4c65-b112-d8ec65647555,zjllm-sci-llama-3-7b,1721011405,1721012082,finished,1721011426,1721012082,A100-SXM4-80GB,8,1,64,448,21,656
b3b5ce42-3afe-4a3c-b4c6-738f30506ec1,qwen1-14B,1721011411,1721011490,finished,1721011431,1721011490,A100-SXM4-80GB,8,1,64,896,20,59
316fa61c-5a29-4ce8-b312-035adcc1f2c8,sparsity-10-18-dp-0612-943d3-auto,1721011474,1721012071,finished,1721011496,1721012071,A100-SXM4-80GB,8,1,64,448,22,575
a69f88a8-0605-4172-acec-bf50443e170d,zzb,1721011531,1721012004,finished,1721011570,1721012004,A100-SXM4-80GB,8,2,64,896,39,434
af99a325-446c-42a7-8669-da4388fc841d,qwen1-14B,1721011572,1721011652,finished,1721011594,1721011652,A100-SXM4-80GB,8,1,64,896,22,58
2c34ecbb-fc2d-4390-93ef-84d5ed4c6cd9,llama3-8b-sft81k-lora-qkvo,1721011612,1721269188,finished,1721011671,1721269188,A100-SXM4-80GB,8,4,64,448,59,257517
4aff5ae6-c838-4d9c-943f-c04b4ceb361b,qwen1-14B,1721011734,1721011814,finished,1721011753,1721011814,A100-SXM4-80GB,8,1,64,896,19,61
55bd0a48-3b1a-4560-b1c8-1ff5ce454774,gpt-megatron,1721011893,1721028228,finished,1721011955,1721028228,A100-SXM4-80GB,8,16,64,448,62,16273
1d34c16e-0081-431a-9a8b-e9742d7744cb,qwen1-14B,1721011897,1721011984,finished,1721011918,1721011984,A100-SXM4-80GB,8,1,64,896,21,66
1c6ac4a3-0353-4251-a916-095f551af6f6,sql-spider-qy-llama,1721011920,1721012819,finished,1721011941,1721012819,A100-SXM4-80GB,8,1,64,896,21,878
4156b855-a94e-48c4-876d-fcf7ad307d13,llama-actsave,1721011939,1721012308,finished,1721011964,1721012308,A100-SXM4-80GB,8,1,64,448,25,344
a7cf8260-d639-4c5a-af7d-abdf0fa5bfe0,qwen1-14B,1721012067,1721012148,finished,1721012087,1721012148,A100-SXM4-80GB,8,1,64,896,20,61
9207353d-42e3-47c5-80e5-80fab81d653d,zjllm-sci-llama-3-7b,1721012082,1721021790,finished,1721012102,1721021790,A100-SXM4-80GB,8,1,64,448,20,9688
53a06eb2-dbb3-4497-9e11-5af1c49b046c,geogpt-72b-0206,1721012117,1721016545,finished,1721012139,1721016545,A100-SXM4-80GB,4,1,32,448,22,4406
bd87a216-163c-4b52-a0ef-b841adbd2004,qwen1-14B,1721012227,1721012307,finished,1721012247,1721012307,A100-SXM4-80GB,8,1,64,896,20,60
86f52874-8b82-4aa7-8e43-8df0f55a4cce,llama-actsave,1721012367,1721023378,finished,1721012388,1721023378,A100-SXM4-80GB,8,1,64,448,21,10990
f98b1adc-6087-4f71-ab0f-69fddf790d7f,qwen1-14B,1721012387,1721012466,finished,1721012407,1721012466,A100-SXM4-80GB,8,1,64,896,20,59
a5c344d7-cba0-44dc-9c9f-b88e61530c1c,qwen1-14B,1721012546,1721012625,finished,1721012565,1721012625,A100-SXM4-80GB,8,1,64,896,19,60
291f1c0b-6fb6-4d62-bd6e-64ce92903b2f,qwen1-14B,1721012715,1721012796,finished,1721012734,1721012796,A100-SXM4-80GB,8,1,64,896,19,62
6e9bda17-24f2-4601-988b-52d2cd95e645,geogpt-7b-lp40-chat-s2-gate-2b,1721012782,1721012974,finished,1721012826,1721012974,A100-SXM4-80GB,8,2,64,448,44,148
9de2cbd5-d227-42bf-b081-29b9d828f201,sparsity-10-18-dp-0612-0976b-auto,1721012822,1721028993,finished,1721012843,1721028993,A100-SXM4-80GB,8,1,64,448,21,16150
b9020e8e-41ab-49e6-baff-ce1fbb8e7d30,qwen1-14B,1721012880,1721012964,finished,1721012900,1721012964,A100-SXM4-80GB,8,1,64,896,20,64
43c9a2cc-49cd-40ec-8599-983bb1b56cb8,zjllm-sci-llama-3-7b-infer,1721012895,1721013627,finished,1721012916,1721013627,A100-SXM4-80GB,8,1,64,448,21,711
edf5e53e-ab2e-478c-b11b-6d7f2a6548cc,m8x22b-sft-test-12250-auto,1721012970,1721028490,finished,1721012991,1721028490,A100-SXM4-80GB,8,1,64,448,21,15499
48166852-3ead-4ca6-afbc-b9834c185c9b,zzb,1721012985,1721013367,finished,1721013046,1721013367,A100-SXM4-80GB,8,2,64,896,61,321
77d5707f-baec-4722-a797-0a87852668b7,qwen1-14B,1721013048,1721013129,finished,1721013068,1721013129,A100-SXM4-80GB,8,1,64,896,20,61
08bc0c2b-def6-491c-a853-187d6d0eb2f4,geogpt-ultrafuser-direct-eval,1721013092,1721015299,finished,1721013113,1721015299,A100-SXM4-80GB,8,1,64,448,21,2186
6953372f-032a-4fd0-b952-8f92af521335,qwen1-14B,1721013208,1721013287,finished,1721013228,1721013287,A100-SXM4-80GB,8,1,64,896,20,59
f458b7ab-9989-412e-af48-f76be1cb48bc,qwen1-14B,1721013369,1721013449,finished,1721013389,1721013449,A100-SXM4-80GB,8,1,64,896,20,60
5c700d4e-aa37-41c9-b180-e81c7c8076c1,sql-spider-qy-llama,1721013371,1721013554,finished,1721013391,1721013554,A100-SXM4-80GB,8,1,64,896,20,163
c763e9dd-c773-43e6-a6e1-f0f20b2b4eb8,zzb,1721013448,1721018079,finished,1721013511,1721018079,A100-SXM4-80GB,8,2,64,896,63,4568
19f9515b-d5bf-44c9-ad35-26cd55929ca1,zxx-new,1721013470,1721014798,finished,1721013490,1721014798,A100-SXM4-80GB,8,1,64,896,20,1308
c9f33c4d-d58c-4db2-aded-e7d1f4c61f34,qwen1-14B,1721013532,1721013612,finished,1721013552,1721013612,A100-SXM4-80GB,8,1,64,896,20,60
f921ae72-206f-4037-85a8-465dcd98846c,zjllm-sci-llama-3-7b-infer,1721013627,1721030491,finished,1721013648,1721030491,A100-SXM4-80GB,8,1,64,448,21,16843
a573c63c-dff0-4f55-818d-c51a2b2131fd,qwen1-14B,1721013694,1721013776,finished,1721013714,1721013776,A100-SXM4-80GB,8,1,64,896,20,62
5418a4a7-95b6-4e85-b89c-3b087c1da91e,qwen1-14B,1721013856,1721013938,finished,1721013876,1721013938,A100-SXM4-80GB,8,1,64,896,20,62
7efe51f6-cf99-4d8a-89bd-c4a81c8df49f,qwen1-14B,1721014018,1721014121,finished,1721014038,1721014121,A100-SXM4-80GB,8,1,64,896,20,83
f1d6ea37-5caa-4ac4-803c-898479355941,sfr-embedding,1721014139,1721821721,finished,1721014161,1721821721,A100-SXM4-80GB,8,1,64,448,22,807560
02ad940e-5f3a-4048-ac92-b99d6c015704,qwen1-14B,1721014204,1721014287,finished,1721014224,1721014287,A100-SXM4-80GB,8,1,64,896,20,63
b4c540ce-9b18-4b1e-aca8-5feb59d7866f,sql-spider-qy-llama,1721014227,1721015168,finished,1721014247,1721015168,A100-SXM4-80GB,8,1,64,896,20,921
720dd4bc-e22b-45ba-bcd0-951d1f372b32,geogpt-7b-lp40-chat-s2-gate-2b,1721014295,1721101288,finished,1721016194,1721101288,A100-SXM4-80GB,8,2,64,448,1899,85094
669e50af-ba37-41c4-a30a-ee5f1929cbd3,qwen1-14B,1721014370,1721014452,finished,1721014391,1721014452,A100-SXM4-80GB,8,1,64,896,21,61
4450f147-831b-4f91-8370-684956a26f72,qwen1-14B,1721014533,1721014612,finished,1721014553,1721014612,A100-SXM4-80GB,8,1,64,896,20,59
260b95d8-b2d9-48d6-b93a-edde01093133,qwen1-14B,1721014692,1721014779,finished,1721014712,1721014779,A100-SXM4-80GB,8,1,64,896,20,67
316354ba-5961-4c41-84f2-4570f0a93651,run-reward-model,1721014720,1721015067,finished,1721014740,1721015067,A100-SXM4-80GB,8,1,64,448,20,327
e7a34f82-01f9-4982-961a-cc25204ea2be,llama3-extra-infer,1721014775,1721015604,finished,1721014797,1721015604,A100-SXM4-80GB,8,1,64,448,22,807
91b945e3-f0d1-493b-a07f-196f72194c9d,zxx-new,1721014798,1721015975,finished,1721014840,1721015975,A100-SXM4-80GB,8,4,64,896,42,1135
7a7dc687-a47d-47c2-b281-15e668785d84,qwen1-14B,1721014862,1721014943,finished,1721014882,1721014943,A100-SXM4-80GB,8,1,64,896,20,61
7d3e0abc-a766-4991-a096-2eeb69b47f24,qwen1-14B,1721015024,1721015104,finished,1721015043,1721015104,A100-SXM4-80GB,8,1,64,896,19,61
68949628-3a00-40c9-b2ed-5f827526feee,qwen1-14B,1721015188,1721015275,finished,1721015209,1721015275,A100-SXM4-80GB,8,1,64,896,21,66
4e81c06c-7c7a-4800-9154-8f93ec0f752b,sparsity-q72b-0612-dp-ties-w55-40d03-auto,1721015235,1721030079,finished,1721015258,1721030079,A100-SXM4-80GB,8,1,64,448,23,14821
6c4d5c0b-b906-4ac5-9adc-807842876763,geogpt-cot-eval-cp-r1,1721015303,1721015901,finished,1721015325,1721015901,A100-SXM4-80GB,8,1,64,896,22,576
1771f3f1-048f-4d4a-974c-1b981983ee4d,qwen1-14B,1721015358,1721015440,finished,1721015378,1721015440,A100-SXM4-80GB,8,1,64,896,20,62
5abf25c5-82ef-4168-82a2-580d0a77f32d,run-reward-model,1721015362,1721015731,finished,1721015384,1721015731,A100-SXM4-80GB,8,1,64,448,22,347
8990ae62-89cd-49c9-86f3-efdb286bc7a1,qwen1-14B,1721015522,1721015606,finished,1721015544,1721015606,A100-SXM4-80GB,8,1,64,896,22,62
1761acff-a0a8-452b-98e1-75becd28e164,llama3-extra-infer,1721015604,1721021857,finished,1721015625,1721021857,A100-SXM4-80GB,8,1,64,448,21,6232
5ea107a6-2d43-4767-b2e7-510144d379ef,qwen1-14B,1721015686,1721015767,finished,1721015706,1721015767,A100-SXM4-80GB,8,1,64,896,20,61
25d21be9-7aad-4ccf-922a-e895559e00f4,qwen1-14B,1721015849,1721015934,finished,1721015869,1721015934,A100-SXM4-80GB,8,1,64,896,20,65
6db535da-2fef-44de-a189-2d80329aee6b,run-reward-model,1721015918,1721016128,finished,1721015938,1721016128,A100-SXM4-80GB,8,1,64,448,20,190
6a12afa8-23db-4e2f-bea9-70d721afe235,qwen1-14B,1721016020,1721016102,finished,1721016041,1721016102,A100-SXM4-80GB,8,1,64,896,21,61
3f44b3e7-afe8-4071-b46c-ae59ff48b198,marker-xiaodian,1721016118,1721103598,finished,1721016140,1721103598,A100-SXM4-80GB,8,1,64,896,22,87458
e3af6044-5a20-4b55-90d5-afca3cfacc48,qwen1-14B,1721016186,1721021026,finished,1721020942,1721021026,A100-SXM4-80GB,8,1,64,896,4756,84
54f089a1-ed5c-4c43-bf63-ce22d50f908a,zxx-new,1721016430,1721016921,finished,1721016451,1721016921,A100-SXM4-80GB,8,1,64,896,21,470
2b5fa627-7a82-4e2e-a215-4c80759cff0f,geogpt-72b-0206,1721016607,1721103631,finished,1721016628,1721103631,A100-SXM4-80GB,4,1,32,448,21,87003
c9fb6a7d-c925-4bcc-831e-32c5ced2fbd4,zxx-new,1721016921,1721019766,finished,1721016941,1721019766,A100-SXM4-80GB,8,1,64,896,20,2825
54ee3224-270e-4223-9066-0a6e8370b666,install2,1721019659,1721021854,finished,1721019681,1721021854,A100-SXM4-80GB,8,1,64,896,22,2173
3ccc04da-83ef-4179-97f1-bf9b2f639ef5,zxx-new,1721019766,1721020638,finished,1721019786,1721020638,A100-SXM4-80GB,8,1,64,896,20,852
f1f61eb0-b3f6-465a-989b-9523918f8229,ori-load-save,1721020091,1721021628,finished,1721020133,1721021628,A100-SXM4-80GB,8,2,64,896,42,1495
803aecbc-236a-4daa-9f2c-909c8d030805,zxx-new,1721020638,1721022860,finished,1721020658,1721022860,A100-SXM4-80GB,8,1,64,896,20,2202
00037157-4024-4394-b762-380ac086ef8b,qwen1-14B,1721021108,1721021189,finished,1721021128,1721021189,A100-SXM4-80GB,8,1,64,896,20,61
c673bd8b-188b-4603-b7a2-31a1b25a5e60,qwen1-14B,1721021272,1721021357,finished,1721021292,1721021357,A100-SXM4-80GB,8,1,64,896,20,65
34d1479d-9ffe-460d-b3ca-68737e131342,citysora-modelv4-cele-ppm-65-512-from-200k256,1721021318,1721022401,finished,1721021360,1721022401,A100-SXM4-80GB,8,4,64,896,42,1041
2c4364de-7ab2-4a6d-bdf8-4986f863b902,qwen1-14B,1721021443,1721021527,finished,1721021464,1721021527,A100-SXM4-80GB,8,1,64,896,21,63
7f521d84-9c3d-4fe6-91e5-d03628b43846,geo-mod-05b-test,1721021446,1721024744,finished,1721021509,1721024744,A100-SXM4-80GB,8,4,64,448,63,3235
68b91d12-56cb-4b49-aacf-28f1faebe835,qwen1-14B,1721021608,1721021689,finished,1721021629,1721021689,A100-SXM4-80GB,8,1,64,896,21,60
90e9eaea-7beb-4336-b314-0c0d5e93f813,lf-llama3-8b-ins-sft-dyn-test,1721021751,1721022438,finished,1721021794,1721022438,A100-SXM4-80GB,8,2,64,448,43,644
2718c0a2-ec39-4001-92b3-d01e992cdcff,qwen1-14B,1721021753,1721021838,finished,1721021774,1721021838,A100-SXM4-80GB,8,1,64,896,21,64
dc8a01f2-822c-4140-8e11-81397198707b,zjllm-sci-llama-3-7b,1721021791,1721022757,finished,1721021811,1721022757,A100-SXM4-80GB,8,1,64,448,20,946
1b1bb034-da95-49fd-9b31-dc126bd29ff6,install2,1721021854,1721103558,finished,1721021875,1721103558,A100-SXM4-80GB,8,1,64,896,21,81683
7dd65f95-9668-408e-b760-2fd20a4f7b17,qwen1-14B,1721021921,1721022005,finished,1721021942,1721022005,A100-SXM4-80GB,8,1,64,896,21,63
22c7650c-e2a0-45af-a9ee-34800a74ea31,qwen1-14B,1721022087,1721022170,finished,1721022108,1721022170,A100-SXM4-80GB,8,1,64,896,21,62
d69307ff-e79e-4ba5-9604-f8d0b0daca33,qwen1-14B,1721022251,1721022333,finished,1721022271,1721022333,A100-SXM4-80GB,8,1,64,896,20,62
4bbff5dc-2fa3-4b1b-8beb-834e09c2bb77,llama3-extra-infer,1721022331,1721026211,finished,1721022354,1721026211,A100-SXM4-80GB,8,1,64,448,23,3857
5a55e589-5cb4-41e3-9d56-d5747a8731b7,citysora-modelv4-cele-ppm-65-512-from-200k256,1721022401,1721026170,finished,1721022464,1721026170,A100-SXM4-80GB,8,4,64,896,63,3706
ef1c7838-6b77-4ea1-9168-54d145a8f119,qwen1-14B,1721022420,1721022504,finished,1721022440,1721022504,A100-SXM4-80GB,8,1,64,896,20,64
1665625b-3ded-4bb4-99bd-83132f0132a9,slimorca-mtm1-fucfilt-14b,1721022568,1721109594,finished,1721022589,1721109594,A100-SXM4-80GB,8,1,64,448,21,87005
99a78133-6f50-479b-a598-a76bc38ac0ea,slimorca-mtm1-func-14b,1721022568,1721109573,finished,1721022589,1721109573,A100-SXM4-80GB,8,1,64,448,21,86984
6a887c3c-1250-48ae-b0f1-ac6ea732b07c,qwen1-14B,1721022584,1721022663,finished,1721022604,1721022663,A100-SXM4-80GB,8,1,64,896,20,59
062c7a59-248b-4d21-8cb9-33f4d88b26ce,qwen1-14B,1721022741,1721022821,finished,1721022763,1721022821,A100-SXM4-80GB,8,1,64,896,22,58
96deeabb-ab9f-4cbb-aebd-c7d0f0ae558b,zjllm-sci-llama-3-7b,1721022757,1721026315,finished,1721022777,1721026315,A100-SXM4-80GB,8,1,64,448,20,3538
d2394eea-fdea-49ab-b363-d8114af0f421,zxx-new,1721022860,1721236652,finished,1721022880,1721236652,A100-SXM4-80GB,8,1,64,896,20,213772
4533e787-18e2-474b-bb9f-8199c6a20412,qwen1-14B,1721022901,1721022981,finished,1721022920,1721022981,A100-SXM4-80GB,8,1,64,896,19,61
ec7bcfec-47c4-46a3-8aa9-928a26ec7a17,flash-load-save,1721022979,1721023184,finished,1721023040,1721023184,A100-SXM4-80GB,8,2,64,896,61,144
9b82d7f2-940f-4207-9994-fb58e0a04c0e,qwen1-14B,1721023062,1721023143,finished,1721023082,1721023143,A100-SXM4-80GB,8,1,64,896,20,61
176ddedd-8a13-4ed4-b213-cd4d9673e765,flash-load-save,1721023184,1721023458,finished,1721023252,1721023458,A100-SXM4-80GB,8,2,64,896,68,206
996e255b-7da5-482a-8cd8-caf8c2c29d55,GeoGPT-0701-CPT-9b611-auto,1721023194,1721063147,finished,1721023219,1721063147,A100-SXM4-80GB,8,1,64,448,25,39928
9be9bf59-4ec0-47ad-ab12-ade394cff590,citysora-modelv4-cele-ppm-cosmic-256-fp,1721023212,1721023401,finished,1721023338,1721023401,A100-SXM4-80GB,8,4,64,896,126,63
7542e65d-f743-49f6-8334-2120166a2035,qwen1-14B,1721023233,1721023314,finished,1721023254,1721023314,A100-SXM4-80GB,8,1,64,896,21,60
cc66c9cc-3bc8-4422-a5e6-152406e8534a,qwen1-14B,1721023398,1721023481,finished,1721023419,1721023481,A100-SXM4-80GB,8,1,64,896,21,62
2d4119dc-4dfd-4783-a55b-4cf694c5662b,citysora-modelv4-cele-ppm-cosmic-256-fp,1721023401,1721026846,finished,1721023462,1721026846,A100-SXM4-80GB,8,4,64,896,61,3384
eb1fe78d-67e8-413a-8a05-105e9a904601,qwen1-14B,1721023560,1721023639,finished,1721023580,1721023639,A100-SXM4-80GB,8,1,64,896,20,59
799e4619-4988-420d-a506-aba036f694a7,qwen1-14B,1721023720,1721023801,finished,1721023740,1721023801,A100-SXM4-80GB,8,1,64,896,20,61
bb9d2a2a-98b3-4b73-960a-510cf18433dc,sp-q72b-0612-dp-linear-w55-b3900-auto,1721023745,1721034979,finished,1721023766,1721034979,A100-SXM4-80GB,8,1,64,448,21,11213
4f00b81b-6bbc-493d-bb03-2d608f4bca37,sp-q72b-0612-dp-ties-w55-bb68d-auto,1721023850,1721027361,finished,1721023871,1721027361,A100-SXM4-80GB,8,1,64,448,21,3490
5d22607f-849a-4a45-956e-120fd87a6aca,qwen1-14B,1721023886,1721023967,finished,1721023906,1721023967,A100-SXM4-80GB,8,1,64,896,20,61
78a642c3-5b79-46de-9d5a-05e41df94fe5,qwen1-14B,1721024047,1721024134,finished,1721024068,1721024134,A100-SXM4-80GB,8,1,64,896,21,66
6c8993ff-2a28-4daa-92c1-a5142816ab62,qwen1-14B,1721024215,1721024277,finished,1721024236,1721024277,A100-SXM4-80GB,8,1,64,896,21,41
24e026df-f4eb-4c47-a78a-3c2b2ac81404,qwen1-14B,1721024360,1721024443,finished,1721024381,1721024443,A100-SXM4-80GB,8,1,64,896,21,62
a51fef16-1c09-45a3-8f74-b93bcabf7323,flash-load-save,1721024441,1721024969,finished,1721024504,1721024969,A100-SXM4-80GB,8,2,64,896,63,465
7a2f166a-9fe3-4e79-a5cd-3f1d7fe16b04,qwen1-14B,1721024527,1721024611,finished,1721024547,1721024611,A100-SXM4-80GB,8,1,64,896,20,64
248eb0b0-7a74-41f9-bcd2-afe9b91ecfc1,qwen1-14B,1721024696,1721024782,finished,1721024718,1721024782,A100-SXM4-80GB,8,1,64,896,22,64
b180ee80-85bc-4264-a8e3-b46db8e4fc97,sfr-ft-2,1721024802,1721025509,finished,1721024823,1721025509,A100-SXM4-80GB,8,1,64,448,21,686
dcb441ff-b6b4-40de-a501-e7d50de24c77,qwen1-14B,1721024866,1721024950,finished,1721024887,1721024950,A100-SXM4-80GB,8,1,64,896,21,63
7d4ed166-7720-4aa4-bf52-b4e86b6a5870,llama-actsave,1721024929,1721031021,finished,1721024951,1721031021,A100-SXM4-80GB,8,1,64,448,22,6070
d0bf6374-0908-4d67-a564-a8c8687bece5,geo-mod-05b-test,1721025015,1721026430,finished,1721025082,1721026430,A100-SXM4-80GB,8,4,64,448,67,1348
348af9bc-3ed3-4e0c-9999-568926a65c15,qwen1-14B,1721025034,1721025122,finished,1721025057,1721025122,A100-SXM4-80GB,8,1,64,896,23,65
2f2b3f36-7f66-4d46-9f58-2ff4e6882c4e,flash-load-save,1721025055,1721025188,finished,1721025120,1721025188,A100-SXM4-80GB,8,2,64,896,65,68
cffbfa2c-ffbe-4d95-a3d6-a0c1450fd279,geogpt-prompt-tuning-tg-infer3,1721025133,1721032167,finished,1721029582,1721032167,A100-SXM4-80GB,8,1,64,448,4449,2585
858b42f2-4c2c-4289-8399-7a2390b828a7,slimorca-cleaned-geo-14b,1721025170,1721112202,finished,1721025194,1721112202,A100-SXM4-80GB,8,1,64,896,24,87008
83a3a17f-3c7d-434c-a91e-f490a6432ea5,qwen1-14B,1721025210,1721025298,finished,1721025230,1721025298,A100-SXM4-80GB,8,1,64,896,20,68
a2679d67-6068-437c-9aa3-1f9a45cd4073,geogpt-moe-0-5B-tag-1-fire-attn-norm-detach,1721025255,1721111534,finished,1721079119,1721111534,A100-SXM4-80GB,8,2,64,896,53864,32415
2e9e9342-42dd-4dd4-8bcc-831fed8a67bb,opencompass-eval-0715,1721025294,1721025844,finished,1721025316,1721025844,A100-SXM4-80GB,8,1,64,896,22,528
b6ca270c-a5c6-4bb6-95a9-34963cb0998a,flash-load-save,1721025296,1721025509,finished,1721025362,1721025509,A100-SXM4-80GB,8,2,64,896,66,147
8fe16515-5dc5-4c73-a8e5-fa9f69d7f16b,tulu-v2-plus-mt-subset-14b,1721025345,1721112366,finished,1721025367,1721112366,A100-SXM4-80GB,8,1,64,896,22,86999
16055e35-064e-4af0-86c4-f95212e9cc35,qwen1-14B,1721025384,1721025468,finished,1721025404,1721025468,A100-SXM4-80GB,8,1,64,896,20,64
96996af1-d9ae-499b-b05b-7537a51b4741,geogpt-moe-1b5-tag-1-freeze-attn-norm-detach,1721025449,1721083690,finished,1721026495,1721083690,A100-SXM4-80GB,8,2,64,896,1046,57195
ad1abe97-06ee-4b86-ac80-64fe450d31ae,geogpt-moe-1b5-tag-1-fire-attn-norm-detach,1721025492,1721142107,finished,1721083749,1721142107,A100-SXM4-80GB,8,2,64,896,58257,58358
f5dc2bd3-e0e6-4a2d-b909-1f8da5fb55da,llama3-8b-instruct-gradient-b5e5f-auto,1721025549,1721034753,finished,1721025571,1721034753,A100-SXM4-80GB,8,1,64,896,22,9182
dba83f8a-9dc1-4165-8b89-5631d1d370e2,qwen1-14B,1721025552,1721025639,finished,1721025574,1721025639,A100-SXM4-80GB,8,1,64,896,22,65
f3d01c35-9d1c-4d7f-bc92-675265895b69,geo-cpt-qwen2-7b-freezeEmbed-lr5e-5,1721025598,1721105635,finished,1721105359,1721105635,A100-SXM4-80GB,8,2,64,896,79761,276
af94f446-8655-4cc7-b5b7-dca0059e9e4a,qwen1-14B,1721025721,1721025805,finished,1721025741,1721025805,A100-SXM4-80GB,8,1,64,896,20,64
fc568e66-0776-4ffa-9985-90da81a59234,sql-spider-qy-llama,1721025743,1721025913,finished,1721025765,1721025913,A100-SXM4-80GB,8,1,64,896,22,148
8d37cd46-35dd-4993-9b9b-8a0028b01211,opencompass-eval-0715,1721025844,1721033709,finished,1721025867,1721033709,A100-SXM4-80GB,8,1,64,896,23,7842
6cffd1e5-e286-4cc9-b09d-36235b647e79,flash-load-save,1721025846,1721026034,finished,1721025889,1721026034,A100-SXM4-80GB,8,2,64,896,43,145
f4055c05-a0b7-4442-8b6e-7c4d4c5a1633,qwen1-14B,1721025870,1721025951,finished,1721025890,1721025951,A100-SXM4-80GB,8,1,64,896,20,61
a45be6e7-e421-454c-884f-c796debc8a10,qwen1-14B,1721026036,1721026124,finished,1721026057,1721026124,A100-SXM4-80GB,8,1,64,896,21,67
ac4814e6-5206-4b74-80c9-e78593893a20,sql-spider-qy-llama,1721026038,1721029155,finished,1721026059,1721029155,A100-SXM4-80GB,8,1,64,896,21,3096
6f8cb914-9d6c-43d1-8756-5dca4efdedac,geo-cpt-qwen1-5-13b-freezeEmbed-lr5e-5,1721026061,1721026823,finished,1721026495,1721026823,A100-SXM4-80GB,8,2,64,896,434,328
97e3d3fc-c011-492b-a573-95adad65d372,geogpt-eval-common-latest,1721026085,1721103703,finished,1721026108,1721103703,A100-SXM4-80GB,8,1,64,896,23,77595
c4e5cf88-0d8b-469f-be77-63bacf78ab88,citysora-modelv4-cele-ppm-65-512-from-200k256,1721026170,1721026691,finished,1721026215,1721026691,A100-SXM4-80GB,8,4,64,896,45,476
b6e16af2-cf4c-4b86-bd8c-53dadbaeea80,llama3-extra-infer,1721026211,1721031633,finished,1721026232,1721031633,A100-SXM4-80GB,8,1,64,448,21,5401
4fecd792-9645-47ec-9fdf-3df27b7851bf,qwen1-14B,1721026212,1721026321,finished,1721026234,1721026321,A100-SXM4-80GB,8,1,64,896,22,87
9552f3c9-61ee-48b8-913b-c4dc95df1552,llm-train,1721026299,1721026600,finished,1721026321,1721026600,A100-SXM4-80GB,8,1,64,896,22,279
dfc3b210-d154-43e5-b4d7-94833e889b2a,zjllm-sci-llama-3-7b,1721026315,1721027911,finished,1721026337,1721027911,A100-SXM4-80GB,8,1,64,448,22,1574
1ed25805-3df8-4404-9710-bfc1e9866a63,flash-load-save,1721026319,1721026575,finished,1721026384,1721026575,A100-SXM4-80GB,8,2,64,896,65,191
572212c3-f171-4dad-83ce-361624445dab,qwen1-14B,1721026407,1721026491,finished,1721026427,1721026491,A100-SXM4-80GB,8,1,64,896,20,64
6645b7ac-8a8e-4297-8ee3-0faacc977189,sfr-ft-2,1721026489,1721027142,finished,1721026512,1721027142,A100-SXM4-80GB,8,1,64,448,23,630
77985d23-6352-45a1-ba4f-d66f31fae642,qwen-0-5b,1721026494,1721027107,finished,1721026846,1721027107,A100-SXM4-80GB,1,1,8,112,352,261
4a3f9b66-a8be-4b2d-9199-6ce552ca7d1d,qwen1-14B,1721026577,1721026666,finished,1721026600,1721026666,A100-SXM4-80GB,8,1,64,896,23,66
74ee4b7a-818c-433e-8757-b8178b804bb6,citysora-modelv4-cele-ppm-65-512-from-200k256,1721026691,1721036504,finished,1721026755,1721036504,A100-SXM4-80GB,8,4,64,896,64,9749
b8accb48-bcfb-4d09-b025-56a26d774ab5,qwen1-14B,1721026752,1721026842,finished,1721026775,1721026842,A100-SXM4-80GB,8,1,64,896,23,67
1bb1a16d-68eb-4efe-991f-5de917d6816d,qw7b-tcpt-lr-2e5-hw-2stage-30w-0632e-auto,1721026787,1721027883,finished,1721026854,1721027883,A100-SXM4-80GB,8,1,64,448,67,1029
facb4c84-3b15-4c4a-832b-56959580e066,flash-load-save,1721026796,1721027526,finished,1721026864,1721027526,A100-SXM4-80GB,8,2,64,896,68,662
7857ff7a-6b19-4722-a79b-5f035ccd00b5,citysora-modelv4-cele-ppm-cosmic-256-fp,1721026846,1721034781,finished,1721026911,1721034781,A100-SXM4-80GB,8,4,64,896,65,7870
a59621da-3adf-4d06-91d2-55821a06326e,qw7b-tcpt-lr-8e5-hw-2stage-30w-98130-auto,1721026854,1721045258,finished,1721044232,1721045258,A100-SXM4-80GB,8,1,64,448,17378,1026
7f5a4107-027f-4261-8fd8-823eaa18a796,qwen1-14B,1721026930,1721027015,finished,1721026952,1721027015,A100-SXM4-80GB,8,1,64,896,22,63
26e3d75e-9037-4552-acbe-24543eb6a1b6,qw7b-tcpt-lr-2e5-hw-sft-30w-e1-69d30-auto,1721027027,1721028153,finished,1721027134,1721028153,A100-SXM4-80GB,8,1,64,448,107,1019
963333bc-c605-4663-a806-9aff04e9df63,qw7b-tcpt-lr-8e5-hw-sft-30w-e1-e6232-auto,1721027029,1721044211,finished,1721043244,1721044211,A100-SXM4-80GB,8,1,64,448,16215,967
28b65518-0fe6-490d-9f41-96fa08f3d402,qwen1-14B,1721027104,1721027185,finished,1721027124,1721027185,A100-SXM4-80GB,8,1,64,896,20,61
864ed23b-eaef-4127-804d-85473da63a05,geo-sae-test,1721027232,1721029513,finished,1721027898,1721029513,A100-SXM4-80GB,8,1,64,896,666,1615
aff9e3ba-0952-414e-a530-2c23c497d6ea,qwen1-14B,1721027272,1721027356,finished,1721027293,1721027356,A100-SXM4-80GB,8,1,64,896,21,63
a0450d2a-f8ca-4b7c-a38b-ba621eead804,geogpt-qwen15-moe-alpaca-sft,1721027289,1721027415,finished,1721027310,1721027415,A100-SXM4-80GB,8,1,64,896,21,105
54918736-033d-46ef-8ad9-9b6274605dfe,llm-train,1721027420,1721027593,finished,1721027443,1721027593,A100-SXM4-80GB,8,1,64,896,23,150
de10ac89-a3b6-4898-b867-f93c12beba82,geogpt-ultrafuser-direct-eval,1721027424,1721043091,finished,1721027446,1721043091,A100-SXM4-80GB,8,1,64,448,22,15645
051710ad-e153-4e64-9191-517245d5c9c8,qwen1-14B,1721027442,1721027528,finished,1721027463,1721027528,A100-SXM4-80GB,8,1,64,896,21,65
9b4c1955-40de-4b47-b817-4ef9c63bb1b8,qwen2-72b-chat-2,1721027475,1721821349,finished,1721027497,1721821349,A100-SXM4-80GB,8,2,64,448,22,793852
7b26cb55-5902-46e4-9674-c27981a5049d,flash-load-save,1721027526,1721030240,finished,1721027591,1721030240,A100-SXM4-80GB,8,2,64,896,65,2649
55603e4d-2d15-49ae-ae4e-dc91718f7a8c,qwen1-14B,1721027613,1721027699,finished,1721027633,1721027699,A100-SXM4-80GB,8,1,64,896,20,66
908de21d-dd54-42e6-9245-8b6e71e418e2,qwen2-0-5B-bcb29-auto,1721027638,1721039598,finished,1721028168,1721039598,A100-SXM4-80GB,1,1,8,112,530,11430
dbe20067-3a5f-4f95-9f4a-3eafbd385c0f,geogpt-qwen15-moe-alpaca-sft,1721027738,1721027826,finished,1721027761,1721027826,A100-SXM4-80GB,8,1,64,896,23,65
ae5332a0-2e67-4ac1-9675-e0d5b3aec4b3,geo-cpt-qwen1-5-13b-freezeEmbed-lr5e-5,1721027746,1721105297,finished,1721104925,1721105297,A100-SXM4-80GB,8,2,64,896,77179,372
93c48eee-7d75-4720-b1ef-0aa0790e04d8,qwen1-14B,1721027786,1721027872,finished,1721027808,1721027872,A100-SXM4-80GB,8,1,64,896,22,64
b5d0f61b-be4e-405b-9d8f-1bb517313265,geogpt-sft-tq-llm-yxs,1721027794,1721028057,finished,1721027816,1721028057,A100-SXM4-80GB,8,1,64,896,22,241
fb19fabb-47fd-4e04-96f8-a3e2946e45e8,sfr-ft-2,1721027892,1721030386,finished,1721027914,1721030386,A100-SXM4-80GB,8,1,64,448,22,2472
03c20a60-fd10-4cb5-9393-9a7276790907,zjllm-sci-llama-3-7b,1721027911,1721201081,finished,1721027933,1721201081,A100-SXM4-80GB,8,1,64,448,22,173148
02282bb8-c8f9-419b-94af-03f48810e56f,qwen1-14B,1721027959,1721028047,finished,1721027981,1721028047,A100-SXM4-80GB,8,1,64,896,22,66
e076db8b-df6d-45b2-ab8b-8f6048624b01,llm-train,1721027960,1721028141,finished,1721027981,1721028141,A100-SXM4-80GB,8,1,64,896,21,160
f7af20c4-d6c9-44ba-ac02-ebbeb7b430fa,geogpt-qwen15-moe-alpaca-sft,1721027998,1721028136,finished,1721028019,1721028136,A100-SXM4-80GB,8,1,64,896,21,117
c2883aa5-ba8b-4b9a-9798-3e895d700a50,qwen1-14B,1721028140,1721028231,finished,1721028164,1721028231,A100-SXM4-80GB,8,1,64,896,24,67
47ca41b2-2a4f-452e-a336-c034d4dd89af,geo-mod-05b-test,1721028168,1721079060,finished,1721078185,1721079060,A100-SXM4-80GB,8,2,64,448,50017,875
83d3be29-7139-4130-98e6-2dbc3f440b28,qwen1-14B,1721028314,1721028400,finished,1721028335,1721028400,A100-SXM4-80GB,8,1,64,896,21,65
19ae4824-0d73-4008-9940-778bf1941f2f,geogpt-dairui-eval-code-3,1721028339,1721112303,finished,1721111574,1721112303,A100-SXM4-80GB,8,4,64,896,83235,729
0912dec9-bdf0-4a4e-a2bc-e98056dde194,syh-subspace-eval,1721028390,1721103731,finished,1721029541,1721103731,A100-SXM4-80GB,8,1,64,448,1151,74190
664d686e-b082-46ed-b7cc-8bb90cb3f0d6,llm-train,1721028443,1721028617,finished,1721028464,1721028617,A100-SXM4-80GB,8,1,64,896,21,153
2d6ddb76-5a57-4700-bb48-8bea1aae549f,gpt-megatron,1721028481,1721091235,finished,1721028544,1721091235,A100-SXM4-80GB,8,16,64,448,63,62691
15969d4b-d71d-4feb-8e1f-c2aa29e352a2,qwen1-14B,1721028486,1721028573,finished,1721028506,1721028573,A100-SXM4-80GB,8,1,64,896,20,67
0cc6c3ea-9743-4b09-9063-027772e8f2f9,qwen1-14B,1721028659,1721028743,finished,1721028680,1721028743,A100-SXM4-80GB,8,1,64,896,21,63
c070abdd-9c6b-4352-825a-c92e4d68d54f,qwen1-14B,1721028825,1721028907,finished,1721028845,1721028907,A100-SXM4-80GB,8,1,64,896,20,62
218c2802-8805-4468-8d48-e3667aaeaa63,geogpt-qwen15-moe-alpaca-sft,1721028985,1721029108,finished,1721029006,1721029108,A100-SXM4-80GB,8,1,64,896,21,102
53fbefa1-954e-4383-8c8e-dd74a3d26d20,qwen1-14B,1721028989,1721029071,finished,1721029010,1721029071,A100-SXM4-80GB,8,1,64,896,21,61
0f656cfa-ad77-4c96-bc98-cf0737fc0670,qwen1-14B,1721029153,1721029237,finished,1721029173,1721029237,A100-SXM4-80GB,8,1,64,896,20,64
3ba7dfc9-8c16-41c3-83cb-6cf4bdcfe45a,geo-1-5B-memcost-sq,1721029217,1721043215,finished,1721041331,1721043215,A100-SXM4-80GB,8,1,64,448,12114,1884
dcc913da-9aee-487a-a5c7-4db887de266a,qwen1-14B,1721029318,1721029401,finished,1721029338,1721029401,A100-SXM4-80GB,8,1,64,896,20,63
56fbd68d-4caa-4e91-8838-65aad4fedf7b,qwen2-1-5B-3cf11-auto,1721029404,1721041310,finished,1721029427,1721041310,A100-SXM4-80GB,1,1,8,112,23,11883
0a562d14-4857-44d4-a86f-f3d11f1fd5fb,qwen2-0-5B-geocpt-5B-3f059-auto,1721029449,1721040745,finished,1721029471,1721040745,A100-SXM4-80GB,1,1,8,112,22,11274
8d7c3f52-1b17-43b6-8245-adbe29762d50,qwen2-1-5B-geocpt-5B-1e06f-auto,1721029471,1721041185,finished,1721029493,1721041185,A100-SXM4-80GB,1,1,8,112,22,11692
d2915597-132e-428c-b230-4429d2248015,qwen1-14B,1721029489,1721029571,finished,1721029510,1721029571,A100-SXM4-80GB,8,1,64,896,21,61
1b892e45-b8fa-42f0-b226-b7f07576610a,qwen1-14B,1721029654,1721029755,finished,1721029675,1721029755,A100-SXM4-80GB,8,1,64,896,21,80
fbce8ffc-9480-49ac-94b5-f3be5ff657e4,geogpt-qwen15-moe-alpaca-sft,1721029730,1721029876,finished,1721029751,1721029876,A100-SXM4-80GB,8,1,64,448,21,125
489932f4-f380-4190-b3ea-409a11560f8a,qwen1-14B,1721029838,1721029925,finished,1721029859,1721029925,A100-SXM4-80GB,8,1,64,896,21,66
7913dd4a-162c-4c18-88d2-e593df606036,llm-train,1721029881,1721030034,finished,1721029903,1721030034,A100-SXM4-80GB,8,1,64,896,22,131
74901c90-d864-47b5-822a-ba8efa641f1d,llama-factory-zj-test,1721029967,1721030432,finished,1721030031,1721030432,A100-SXM4-80GB,8,4,64,896,64,401
f57240fa-1732-4068-9d2a-7660b40fc4b2,qwen1-14B,1721030012,1721030096,finished,1721030033,1721030096,A100-SXM4-80GB,8,1,64,896,21,63
1fce2131-a600-44ac-9eb3-51396d80e106,qwen1-14B,1721030179,1721030263,finished,1721030200,1721030263,A100-SXM4-80GB,8,1,64,896,21,63
b039d7bd-60b3-4bb9-92de-9f05984acbf3,flash-load-save,1721030240,1721031485,finished,1721030282,1721031485,A100-SXM4-80GB,8,2,64,896,42,1203
bf82314a-4087-481a-9b8e-3bbb44dde506,geogpt-sft-tq-llm-yxs,1721030334,1721030595,finished,1721030355,1721030595,A100-SXM4-80GB,8,1,64,896,21,240
c19f9a9d-4a8a-40a5-a77c-b27af92c58b5,qwen1-14B,1721030346,1721030434,finished,1721030368,1721030434,A100-SXM4-80GB,8,1,64,896,22,66
9117aaf1-9aca-48fe-8d35-e8360e177e69,llama-factory-zj-test,1721030432,1721030894,finished,1721030496,1721030894,A100-SXM4-80GB,8,4,64,896,64,398
6177e469-d9f4-4a1c-b9f3-7db1f097ac7d,zjllm-sci-llama-3-7b-infer,1721030491,1721031122,finished,1721030515,1721031122,A100-SXM4-80GB,8,1,64,448,24,607
f7720f80-8146-4b86-875b-719aaced0022,qwen1-14B,1721030521,1721030607,finished,1721030542,1721030607,A100-SXM4-80GB,8,1,64,896,21,65
b4de2632-45dd-44e3-a416-1865e6ef5f2b,sfr-ft-2,1721030605,1721033093,finished,1721030626,1721033093,A100-SXM4-80GB,8,1,64,448,21,2467
c93c0dd9-40ec-46b1-be72-44b0974217a8,qwen1-14B,1721030691,1721030773,finished,1721030712,1721030773,A100-SXM4-80GB,8,1,64,896,21,61
7c4ab6ea-f295-4220-b6c7-b51185c290b8,qwen1-14B,1721030936,1721031020,finished,1721030956,1721031020,A100-SXM4-80GB,8,1,64,896,20,64
72fd4d8f-857b-43c9-b78a-152c7ea96c08,llm-train,1721030957,1721031044,finished,1721030979,1721031044,A100-SXM4-80GB,8,1,64,896,22,65
07cbb19f-984c-4363-a6dd-eff087a7acfe,llama-factory-zj-test,1721030998,1721032559,finished,1721031041,1721032559,A100-SXM4-80GB,8,4,64,896,43,1518
d9775618-cbfe-4f71-a887-3b80a2d60c0e,qwen-trainer,1721031021,1721031254,finished,1721031044,1721031254,A100-SXM4-80GB,8,1,64,896,23,210
30d523cb-316d-45ce-bfb4-548621eef92d,geogpt-qwen15-moe-alpaca-sft,1721031038,1721031187,finished,1721031060,1721031187,A100-SXM4-80GB,8,1,64,448,22,127
847debde-a974-4ec2-ac0c-ecfe6f953193,qwen1-14B,1721031107,1721031191,finished,1721031128,1721031191,A100-SXM4-80GB,8,1,64,896,21,63
10ddcc65-9ea3-4d65-b999-6ad3a0e6b0d4,zjllm-sci-llama-3-7b-infer,1721031122,1721031309,finished,1721031145,1721031309,A100-SXM4-80GB,8,1,64,448,23,164
a351d571-74e2-4ce9-a011-6ea7e1d6d273,qwen1-14B,1721031274,1721031355,finished,1721031294,1721031355,A100-SXM4-80GB,8,1,64,896,20,61
8a592840-4f40-42bb-9d71-71c487378953,zjllm-sci-llama-3-7b-infer,1721031310,1721031629,finished,1721031330,1721031629,A100-SXM4-80GB,8,1,64,448,20,299
e87050b6-026d-4e6b-be8b-b1bffef7e8f7,geogpt-sft-tq-llm-yxs,1721031407,1721031664,finished,1721031428,1721031664,A100-SXM4-80GB,8,1,64,896,21,236
ca18bfb5-6bf9-4e84-9d74-b8611a8f711b,qwen1-14B,1721031442,1721031551,finished,1721031464,1721031551,A100-SXM4-80GB,8,1,64,896,22,87
3e598680-5cfa-4054-81c4-dac0c39fe0d6,geogpt-prompt-tuning-tg-infer1,1721031475,1721038259,finished,1721032187,1721038259,A100-SXM4-80GB,8,1,64,448,712,6072
6a48d2c0-2194-4cda-92c9-1d3e4f442ccb,bug,1721031506,1721034429,finished,1721031570,1721034429,A100-SXM4-80GB,8,2,64,896,64,2859
900a0053-624c-4017-ae2c-cdb1cc1db307,qwen1-14B,1721031614,1721031697,finished,1721031635,1721031697,A100-SXM4-80GB,8,1,64,896,21,62
88079a23-b08a-46fb-8296-8e7854f7a854,zjllm-sci-llama-3-7b-infer,1721031629,1721118208,finished,1721031651,1721118208,A100-SXM4-80GB,8,1,64,448,22,86557
d29b449f-85ac-490e-a81b-4f4b55a55bf4,qwen1-14B,1721031780,1721031861,finished,1721031801,1721031861,A100-SXM4-80GB,8,1,64,896,21,60
e2178903-bce1-410d-b290-02852aa0e435,qwen-trainer,1721031801,1721031949,finished,1721031821,1721031949,A100-SXM4-80GB,8,1,64,896,20,128
747f8d05-8d91-4ae7-ae53-9db7dbb11047,geogpt-qwen15-moe-alpaca-sft,1721031879,1721032027,finished,1721031899,1721032027,A100-SXM4-80GB,8,1,64,448,20,128
e2567826-b45c-444c-9cb8-5df5ea608b44,sp-10-13-dp-0612-d4a4c-auto,1721031909,1721044940,finished,1721031933,1721044940,A100-SXM4-80GB,8,1,64,448,24,13007
92d93110-7983-4da7-8ca1-4c0ad99aed5c,sp-0-13-dp-0612-3fa97-auto,1721031911,1721044501,finished,1721031933,1721044501,A100-SXM4-80GB,8,1,64,448,22,12568
ecd69d5c-2035-4140-a672-4ca4708789b7,qwen1-14B,1721031949,1721032031,finished,1721031969,1721032031,A100-SXM4-80GB,8,1,64,896,20,62
7f520afc-5876-4ef5-9bc9-f67068f90116,qwen1-14B,1721032114,1721032197,finished,1721032135,1721032197,A100-SXM4-80GB,8,1,64,896,21,62
0bb5b225-8a3a-4bf0-9503-5c4a9e9249ad,llama3-8b-cpt-80k-4b-07707-auto,1721032131,1721180219,finished,1721032152,1721180219,A100-SXM4-80GB,8,1,64,896,21,148067
1a8d68fb-19a1-4d99-bbb8-92c6c77e8c96,qwen-trainer,1721032260,1721032386,finished,1721032283,1721032386,A100-SXM4-80GB,8,1,64,896,23,103
342c4db6-a552-4303-8234-2d636cdaeb47,qwen1-14B,1721032282,1721032385,finished,1721032303,1721032385,A100-SXM4-80GB,8,1,64,896,21,82
e56cff00-1b0a-4b68-8aea-5f22b4d2c9df,opencompass-eval-0715,1721032299,1721042152,finished,1721032320,1721042152,A100-SXM4-80GB,8,1,64,896,21,9832
1555b6b0-9b7d-400e-9785-802a9e295deb,geogpt-sft-tq-llm-yxs,1721032311,1721032593,finished,1721032332,1721032593,A100-SXM4-80GB,8,1,64,896,21,261
0bbf2e6f-5ea8-4d55-80d3-2ff09999d052,sp-8-dp-0612-96552-auto,1721032412,1721036751,finished,1721032436,1721036751,A100-SXM4-80GB,8,1,64,448,24,4315
34f436e8-d27a-40ad-bdd7-c0a8e73bccc6,sp-9-dp-0612-225bb-auto,1721032415,1721037739,finished,1721032436,1721037739,A100-SXM4-80GB,8,1,64,448,21,5303
05aee0e2-30cf-45f2-a93a-886ca12d044f,geogpt-qwen15-moe-alpaca-sft,1721032448,1721039379,finished,1721032469,1721039379,A100-SXM4-80GB,8,1,64,448,21,6910
b2615dcf-7477-48f8-9b4d-94d4cf645a02,qwen1-14B,1721032473,1721032561,finished,1721032494,1721032561,A100-SXM4-80GB,8,1,64,896,21,67
03a8b0ab-1870-44b6-af64-54e7c5ca3f34,geogpt-sft-finetune-yxs,1721032546,1721032678,finished,1721032569,1721032678,A100-SXM4-80GB,8,1,64,896,23,109
5090ceef-05fd-4150-afcb-0b08b1e17b46,llama3-8b-cpt-80k-3b-6198d-auto,1721032579,1721180258,finished,1721032602,1721180258,A100-SXM4-80GB,8,1,64,896,23,147656
0d7b722e-06a4-46ca-90d6-ea4aa5e3c236,llama3-extra-infer,1721032583,1721040213,finished,1721032604,1721040213,A100-SXM4-80GB,8,1,64,448,21,7609
dddcdd4b-ace1-4c69-87bf-ab661152ba36,qwen1-14B,1721032648,1721032733,finished,1721032669,1721032733,A100-SXM4-80GB,8,1,64,896,21,64
3688847e-3885-40f6-8cd5-86c66a5156b2,qwen-trainer,1721032820,1721032947,finished,1721032842,1721032947,A100-SXM4-80GB,8,1,64,896,22,105
33f950b8-87dc-469d-9459-669c1fb96280,qwen1-14B,1721032820,1721032904,finished,1721032841,1721032904,A100-SXM4-80GB,8,1,64,896,21,63
84aea9cf-3b34-4ca2-b0b7-8c348c46201b,llm-train,1721032842,1721033159,finished,1721032863,1721033159,A100-SXM4-80GB,8,1,64,896,21,296
a5d1534c-e387-4610-8c4c-9c2e1c66515b,qwen1-14B,1721032988,1721033074,finished,1721033009,1721033074,A100-SXM4-80GB,8,1,64,896,21,65
570305e4-dc0d-4990-8353-8a6c9f755fb3,linux-env,1721033007,1721036385,finished,1721033031,1721036385,A100-SXM4-80GB,8,1,64,448,24,3354
410286ca-12cb-438d-8269-6cf298a181fd,qwen1-14B,1721033159,1721033244,finished,1721033180,1721033244,A100-SXM4-80GB,8,1,64,896,21,64
68d98feb-ad84-436a-a4ee-903072747b52,debug,1721033307,1721040592,finished,1721033329,1721040592,A100-SXM4-80GB,8,1,64,896,22,7263
49d7e30d-b04b-4239-a579-a5d512a488d4,qwen1-14B,1721033329,1721033415,finished,1721033350,1721033415,A100-SXM4-80GB,8,1,64,896,21,65
046ec0da-c9b1-4025-99ec-41e9d79b3208,qwen1-14B,1721033500,1721033584,finished,1721033521,1721033584,A100-SXM4-80GB,8,1,64,896,21,63
82b68a48-5169-4045-831a-117277459234,sfr-ft-2,1721033646,1721036126,finished,1721033667,1721036126,A100-SXM4-80GB,8,1,64,448,21,2459
60d65340-9624-4088-aa6e-229dc7b56667,qwen1-14B,1721033669,1721033755,finished,1721033691,1721033755,A100-SXM4-80GB,8,1,64,896,22,64
8ec22776-e4f3-4902-bf66-e56ef44a4427,qwen1-14B,1721033843,1721033930,finished,1721033864,1721033930,A100-SXM4-80GB,8,1,64,896,21,66
a70343c5-0011-4f30-9061-2f2a8f218fb3,llm-train,1721033843,1721034020,finished,1721033865,1721034020,A100-SXM4-80GB,8,1,64,896,22,155
b786d3b7-939c-49b4-bfd9-6d7b0b0d7770,zxx-token-10,1721033885,1721251396,finished,1721033907,1721251396,A100-SXM4-80GB,8,1,64,896,22,217489
7eecdf7a-3527-4aa9-acde-2692a7a0a5ab,geogpt-sft-finetune-yxs,1721033895,1721034072,finished,1721033917,1721034072,A100-SXM4-80GB,8,1,64,896,22,155
2e492d74-efe7-4f1e-9ff4-475944cd0bcf,geogpt-cot-train-cp-d1,1721033939,1721034118,finished,1721034005,1721034118,A100-SXM4-80GB,8,4,64,896,66,113
268b2d87-7897-4f73-b842-63456fc3a49f,qwen1-14B,1721033996,1721034085,finished,1721034019,1721034085,A100-SXM4-80GB,8,1,64,896,23,66
89512eeb-6ec3-4197-8942-5ce9bf76fd82,train-0715B,1721034081,1721035017,finished,1721034106,1721035017,A100-SXM4-80GB,8,1,64,896,25,911
1fad1d86-1f67-4c0e-83e5-73e1a8ae67fb,qwen1-14B,1721034174,1721034258,finished,1721034195,1721034258,A100-SXM4-80GB,8,1,64,896,21,63
3b02cb3f-987d-44d7-b340-1a1e16a938c4,qwen1-14B,1721034344,1721034431,finished,1721034364,1721034431,A100-SXM4-80GB,8,1,64,896,20,67
9776bf9b-7031-4c46-9ca9-d7fc3157a112,bug,1721034429,1721035973,finished,1721034494,1721035973,A100-SXM4-80GB,8,2,64,896,65,1479
a73ff959-5229-4b71-9583-2d355a2ff9f8,qwen1-14B,1721034518,1721034602,finished,1721034540,1721034602,A100-SXM4-80GB,8,1,64,896,22,62
ef389140-e3e2-483d-90c2-27d39fa5372e,geogpt-sft-finetune-yxs,1721034569,1721034766,finished,1721034590,1721034766,A100-SXM4-80GB,8,1,64,896,21,176
c53c2e82-4927-43f8-8c2d-2c10fa26be2b,qwen1-14B,1721034688,1721034778,finished,1721034710,1721034778,A100-SXM4-80GB,8,1,64,896,22,68
4cfc0124-599b-4798-b6cf-a260f6ff4cb4,citysora-nan-debug,1721034735,1721036110,finished,1721034845,1721036110,A100-SXM4-80GB,8,4,64,896,110,1265
838b1063-7f42-426e-924b-fd00ab434eab,qwen1-14B,1721034866,1721034952,finished,1721034888,1721034952,A100-SXM4-80GB,8,1,64,896,22,64
8a6a92f7-c18b-488b-93a4-64b258be1f69,geogpt-sft-finetune-yxs,1721034875,1721035071,finished,1721034897,1721035071,A100-SXM4-80GB,8,1,64,896,22,174
1e368113-5349-478c-bee3-7c293f2faf7e,llama-actsave,1721034997,1721035084,finished,1721035020,1721035084,A100-SXM4-80GB,8,1,64,448,23,64
e8c5700c-831f-4418-96e1-14072fec45e7,train-0715B,1721035017,1721036148,finished,1721035038,1721036148,A100-SXM4-80GB,8,1,64,896,21,1110
8d7dfadd-53dd-4e4d-9b40-1f2f2f21d2d9,llm-train,1721035020,1721035172,finished,1721035042,1721035172,A100-SXM4-80GB,8,1,64,896,22,130
78518e48-65b9-4073-96e0-c56247a147b9,qwen1-14B,1721035041,1721035128,finished,1721035062,1721035128,A100-SXM4-80GB,8,1,64,896,21,66
f55139a6-f91b-4903-b1e5-52b7615b7463,zxx-token-50,1721035105,1721244724,finished,1721035127,1721244724,A100-SXM4-80GB,8,1,64,896,22,209597
b1af6624-4d15-4a7f-8584-6080379449af,llama-actsave,1721035194,1721093504,finished,1721035216,1721093504,A100-SXM4-80GB,8,1,64,448,22,58288
4d8e1698-8a79-418b-84f2-023878affaa1,qwen1-14B,1721035215,1721035300,finished,1721035236,1721035300,A100-SXM4-80GB,8,1,64,896,21,64
893f3565-a62b-48e8-99ab-6cdde6516744,qwen1-14B,1721035385,1721035489,finished,1721035406,1721035489,A100-SXM4-80GB,8,1,64,896,21,83
e0cc349d-21a8-43e1-8367-57417acf3040,qwen1-14B,1721035574,1721035659,finished,1721035595,1721035659,A100-SXM4-80GB,8,1,64,896,21,64
e2983c8e-14f6-483b-9384-3f37149d3955,qwen1-14B,1721035742,1721035846,finished,1721035763,1721035846,A100-SXM4-80GB,8,1,64,896,21,83
608040bd-31fb-4803-9b98-6d5365c81e44,llm-train,1721035889,1721036084,finished,1721035911,1721036084,A100-SXM4-80GB,8,1,64,896,22,173
4aecb35a-44e4-43d9-a503-0e6d740619dc,zxx-token-200,1721035930,1721241339,finished,1721035952,1721241339,A100-SXM4-80GB,8,1,64,896,22,205387
6de19d75-60c1-484f-908e-b85d6ceb8c49,qwen1-14B,1721035931,1721036019,finished,1721035953,1721036019,A100-SXM4-80GB,8,1,64,896,22,66
3302871b-91f3-498a-8f3d-9da87c8ff53c,qwen1-14B,1721036107,1721036194,finished,1721036128,1721036194,A100-SXM4-80GB,8,1,64,896,21,66
9329b81a-9462-4479-9fc5-f3023b6c2f05,citysora-nan-debug,1721036110,1721036325,finished,1721036174,1721036325,A100-SXM4-80GB,8,4,64,896,64,151
63fcf90b-5307-40bd-8330-b1c5091934f8,train-0715B,1721036148,1721038917,finished,1721036168,1721038917,A100-SXM4-80GB,8,1,64,896,20,2749
464e677c-69e8-4ea9-aed1-daa42dec022f,geogpt-cot-train-cp-r1,1721036267,1721043573,finished,1721036289,1721043573,A100-SXM4-80GB,8,1,64,896,22,7284
3d08da22-b68c-4cd0-ae11-3736d276e7ba,qwen1-14B,1721036280,1721036364,finished,1721036301,1721036364,A100-SXM4-80GB,8,1,64,896,21,63
34cd7eb7-610f-4dab-9ba9-c5ce45d4a4ba,linux-env,1721036385,1721047465,finished,1721036408,1721047465,A100-SXM4-80GB,8,1,64,448,23,11057
e5f63648-e6f8-4d26-add1-cc42b20fa003,geogpt-cot-train-cp-r2,1721036396,1721043573,finished,1721036419,1721043573,A100-SXM4-80GB,8,1,64,896,23,7154
f88814bb-a0eb-424d-9463-3dfb4d4e8056,citysora-nan-debug,1721036413,1721036637,finished,1721036482,1721036637,A100-SXM4-80GB,8,4,64,896,69,155
bd9733fe-807e-4de6-9195-7ee4d3a0e2df,citysora-modelv4-cele-ppm-65-512-from-5k512-lr1em6,1721036436,1721036702,finished,1721036547,1721036702,A100-SXM4-80GB,8,4,64,896,111,155
16c57aa8-5f7d-4923-b51d-7a3987ff96c9,qwen1-14B,1721036457,1721036544,finished,1721036479,1721036544,A100-SXM4-80GB,8,1,64,896,22,65
cf4b8ce2-7b2d-4e6a-91e7-c6dc5ea60697,Qwen2-7B-Instruct-9a3de-auto,1721036623,1721045650,finished,1721036645,1721045650,A100-SXM4-80GB,4,1,32,448,22,9005
64332798-69a0-497f-b219-ef51cf175180,qwen1-14B,1721036634,1721036722,finished,1721036656,1721036722,A100-SXM4-80GB,8,1,64,896,22,66
69cfb296-110e-411d-9e9d-20d9bf8d59ac,citysora-nan-debug,1721036725,1721036966,finished,1721036771,1721036966,A100-SXM4-80GB,8,4,64,896,46,195
246540b1-459d-48fc-9843-1b78cf0e4de0,citysora-modelv4-cele-ppm-65-512-from-5k512-lr1em6,1721036771,1721100616,finished,1721036815,1721100616,A100-SXM4-80GB,8,4,64,896,44,63801
d63b0bbf-ab32-42b9-a32c-bb5db06564c6,qwen1-14B,1721036812,1721036897,finished,1721036834,1721036897,A100-SXM4-80GB,8,1,64,896,22,63
4c0bc661-bc4c-4d45-9039-12a988a8ae32,citysora-nan-debug,1721036966,1721037845,finished,1721037010,1721037845,A100-SXM4-80GB,8,4,64,896,44,835
f16b7817-10cb-4202-8626-3e80f0510592,qwen1-14B,1721036985,1721037070,finished,1721037007,1721037070,A100-SXM4-80GB,8,1,64,896,22,63
b35a2c6e-a001-4dda-9c65-13f403188918,qwen1-5-14b-1-8msft-dc27e-auto,1721037120,1721048694,finished,1721037142,1721048694,A100-SXM4-80GB,8,1,64,448,22,11552
a521c774-91be-4b5e-97c7-e2a5149cb306,qwen1-14B,1721037155,1721037239,finished,1721037176,1721037239,A100-SXM4-80GB,8,1,64,896,21,63
4c7d5bdb-faad-4700-b4be-90efb0496063,geogpt-sft-finetune-yxs,1721037248,1721037437,finished,1721037269,1721037437,A100-SXM4-80GB,8,1,64,896,21,168
008dc500-c437-41a6-95f2-6e0b6e988cea,qwen1-14B,1721037324,1721037407,finished,1721037345,1721037407,A100-SXM4-80GB,8,1,64,896,21,62
96833381-fc06-468c-981e-77ce319d7af7,geogpt-prompt-tuning-tg-infer3,1721037463,1721048858,finished,1721038280,1721048858,A100-SXM4-80GB,8,1,64,448,817,10578
fbf5a722-7759-4e8a-95cb-c58015e37ddb,qwen1-14B,1721037495,1721037578,finished,1721037515,1721037578,A100-SXM4-80GB,8,1,64,896,20,63
bcb4f838-e64d-4e4a-a1d9-d0c83837aa4f,geogpt-sft-finetune-yxs,1721037614,1721037894,finished,1721037636,1721037894,A100-SXM4-80GB,8,1,64,896,22,258
475516df-2162-4e9c-8b4a-28901c4c2bec,qwen1-14B,1721037670,1721037756,finished,1721037691,1721037756,A100-SXM4-80GB,8,1,64,896,21,65
eeb1bf44-9f76-402d-98b7-1f634e4b20ca,qwen1-14B,1721037842,1721037928,finished,1721037864,1721037928,A100-SXM4-80GB,8,1,64,896,22,64
1aff5d5e-0ad3-42a3-9a74-915a4765af33,citysora-nan-debug,1721037845,1721097297,finished,1721037909,1721097297,A100-SXM4-80GB,8,4,64,896,64,59388
98208b23-289f-41d3-a508-484f29d6d986,qwen1-14B,1721038013,1721038098,finished,1721038034,1721038098,A100-SXM4-80GB,8,1,64,896,21,64
2593c6b6-47e1-4859-bf96-2d6d6cb18dbb,llm-train,1721038056,1721038777,finished,1721038078,1721038777,A100-SXM4-80GB,8,1,64,896,22,699
76f5fccb-325d-4522-84c8-c7f1970002e5,qwen1-14B,1721038184,1721038269,finished,1721038205,1721038269,A100-SXM4-80GB,8,1,64,896,21,64
c72766cb-94cd-480a-82cd-e98886c14134,qwen1-14B,1721038355,1721038439,finished,1721038376,1721038439,A100-SXM4-80GB,8,1,64,896,21,63
017470ea-36cf-4dad-b197-ef60fde7c298,qwen1-14B,1721038523,1721038606,finished,1721038543,1721038606,A100-SXM4-80GB,8,1,64,896,20,63
75e5ccbe-d949-4668-a82a-b9dc1b038863,sp-3-dp-0612-9ae3b-auto,1721038633,1721049873,finished,1721038656,1721049873,A100-SXM4-80GB,8,1,64,448,23,11217
8584629d-9fde-4dc9-bc09-37e2f513aa16,sp-5-dp-0612-f38ad-auto,1721038635,1721050408,finished,1721038657,1721050408,A100-SXM4-80GB,8,1,64,448,22,11751
9944d2b0-2c8b-42a6-a1be-90c793ef03f1,qwen1-14B,1721038694,1721038777,finished,1721038714,1721038777,A100-SXM4-80GB,8,1,64,896,20,63
b2ce0599-ce89-4df7-814c-00431f97d450,qwen1-14B,1721038859,1721038941,finished,1721038879,1721038941,A100-SXM4-80GB,8,1,64,896,20,62
22db3a84-85bc-47c7-8f54-be5d28ed3400,train-0715B,1721038917,1721040042,finished,1721038938,1721040042,A100-SXM4-80GB,8,1,64,896,21,1104
bf0c9c3a-4859-4efb-beee-f8f808681481,qwen1-14B,1721039027,1721039110,finished,1721039048,1721039110,A100-SXM4-80GB,8,1,64,896,21,62
4a06cec4-1687-42bc-aec3-3a83bce51767,qwen1-14B,1721039192,1721039278,finished,1721039213,1721039278,A100-SXM4-80GB,8,1,64,896,21,65
35f2eb08-3d0a-438f-98a0-094cb2189948,qwen1-14B,1721039362,1721039468,finished,1721039383,1721039467,A100-SXM4-80GB,8,1,64,896,21,84
e4e6af5d-e9fc-4a86-8775-6b8e9f04100a,qwen1-14B,1721039552,1721039637,finished,1721039574,1721039637,A100-SXM4-80GB,8,1,64,896,22,63
409e2eb3-0818-44be-b85d-ed56b221f15a,qwen1-14B,1721039721,1721039806,finished,1721039742,1721039806,A100-SXM4-80GB,8,1,64,896,21,64
e2f837da-0329-4c17-884a-6ad3dd7f9a5c,qwen1-14B,1721039894,1721039981,finished,1721039916,1721039981,A100-SXM4-80GB,8,1,64,896,22,65
74494f64-9629-43d2-9916-20bfa9e91a55,geogpt-sft-finetune-yxs,1721039925,1721041023,finished,1721039947,1721041023,A100-SXM4-80GB,8,1,64,896,22,1076
dbd1b6e4-fd18-47d6-b772-9b63a0bafc4f,geogpt-cot-eval-cp-r1,1721039925,1721041253,finished,1721039947,1721041253,A100-SXM4-80GB,8,1,64,896,22,1306
2159238c-a6ed-4dc4-abf9-409889a7ad8c,llm-train,1721039939,1721045143,finished,1721039961,1721045143,A100-SXM4-80GB,8,1,64,896,22,5182
23316e20-7eae-4c99-bc8a-fa704f2a717b,qwen1-14B,1721040067,1721040149,finished,1721040087,1721040149,A100-SXM4-80GB,8,1,64,896,20,62
b2918ac9-89f6-407f-806f-ec4acd318c55,qwen1-14B,1721040236,1721040320,finished,1721040257,1721040320,A100-SXM4-80GB,8,1,64,896,21,63
d1d42239-9387-461e-82f6-9c252ed37fde,train-0715B,1721040338,1721162267,finished,1721040359,1721162267,A100-SXM4-80GB,8,1,64,896,21,121908
4e9eb72d-b097-49b0-8e74-7531e9024cc3,qwen1-14B,1721040404,1721040487,finished,1721040424,1721040487,A100-SXM4-80GB,8,1,64,896,20,63
1b4767e0-ecdb-4fe9-9fff-2b0381c6b98a,qwen1-14B,1721040571,1721040655,finished,1721040592,1721040655,A100-SXM4-80GB,8,1,64,896,21,63
df52ad0f-0683-4453-a78f-ce51e15ebd9a,qwen1-14B,1721040742,1721040825,finished,1721040763,1721040825,A100-SXM4-80GB,8,1,64,896,21,62
8f06123b-7629-4a8c-8f2f-1e9ad04df51f,qwen1-14B,1721040908,1721040993,finished,1721040929,1721040993,A100-SXM4-80GB,8,1,64,896,21,64
b3aa4ef5-d074-4022-ba51-28dc2095315b,qwen1-14B,1721041078,1721041161,finished,1721041099,1721041161,A100-SXM4-80GB,8,1,64,896,21,62
ae625e09-4a32-4a3f-85a5-6e873093739d,qwen1-14B,1721041244,1721041327,finished,1721041266,1721041327,A100-SXM4-80GB,8,1,64,896,22,61
166f43ff-8cf9-436e-a8c0-f8a2fec5227a,qwen1-14B,1721041412,1721041493,finished,1721041432,1721041493,A100-SXM4-80GB,8,1,64,896,20,61
969f439e-e6fe-4a7f-a028-489bc03eaa90,qwen1-14B,1721041575,1721041658,finished,1721041595,1721041658,A100-SXM4-80GB,8,1,64,896,20,63
715b323c-b7f7-4ebe-8ee8-f721d6ed1df2,qwen1-14B,1721041740,1721041822,finished,1721041760,1721041822,A100-SXM4-80GB,8,1,64,896,20,62
a0d2d185-c309-4ae3-8751-8cdc2bab5ab2,qwen1-14B,1721041906,1721041990,finished,1721041927,1721041990,A100-SXM4-80GB,8,1,64,896,21,63
302d4a90-2ebb-436a-afc3-8ee42fe63b00,geogpt-cot-eval-cp-r1,1721041914,1721043261,finished,1721041935,1721043261,A100-SXM4-80GB,8,1,64,896,21,1326
0eff6e73-96da-41e2-8f86-7d37e0a7c5e1,qwen1-14B,1721042073,1721042155,finished,1721042093,1721042155,A100-SXM4-80GB,8,1,64,896,20,62
15567225-077e-4155-8e6a-c2dad1b93d43,geogpt-sft-finetune-yxs,1721042185,1721042516,finished,1721042205,1721042516,A100-SXM4-80GB,8,1,64,896,20,311
0c4dacdd-cc72-43d3-80b0-7dd73215a84b,qwen1-14B,1721042239,1721042322,finished,1721042260,1721042322,A100-SXM4-80GB,8,1,64,896,21,62
b3c1b897-9e7d-4b57-b044-e4ee629bc03d,qwen1-14B,1721042404,1721042487,finished,1721042425,1721042487,A100-SXM4-80GB,8,1,64,896,21,62
ec6824c4-7334-49b4-a127-b2f6b4828ba7,qwen1-14B,1721042570,1721042655,finished,1721042591,1721042655,A100-SXM4-80GB,8,1,64,896,21,64
711f22ac-b0c5-45b0-bd72-bc4d119e2063,geogpt-sft-finetune-yxs,1721042621,1721044146,finished,1721042642,1721044146,A100-SXM4-80GB,8,1,64,896,21,1504
cee95d36-a8b9-4495-ad8f-dbede2fae162,sp-0-16-dp-0612-057bf-auto,1721042722,1721057998,finished,1721042744,1721057998,A100-SXM4-80GB,8,1,64,448,22,15254
6140ab00-fe9f-47b6-a85e-eef0ec5f1dc7,qwen1-14B,1721042740,1721042821,finished,1721042761,1721042821,A100-SXM4-80GB,8,1,64,896,21,60
de568a6d-7875-400f-ae03-33864ba12c17,qwen1-14B,1721042903,1721042984,finished,1721042923,1721042984,A100-SXM4-80GB,8,1,64,896,20,61
8c2bb10e-defd-4eb0-a67e-665d84d953f0,qwen1-14B,1721043066,1721043149,finished,1721043087,1721043149,A100-SXM4-80GB,8,1,64,896,21,62
dbe52178-505f-4bd2-96ce-de226917413c,qwen1-14B,1721043233,1721043314,finished,1721043253,1721043314,A100-SXM4-80GB,8,1,64,896,20,61
f6e20817-abc7-4c3e-a530-63b8a9364dba,llamafactory-zj-test-cpt,1721043374,1721043520,finished,1721043437,1721043520,A100-SXM4-80GB,8,4,64,896,63,83
4c23b6ea-21db-4a22-8d46-92fd927f11b5,qwen1-14B,1721043397,1721043480,finished,1721043418,1721043480,A100-SXM4-80GB,8,1,64,896,21,62
93338917-abab-46f9-a328-691295ed3786,qwen1-14B,1721043565,1721043671,finished,1721043585,1721043671,A100-SXM4-80GB,8,1,64,896,20,86
40ad1ef0-2204-4832-b856-ff03e1809589,llamafactory-zj-test-cpt,1721043627,1721044578,finished,1721043691,1721044578,A100-SXM4-80GB,8,4,64,896,64,887
3ea4bb45-1db2-4371-8777-400d833c0227,qwen1-14B,1721043756,1721043861,finished,1721043777,1721043861,A100-SXM4-80GB,8,1,64,896,21,84
eebad9fc-31fd-4816-be1c-038f25f12de4,qwen1-14B,1721043944,1721044028,finished,1721043964,1721044028,A100-SXM4-80GB,8,1,64,896,20,64
8cfa81c3-9870-48de-8a87-bbf952941774,llamafactory-zj-test-cpt-cg,1721044048,1721044934,finished,1721044112,1721044934,A100-SXM4-80GB,8,4,64,896,64,822
e9f28ee9-6f28-49d7-a4dd-5190aee29564,qwen1-14B,1721044114,1721044200,finished,1721044135,1721044200,A100-SXM4-80GB,8,1,64,896,21,65
850471aa-c17f-4605-a0e3-1d1bdfac9892,geogpt-prompt-tuning-tg-infer1,1721044276,1721060787,finished,1721048878,1721060787,A100-SXM4-80GB,8,1,64,448,4602,11909
4ee9d5fd-dac1-476f-aefe-6a10e15d95da,qwen1-14B,1721044287,1721044371,finished,1721044308,1721044371,A100-SXM4-80GB,8,1,64,896,21,63
9324a617-fd7d-45dd-9303-ddf1f28c18a1,qwen1-14B,1721044455,1721044539,finished,1721044475,1721044539,A100-SXM4-80GB,8,1,64,896,20,64
90761842-1c24-43bd-9fd8-de3d38ce2bf0,geogpt-sft-finetune-yxs,1721044505,1721046002,finished,1721044526,1721046002,A100-SXM4-80GB,8,1,64,896,21,1476
9ff851ee-279d-42a0-9aad-f48b59681e0f,qwen1-14B,1721044622,1721044704,finished,1721044643,1721044704,A100-SXM4-80GB,8,1,64,896,21,61
75434a46-63e5-4015-aad4-cfbe408550b3,qwen1-14B,1721044786,1721044871,finished,1721044807,1721044871,A100-SXM4-80GB,8,1,64,896,21,64
7983d744-a4ae-446f-8aec-4b1aa28b9114,llamafactory-zj-test-cpt-cg,1721044934,1721045886,finished,1721044997,1721045886,A100-SXM4-80GB,8,4,64,896,63,889
06c5e242-2ce1-447c-8802-e1dac0651564,qwen1-14B,1721044957,1721045041,finished,1721044978,1721045041,A100-SXM4-80GB,8,1,64,896,21,63
c5df3c1d-e270-4f7f-b8ee-ff57bafbfa93,qwen1-14B,1721045123,1721045206,finished,1721045143,1721045206,A100-SXM4-80GB,8,1,64,896,20,63
af454304-2198-483e-ac20-e1c9ce941645,qwen1-14B,1721045288,1721045369,finished,1721045309,1721045369,A100-SXM4-80GB,8,1,64,896,21,60
f2e56f5d-cf4d-482f-ab37-d07c03e92749,qwen1-14B,1721045451,1721045534,finished,1721045473,1721045534,A100-SXM4-80GB,8,1,64,896,22,61
8c187dca-c831-4818-9d40-ba418b4b4f25,qwen1-14B,1721045618,1721045700,finished,1721045639,1721045700,A100-SXM4-80GB,8,1,64,896,21,61
aafe78b4-d239-4b0b-8a6a-38b7fa0aa1a9,qwen1-14B,1721045782,1721045867,finished,1721045803,1721045867,A100-SXM4-80GB,8,1,64,896,21,64
a061b1e8-c269-440f-8b8a-e7c92245142d,geogpt-cot-train-cp-d1,1721045854,1721046042,finished,1721045895,1721046042,A100-SXM4-80GB,8,4,64,896,41,147
cb42fc9a-1eac-4d0a-bde2-52ef83efcf2f,qwen1-14B,1721045949,1721046034,finished,1721045971,1721046034,A100-SXM4-80GB,8,1,64,896,22,63
613920c0-079b-4a82-a841-76d4894e96db,geogpt-eval-abductive,1721045958,1721046102,finished,1721045981,1721046102,A100-SXM4-80GB,8,1,64,896,23,121
73fa2ca8-10c6-4455-9fc6-d2da12785b00,sp-10-16-dp-0612-7b71d-auto,1721045977,1721061629,finished,1721045998,1721061629,A100-SXM4-80GB,8,1,64,448,21,15631
a8aec286-dd81-4698-a0ac-e0e4d537a0cd,qwen1-14B,1721046115,1721046198,finished,1721046136,1721046198,A100-SXM4-80GB,8,1,64,896,21,62
b8988045-0dda-4066-9b87-6bf42cb29390,geogpt-cot-train-cp-d1,1721046144,1721046331,finished,1721046185,1721046331,A100-SXM4-80GB,8,4,64,896,41,146
eeb417a1-a08e-480e-8ff5-4e8321e9ee08,qwen1-14B,1721046282,1721046365,finished,1721046303,1721046365,A100-SXM4-80GB,8,1,64,896,21,62
109039fc-7f1c-4aad-b8b3-1981fe4cf34f,geogpt-eval-abductive,1721046290,1721046456,finished,1721046310,1721046456,A100-SXM4-80GB,8,1,64,896,20,146
31ea5d83-baf3-4a73-945b-6cead3faa752,geogpt-cot-train-cp-d1,1721046435,1721046642,finished,1721046498,1721046642,A100-SXM4-80GB,8,4,64,896,63,144
de401960-1c78-488f-834c-ced09f003b78,qwen1-14B,1721046448,1721046531,finished,1721046468,1721046531,A100-SXM4-80GB,8,1,64,896,20,63
4c52ff17-df84-495c-a0be-5e0d2f6d8570,qwen1-14B,1721046613,1721046699,finished,1721046633,1721046699,A100-SXM4-80GB,8,1,64,896,20,66
696852b4-d6dc-4369-89e4-1ddb659516e5,geogpt-eval-abductive,1721046641,1721047010,finished,1721046662,1721047010,A100-SXM4-80GB,8,1,64,896,21,348
abea8069-46d5-4ab5-b0fd-f29e40c69bd7,llamafactory-zj-test-cpt,1721046717,1721047753,finished,1721046758,1721047753,A100-SXM4-80GB,8,4,64,896,41,995
7187b8b9-3feb-4cd4-b33b-9040c12f1f5c,llamafactory-zj-test-cpt-cg,1721046718,1721047795,finished,1721046778,1721047795,A100-SXM4-80GB,8,4,64,896,60,1017
1dcea9e6-455e-490c-82f7-52bc48f3c968,qwen1-14B,1721046780,1721046859,finished,1721046800,1721046859,A100-SXM4-80GB,8,1,64,896,20,59
5eff856e-556b-4f38-bf8b-e5071f0c6540,qwen1-14B,1721046939,1721047023,finished,1721046958,1721047023,A100-SXM4-80GB,8,1,64,896,19,65
185fc805-b3ec-4ec4-bf64-5d1cd34506c4,geogpt-eval-abductive,1721047010,1721047639,finished,1721047031,1721047639,A100-SXM4-80GB,8,1,64,896,21,608
72486ba0-5cc8-45c8-9172-b6fe525af7c8,geogpt-cot-train-cp-d1,1721047010,1721047703,finished,1721047072,1721047703,A100-SXM4-80GB,8,4,64,896,62,631
7cc5e557-1f41-44db-8078-b3d999b7912e,qwen1-14B,1721047105,1721047185,finished,1721047125,1721047185,A100-SXM4-80GB,8,1,64,896,20,60
b178ced1-08e1-4152-ac9d-f80791851cbe,qwen1-14B,1721047267,1721047347,finished,1721047287,1721047347,A100-SXM4-80GB,8,1,64,896,20,60
debdcab3-b56f-4e8a-89c9-260f00b5380b,qwen1-14B,1721047427,1721047526,finished,1721047447,1721047526,A100-SXM4-80GB,8,1,64,896,20,79
a32e5a34-1d93-405a-ac61-d2d93f341e8f,linux-env,1721047465,1721047545,finished,1721047485,1721047545,A100-SXM4-80GB,8,1,64,448,20,60
3b5120e1-aef0-48d8-b6fb-7d99a8458dd6,qwen1-14B,1721047608,1721047695,finished,1721047630,1721047695,A100-SXM4-80GB,8,1,64,896,22,65
e6675e51-b731-4323-982f-e237c648d2ed,linux-env,1721047629,1721047753,finished,1721047652,1721047753,A100-SXM4-80GB,8,1,64,448,23,101
936d6a25-5606-4e48-b8af-04a66b49271e,geogpt-eval-abductive,1721047639,1721047783,finished,1721047661,1721047783,A100-SXM4-80GB,8,1,64,896,22,122
14ced466-b167-4a48-8c96-d5aa36d62510,qwen1-14B,1721047775,1721047859,finished,1721047797,1721047859,A100-SXM4-80GB,8,1,64,896,22,62
d8984a47-89a0-42a6-9395-fd898ef6de48,geogpt-cot-train-cp-d1,1721047783,1721048550,finished,1721047846,1721048550,A100-SXM4-80GB,8,4,64,896,63,704
a22a1aa6-eee1-4221-8afc-36d3f04e7888,linux-env,1721047899,1721047981,finished,1721047920,1721047981,A100-SXM4-80GB,8,1,64,448,21,61
8ad57ab4-8b80-47d3-9337-c1cf97b78140,qwen1-14B,1721047942,1721048025,finished,1721047962,1721048025,A100-SXM4-80GB,8,1,64,896,20,63
34a61a99-17c5-432f-96a6-0194d4e90c8a,geogpt-eval-abductive,1721047949,1721048094,finished,1721047970,1721048094,A100-SXM4-80GB,8,1,64,896,21,124
9ce0cc8c-3f66-4ea2-aaa7-8d8098dc7c66,linux-env,1721048045,1721048126,finished,1721048065,1721048126,A100-SXM4-80GB,8,1,64,448,20,61
a9d45cb7-5da8-4ba1-9a3f-097655cf9761,qwen1-14B,1721048106,1721048190,finished,1721048128,1721048190,A100-SXM4-80GB,8,1,64,896,22,62
0a7994e3-251f-43ef-98a3-5d018b56a549,geogpt-eval-abductive,1721048157,1721048342,finished,1721048177,1721048342,A100-SXM4-80GB,8,1,64,896,20,165
ef963b31-17c9-4409-9178-6cf411211e41,qwen1-14B,1721048272,1721048378,finished,1721048292,1721048378,A100-SXM4-80GB,8,1,64,896,20,86
ed4df762-4aa1-43a3-a7c0-33191c9739be,geogpt-eval-abductive,1721048342,1721048673,finished,1721048365,1721048673,A100-SXM4-80GB,8,1,64,896,23,308
ad26c7fa-fed6-4e7f-8d8d-65aba46a5d51,geogpt-sft-finetune-eval-yxs,1721048342,1721048466,finished,1721048365,1721048466,A100-SXM4-80GB,8,1,64,896,23,101
192959e2-6855-4955-9b1c-fb97977ca41a,qwen1-14B,1721048458,1721048542,finished,1721048478,1721048542,A100-SXM4-80GB,8,1,64,896,20,64
8bed3844-f067-4f65-89c2-80bdb6589757,geogpt-sft-finetune-eval-yxs,1721048508,1721073020,finished,1721048530,1721073020,A100-SXM4-80GB,8,1,64,896,22,24490
874e59d1-7f3b-4f1d-a2ee-ff106d388262,geogpt-cot-train-cp-d1,1721048550,1721050667,finished,1721048610,1721050667,A100-SXM4-80GB,8,4,64,896,60,2057
d9855a3b-2146-4225-ad7c-e39d59082ca2,qwen1-14B,1721048624,1721048707,finished,1721048645,1721048707,A100-SXM4-80GB,8,1,64,896,21,62
2a143ece-999e-4888-a90a-aa26d02a07ff,geogpt-eval-abductive,1721048674,1721049458,finished,1721048695,1721049458,A100-SXM4-80GB,8,1,64,896,21,763
cb5acd33-aaf6-4a2c-a239-448b7ff85b20,qwen1-14B,1721048788,1721048868,finished,1721048808,1721048868,A100-SXM4-80GB,8,1,64,896,20,60
c8da12ed-1e9c-471a-8d1f-1651ae869828,qwen1-14B,1721048949,1721049030,finished,1721048970,1721049030,A100-SXM4-80GB,8,1,64,896,21,60
7fa1aa6b-bab8-4a0b-ab86-9694df157d0c,qwen1-14B,1721049111,1721049192,finished,1721049131,1721049192,A100-SXM4-80GB,8,1,64,896,20,61
a9414fcf-7c04-4c14-9582-4600c3aab40a,qwen1-14B,1721049271,1721049350,finished,1721049291,1721049350,A100-SXM4-80GB,8,1,64,896,20,59
18b3b70d-4ef3-41d3-9f4d-1eafdfc6fa41,qwen1-14B,1721049430,1721049510,finished,1721049450,1721049510,A100-SXM4-80GB,8,1,64,896,20,60
5a69ba7b-7373-44dd-abe9-ee82a767c181,qwen1-14B,1721049589,1721049668,finished,1721049609,1721049668,A100-SXM4-80GB,8,1,64,896,20,59
4d487635-46fe-43a9-9a8f-cfb760466bab,qwen1-14B,1721049748,1721049829,finished,1721049769,1721049829,A100-SXM4-80GB,8,1,64,896,21,60
32ef572e-907a-4625-b01c-9ee715c6ec60,qwen1-14B,1721049909,1721049989,finished,1721049929,1721049989,A100-SXM4-80GB,8,1,64,896,20,60
024595ed-0291-4fe0-9afd-e22272b7f775,qwen1-14B,1721050068,1721050147,finished,1721050088,1721050147,A100-SXM4-80GB,8,1,64,896,20,59
08070b74-e51f-440e-9f6c-90e20cee8663,qwen1-14B,1721050226,1721050325,finished,1721050245,1721050325,A100-SXM4-80GB,8,1,64,896,19,80
7bca5e60-0365-4a71-aad6-81dd4304c4e0,qwen1-14B,1721050404,1721050483,finished,1721050424,1721050483,A100-SXM4-80GB,8,1,64,896,20,59
25aa4695-92a9-41c0-ab9f-7908b6a9593f,qwen1-14B,1721050563,1721050659,finished,1721050583,1721050659,A100-SXM4-80GB,8,1,64,896,20,76
e6e3500f-23d7-404f-9e8e-c17997ba45cf,qwen1-14B,1721050739,1721050838,finished,1721050759,1721050838,A100-SXM4-80GB,8,1,64,896,20,79
001537b9-8905-4255-8dcb-cee11342e28f,qwen1-14B,1721050917,1721050999,finished,1721050936,1721050999,A100-SXM4-80GB,8,1,64,896,19,63
b3ae1887-0908-4860-94f0-9ca463c2d481,train-0715C,1721051016,1721051097,finished,1721051036,1721051097,A100-SXM4-80GB,8,1,64,896,20,61
63ff2fb7-36e2-40ab-8803-e5ed2817aeec,qwen1-14B,1721051079,1721051160,finished,1721051100,1721051160,A100-SXM4-80GB,8,1,64,896,21,60
958082dd-49f4-4a6b-943b-45d2ac8412b8,geogpt-eval-abductive,1721051127,1721052104,finished,1721051147,1721052104,A100-SXM4-80GB,8,1,64,896,20,957
e5130d87-6c9f-43bb-8a50-2a39ea245304,qwen1-14B,1721051240,1721051320,finished,1721051261,1721051320,A100-SXM4-80GB,8,1,64,896,21,59
054baf3b-6556-4394-bb33-37d283160ee3,qwen1-14B,1721051402,1721051479,finished,1721051421,1721051479,A100-SXM4-80GB,8,1,64,896,19,58
afb2a82f-6df5-4c3c-aaa4-4beef485a780,qwen1-14B,1721051559,1721051657,finished,1721051579,1721051657,A100-SXM4-80GB,8,1,64,896,20,78
f4840dd5-19a9-42d6-8115-81b887c39358,qwen1-14B,1721051735,1721051834,finished,1721051755,1721051834,A100-SXM4-80GB,8,1,64,896,20,79
50e73ee4-dc54-47cc-bd20-f7702ee4d325,qwen1-14B,1721051913,1721051993,finished,1721051933,1721051993,A100-SXM4-80GB,8,1,64,896,20,60
fe164b65-450c-49cf-a3d6-a24a1de7c1e1,train-0715C,1721051970,1721053661,finished,1721051990,1721053661,A100-SXM4-80GB,8,1,64,896,20,1671
42b7bfcc-bee9-473a-8f76-c1d2f45e73ed,qwen1-14B,1721052076,1721052157,finished,1721052097,1721052157,A100-SXM4-80GB,8,1,64,896,21,60
0a2d0443-acfa-4ec0-871b-b7badbf96b46,geogpt-eval-abductive,1721052104,1721052503,finished,1721052124,1721052503,A100-SXM4-80GB,8,1,64,896,20,379
98da47ce-33a5-4994-b93b-e0e297c9f0af,qwen1-14B,1721052237,1721052316,finished,1721052256,1721052316,A100-SXM4-80GB,8,1,64,896,19,60
e04eae4c-fd79-4c5c-93db-f01f86d3be2f,qwen1-14B,1721052394,1721052475,finished,1721052415,1721052475,A100-SXM4-80GB,8,1,64,896,21,60
3eacf1e3-6de8-4df4-9043-a3a45a4c8415,qwen1-14B,1721052555,1721052635,finished,1721052575,1721052635,A100-SXM4-80GB,8,1,64,896,20,60
f518d39f-8ed0-4805-8a7c-56e7e0797021,qwen1-14B,1721052715,1721052795,finished,1721052734,1721052795,A100-SXM4-80GB,8,1,64,896,19,61
99d13564-708a-4c72-8577-29f7fa05a136,qwen1-14B,1721052874,1721052953,finished,1721052894,1721052953,A100-SXM4-80GB,8,1,64,896,20,59
d3dfba81-d5cf-4f96-a226-3332afd6e975,qwen1-14B,1721053033,1721053112,finished,1721053053,1721053112,A100-SXM4-80GB,8,1,64,896,20,59
d5c658cf-7503-49e5-98dd-18fd5d1516d5,qwen1-14B,1721053191,1721053269,finished,1721053210,1721053269,A100-SXM4-80GB,8,1,64,896,19,59
9b5eefec-912a-48b0-9ae4-8f6265991bcd,qwen1-14B,1721053348,1721053427,finished,1721053368,1721053427,A100-SXM4-80GB,8,1,64,896,20,59
78908ec1-b312-4c29-9ab7-77e1b5fbd53a,qwen1-14B,1721053506,1721053585,finished,1721053526,1721053585,A100-SXM4-80GB,8,1,64,896,20,59
45d51e11-0609-4871-ae40-3dab80f64004,qwen1-14B,1721053664,1721053763,finished,1721053684,1721053763,A100-SXM4-80GB,8,1,64,896,20,79
db53bd01-3b95-4187-a8e7-5805efe75c86,train-0715C,1721053740,1721100669,finished,1721053760,1721100669,A100-SXM4-80GB,8,1,64,896,20,46909
dcd26344-a9b7-4e6f-bf75-aa0f00c5c9d1,qwen1-14B,1721053842,1721053923,finished,1721053862,1721053923,A100-SXM4-80GB,8,1,64,896,20,61
0e510be3-f59d-4c24-bb6f-9a34cc6bd3d2,geo-1-5B-memcost-sq,1721053885,1721053964,finished,1721053906,1721053964,A100-SXM4-80GB,8,1,64,448,21,58
be78b559-5050-46f9-95f2-21a5e2463bd4,qwen1-14B,1721054001,1721054100,finished,1721054021,1721054100,A100-SXM4-80GB,8,1,64,896,20,79
4134523d-78cc-4e33-9f21-aa2ff67db0f8,qwen1-14B,1721054180,1721054280,finished,1721054200,1721054280,A100-SXM4-80GB,8,1,64,896,20,80
e7546d35-c617-4c16-a1e7-8adc730b53ec,geo-1-5B-memcost-sq,1721054184,1721054482,finished,1721054203,1721054482,A100-SXM4-80GB,8,1,64,448,19,279
69e26195-a6df-42ee-a146-5b87c82b43dc,qwen1-14B,1721054359,1721054439,finished,1721054379,1721054439,A100-SXM4-80GB,8,1,64,896,20,60
696d0bc7-46c7-463b-bbdd-7bd09131f76e,qwen1-14B,1721054518,1721054617,finished,1721054538,1721054617,A100-SXM4-80GB,8,1,64,896,20,79
f20abcf2-b2cd-43a4-a003-7c7b1589051f,qwen1-14B,1721054696,1721054775,finished,1721054716,1721054775,A100-SXM4-80GB,8,1,64,896,20,59
f5dbb987-015e-4f1b-92cc-a01e38881a84,qwen1-14B,1721054854,1721054933,finished,1721054874,1721054933,A100-SXM4-80GB,8,1,64,896,20,59
12136830-6332-4b1a-bb05-aad615f975eb,qwen1-14B,1721055012,1721055091,finished,1721055031,1721055091,A100-SXM4-80GB,8,1,64,896,19,60
8cf71f2b-19eb-4755-959c-7ff055f4897a,qwen1-14B,1721055171,1721055250,finished,1721055191,1721055250,A100-SXM4-80GB,8,1,64,896,20,59
6eb52ece-da83-4e9f-803c-fe6d63a184a6,geo-1-5B-memcost-sq,1721055193,1721055489,finished,1721055213,1721055489,A100-SXM4-80GB,8,1,64,448,20,276
ce949412-381f-433a-9024-6b51ee1ecc14,qwen1-14B,1721055329,1721055427,finished,1721055348,1721055427,A100-SXM4-80GB,8,1,64,896,19,79
4650c721-71cb-4d34-9ad1-3084c8213ceb,qwen1-14B,1721055506,1721055585,finished,1721055525,1721055585,A100-SXM4-80GB,8,1,64,896,19,60
3b80536e-8f13-4f0b-8253-8aec5e1cf299,qwen1-14B,1721055663,1721055762,finished,1721055683,1721055762,A100-SXM4-80GB,8,1,64,896,20,79
860f6164-83e9-42b5-89b8-83d54fe319e4,qwen1-14B,1721055841,1721055921,finished,1721055861,1721055921,A100-SXM4-80GB,8,1,64,896,20,60
09a38792-1dba-424c-ae23-afa79f548e1a,qwen1-14B,1721056001,1721056098,finished,1721056021,1721056098,A100-SXM4-80GB,8,1,64,896,20,77
de9cb20c-c7ad-46f8-9752-3b204fd91fdd,qwen1-14B,1721056177,1721056257,finished,1721056197,1721056257,A100-SXM4-80GB,8,1,64,896,20,60
28b6f955-2e59-4849-a27a-836ebec32d87,geo-1-5B-memcost-sq,1721056220,1721058430,finished,1721056240,1721058430,A100-SXM4-80GB,8,1,64,448,20,2190
82c15e8c-9bb7-4444-b6cd-ecc28f0f58fc,qwen1-14B,1721056337,1721056417,finished,1721056357,1721056417,A100-SXM4-80GB,8,1,64,896,20,60
55d5c40b-717d-4f98-89c2-18e17ec28640,qwen1-14B,1721056495,1721056575,finished,1721056515,1721056575,A100-SXM4-80GB,8,1,64,896,20,60
dfe6a0be-b78a-4eb1-8a0a-3f5e4a87dac7,qwen1-14B,1721056656,1721056734,finished,1721056676,1721056734,A100-SXM4-80GB,8,1,64,896,20,58
e69b4088-e637-435e-8073-6e5b2c5ca35a,qwen1-14B,1721056812,1721056910,finished,1721056832,1721056910,A100-SXM4-80GB,8,1,64,896,20,78
83b12f46-df82-43b1-a06a-e6d104e6e755,qwen1-14B,1721056988,1721057067,finished,1721057008,1721057067,A100-SXM4-80GB,8,1,64,896,20,59
511d6422-038a-41da-8fb6-880ca7ce9719,qwen1-14B,1721057147,1721057224,finished,1721057166,1721057224,A100-SXM4-80GB,8,1,64,896,19,58
d324646d-6c24-4406-903c-eec719b14f0d,qwen1-14B,1721057304,1721057403,finished,1721057324,1721057403,A100-SXM4-80GB,8,1,64,896,20,79
ca5a4350-ffd9-4106-a3b6-64a402b9e5a4,qwen1-14B,1721057483,1721057562,finished,1721057503,1721057562,A100-SXM4-80GB,8,1,64,896,20,59
67eae161-2173-42bf-b842-40cf675f46c5,qwen1-14B,1721057641,1721057720,finished,1721057661,1721057720,A100-SXM4-80GB,8,1,64,896,20,59
209d7fad-466a-4073-a3f9-084493e731a8,qwen1-14B,1721057797,1721057875,finished,1721057817,1721057875,A100-SXM4-80GB,8,1,64,896,20,58
aa8793a6-5aca-490b-8e39-23c79bd1f81d,qwen1-14B,1721057954,1721058034,finished,1721057974,1721058034,A100-SXM4-80GB,8,1,64,896,20,60
ffb57f35-ca1d-42a7-b952-3e383197f043,qwen1-14B,1721058113,1721058212,finished,1721058133,1721058212,A100-SXM4-80GB,8,1,64,896,20,79
769c4e5f-a40a-4da6-885e-86cb218500a2,qwen1-14B,1721058291,1721058369,finished,1721058311,1721058369,A100-SXM4-80GB,8,1,64,896,20,58
08394ce4-83ca-4605-888a-8aca56e4db7c,qwen1-14B,1721058446,1721058525,finished,1721058466,1721058525,A100-SXM4-80GB,8,1,64,896,20,59
f9d585b6-39e3-40de-b513-a9a32056d415,qwen1-14B,1721058602,1721058681,finished,1721058622,1721058681,A100-SXM4-80GB,8,1,64,896,20,59
4e2f1d9c-15ae-453a-a5cd-1eda408e7a54,qwen1-14B,1721058760,1721058837,finished,1721058779,1721058837,A100-SXM4-80GB,8,1,64,896,19,58
95f9b650-c884-4759-8c55-8726a16ab270,qwen1-14B,1721058915,1721058994,finished,1721058935,1721058994,A100-SXM4-80GB,8,1,64,896,20,59
0d67c2ef-6ca5-45f8-b182-080421477290,qwen1-14B,1721059073,1721059151,finished,1721059092,1721059151,A100-SXM4-80GB,8,1,64,896,19,59
fb4c2ca4-3902-4277-b460-6e3fed3d711b,qwen1-14B,1721059232,1721059311,finished,1721059252,1721059311,A100-SXM4-80GB,8,1,64,896,20,59
fd9f251f-7bf1-4b12-9939-77c35259214f,qwen1-14B,1721059389,1721059468,finished,1721059409,1721059468,A100-SXM4-80GB,8,1,64,896,20,59
46dace9c-9c57-4058-9bb7-bae514062633,qwen1-14B,1721059548,1721059628,finished,1721059568,1721059628,A100-SXM4-80GB,8,1,64,896,20,60
2f93b8db-7a63-4029-b9dd-386ce035bee6,qwen1-14B,1721059707,1721059784,finished,1721059726,1721059784,A100-SXM4-80GB,8,1,64,896,19,58
97a7d51a-e9df-4bb7-989d-28354eb7bbfc,qwen1-14B,1721059863,1721059942,finished,1721059882,1721059942,A100-SXM4-80GB,8,1,64,896,19,60
552c3d7b-0266-4546-b265-a92a2d278713,qwen1-14B,1721060022,1721060101,finished,1721060042,1721060101,A100-SXM4-80GB,8,1,64,896,20,59
a4cd64a7-dd72-4876-bf7f-a2d7d5416fd8,qwen1-14B,1721060181,1721060260,finished,1721060200,1721060260,A100-SXM4-80GB,8,1,64,896,19,60
799c7c32-2c75-4272-bcaf-50014e78c06d,qwen1-14B,1721060340,1721060419,finished,1721060359,1721060419,A100-SXM4-80GB,8,1,64,896,19,60
a104b789-edeb-4c4f-af77-41e19bba2408,qwen1-14B,1721060497,1721060577,finished,1721060518,1721060577,A100-SXM4-80GB,8,1,64,896,21,59
6d0ea6dd-0876-4e55-b7c8-083191e88c47,qwen1-14B,1721060657,1721060737,finished,1721060677,1721060737,A100-SXM4-80GB,8,1,64,896,20,60
c7611c28-4f9e-49d6-9fbd-67367444644c,qwen1-14B,1721060817,1721060895,finished,1721060837,1721060895,A100-SXM4-80GB,8,1,64,896,20,58
1f935b54-1746-411a-b78a-d0f70b19217e,qwen1-14B,1721060974,1721061052,finished,1721060993,1721061052,A100-SXM4-80GB,8,1,64,896,19,59
616d81b6-8364-4772-a0ea-72648c0af8cf,qwen1-14B,1721061131,1721061210,finished,1721061151,1721061210,A100-SXM4-80GB,8,1,64,896,20,59
2c04129b-7c30-43fa-b571-1a61f69b9c8e,qwen1-14B,1721061289,1721061367,finished,1721061309,1721061367,A100-SXM4-80GB,8,1,64,896,20,58
39c7208e-9d2f-4254-86e7-3ce7302d626d,qwen1-14B,1721061446,1721061526,finished,1721061466,1721061526,A100-SXM4-80GB,8,1,64,896,20,60
6fb58155-6764-4495-87f6-9495d2fdca67,qwen1-14B,1721061605,1721061684,finished,1721061625,1721061684,A100-SXM4-80GB,8,1,64,896,20,59
a9b5c447-126d-450f-9406-4b979cbf1207,qwen1-14B,1721061764,1721061843,finished,1721061783,1721061843,A100-SXM4-80GB,8,1,64,896,19,60
6b110412-5908-4a0a-8e49-2cc202f70703,qwen1-14B,1721061922,1721062002,finished,1721061943,1721062002,A100-SXM4-80GB,8,1,64,896,21,59
dd7eb5f4-0951-415d-bf98-7dd3aa2412a0,qwen1-14B,1721062081,1721062159,finished,1721062100,1721062159,A100-SXM4-80GB,8,1,64,896,19,59
0e9a8718-dec2-4408-a418-e0e22d8c985c,qwen1-14B,1721062238,1721062316,finished,1721062257,1721062316,A100-SXM4-80GB,8,1,64,896,19,59
d5610698-5143-4ddf-99a8-4758f2ef84a0,qwen1-14B,1721062396,1721062475,finished,1721062415,1721062475,A100-SXM4-80GB,8,1,64,896,19,60
04c3b76d-8bfa-497e-82d0-f3753191a6c4,qwen1-14B,1721062555,1721062634,finished,1721062574,1721062634,A100-SXM4-80GB,8,1,64,896,19,60
0be55573-318c-4f57-8ce6-bff9340d6b57,qwen1-14B,1721062712,1721062789,finished,1721062731,1721062789,A100-SXM4-80GB,8,1,64,896,19,58
1e2d99f0-68d5-4a85-bf1f-50c3478597d9,qwen1-14B,1721062867,1721062945,finished,1721062887,1721062945,A100-SXM4-80GB,8,1,64,896,20,58
31616c6a-7051-46de-95ef-5d32505500c7,qwen1-14B,1721063023,1721063101,finished,1721063043,1721063101,A100-SXM4-80GB,8,1,64,896,20,58
34e2e729-9417-491d-91da-b58f11e37729,qwen1-14B,1721063179,1721063257,finished,1721063199,1721063257,A100-SXM4-80GB,8,1,64,896,20,58
c63e2d3f-e214-4dbc-aaf3-071114ef066a,qwen1-14B,1721063335,1721063414,finished,1721063355,1721063414,A100-SXM4-80GB,8,1,64,896,20,59
2c1ad711-ba01-44c6-860f-31b4d4c7f7c5,qwen1-14B,1721063492,1721063590,finished,1721063511,1721063590,A100-SXM4-80GB,8,1,64,896,19,79
cc0c6bc2-b476-4fed-87a2-7d8a1c700d71,qwen1-14B,1721063670,1721063748,finished,1721063690,1721063748,A100-SXM4-80GB,8,1,64,896,20,58
88a8713e-7946-469f-b25c-b567e0146b94,qwen1-14B,1721063826,1721063905,finished,1721063845,1721063905,A100-SXM4-80GB,8,1,64,896,19,60
84227129-e2d4-438a-993f-47f5cd021a1b,qwen1-14B,1721063984,1721064081,finished,1721064003,1721064081,A100-SXM4-80GB,8,1,64,896,19,78
637d704c-16c6-4081-8014-a019cdbdb977,qwen1-14B,1721064159,1721064239,finished,1721064180,1721064239,A100-SXM4-80GB,8,1,64,896,21,59
c63311f8-7f57-4e06-b342-c87296b9b57e,ttt,1721064274,1721127586,finished,1721103578,1721127586,A100-SXM4-80GB,8,1,64,896,39304,24008
1cb8da9a-fcef-48a1-a05c-ce8f229314f8,qwen1-14B,1721064319,1721064398,finished,1721064339,1721064398,A100-SXM4-80GB,8,1,64,896,20,59
21534241-d25f-4c7f-aa3c-572926d4edc0,qwen1-14B,1721064476,1721064554,finished,1721064496,1721064554,A100-SXM4-80GB,8,1,64,896,20,58
cf574c86-793c-42e2-a7db-fac3ae33763c,qwen1-14B,1721064632,1721064731,finished,1721064651,1721064731,A100-SXM4-80GB,8,1,64,896,19,80
1e334d52-2937-4a0a-aa22-ef9474e6706d,qwen1-14B,1721064808,1721064887,finished,1721064828,1721064887,A100-SXM4-80GB,8,1,64,896,20,59
05c6a83b-20d9-40f3-8231-7e5b33a04503,geogpt-prompt-tuning-tg-infer3,1721064920,1721068883,finished,1721068043,1721068883,A100-SXM4-80GB,8,1,64,448,3123,840
23522810-2fcf-4e92-9dfe-cd8e573ef713,geogpt-prompt-tuning-tg-infer1,1721064920,1721071133,finished,1721068903,1721071133,A100-SXM4-80GB,8,1,64,448,3983,2230
010caadc-f745-4b7e-91a7-100775ec0879,geogpt-prompt-tuning-tg-infer2,1721064920,1721068023,finished,1721064941,1721068023,A100-SXM4-80GB,8,1,64,448,21,3082
5faf0844-76e7-4be6-9f6d-ac1d81635d33,qwen1-14B,1721064970,1721065049,finished,1721064989,1721065049,A100-SXM4-80GB,8,1,64,896,19,60
87d37465-7112-47fd-b95b-6bbf5c8e0219,qwen1-14B,1721065127,1721065206,finished,1721065146,1721065206,A100-SXM4-80GB,8,1,64,896,19,60
867d30d5-13d1-4f68-bb3b-f83c8515f13e,qwen1-14B,1721065286,1721065365,finished,1721065306,1721065365,A100-SXM4-80GB,8,1,64,896,20,59
319539c2-7e84-4f59-902f-44d3a064963e,qwen1-14B,1721065444,1721065521,finished,1721065464,1721065521,A100-SXM4-80GB,8,1,64,896,20,57
1f603b52-05d4-4fb5-a7e4-2db2f92ddcfa,qwen1-14B,1721065598,1721065675,finished,1721065618,1721065675,A100-SXM4-80GB,8,1,64,896,20,57
6968e45f-9732-4dc6-b09d-d35e903167a4,qwen1-14B,1721065754,1721065851,finished,1721065773,1721065851,A100-SXM4-80GB,8,1,64,896,19,78
009d462c-2f8c-4f77-a024-9828a7d79f41,qwen1-14B,1721065929,1721066008,finished,1721065949,1721066008,A100-SXM4-80GB,8,1,64,896,20,59
a4c4543b-2010-4a55-941f-0a5235c7b6b8,qwen1-14B,1721066087,1721066165,finished,1721066106,1721066165,A100-SXM4-80GB,8,1,64,896,19,59
fca21f29-0e62-4fa6-83c1-973d13f90dfe,qwen1-14B,1721066244,1721066320,finished,1721066263,1721066320,A100-SXM4-80GB,8,1,64,896,19,57
8db52f2a-7cfe-43ce-b688-c82a14eb606c,qwen1-14B,1721066398,1721066479,finished,1721066421,1721066479,A100-SXM4-80GB,8,1,64,896,23,58
f1c4cd4f-d550-41fc-bb3a-f42ea3c28730,qwen1-14B,1721066559,1721066637,finished,1721066579,1721066637,A100-SXM4-80GB,8,1,64,896,20,58
47f9d485-5e8e-4dd4-8838-204126859f80,qwen1-14B,1721066716,1721066794,finished,1721066736,1721066794,A100-SXM4-80GB,8,1,64,896,20,58
21586291-3332-47cb-9042-44a87b9af948,qwen1-14B,1721066872,1721066954,finished,1721066892,1721066954,A100-SXM4-80GB,8,1,64,896,20,62
d1b4bed9-9d8b-4210-b7c5-4b40542f9035,qwen1-14B,1721067032,1721067129,finished,1721067051,1721067129,A100-SXM4-80GB,8,1,64,896,19,78
00fa104e-9586-43ab-a139-1022a308c7dc,qwen1-14B,1721067208,1721067288,finished,1721067229,1721067288,A100-SXM4-80GB,8,1,64,896,21,59
53e1eefe-4454-419d-889d-16312039940e,qwen1-14B,1721067365,1721067443,finished,1721067385,1721067443,A100-SXM4-80GB,8,1,64,896,20,58
e8f3ebb1-0e8b-4c43-a45c-df0726ce2959,qwen1-14B,1721067522,1721067601,finished,1721067542,1721067601,A100-SXM4-80GB,8,1,64,896,20,59
2a9c5158-3b2e-4922-a411-316c3743e2d7,qwen1-14B,1721067679,1721067757,finished,1721067699,1721067757,A100-SXM4-80GB,8,1,64,896,20,58
4adab009-65ad-45f4-908f-7a3d304b306f,qwen1-14B,1721067837,1721067916,finished,1721067858,1721067916,A100-SXM4-80GB,8,1,64,896,21,58
1e93adcc-d896-4468-abd0-a000fa83051a,qwen1-14B,1721067994,1721068072,finished,1721068013,1721068072,A100-SXM4-80GB,8,1,64,896,19,59
4fedfea7-4059-4e5b-b0a5-0d007bd2f7bc,qwen1-14B,1721068148,1721068226,finished,1721068167,1721068226,A100-SXM4-80GB,8,1,64,896,19,59
66542f35-189d-4f95-927e-7e7b4a1e90a1,qwen1-14B,1721068304,1721068384,finished,1721068324,1721068384,A100-SXM4-80GB,8,1,64,896,20,60
644ca720-7a34-41d3-a591-941e33678133,qwen1-14B,1721068463,1721068561,finished,1721068483,1721068561,A100-SXM4-80GB,8,1,64,896,20,78
1468243e-d242-4cb9-87dd-4e98edf7cc27,qwen1-14B,1721068639,1721068717,finished,1721068659,1721068717,A100-SXM4-80GB,8,1,64,896,20,58
a8f7cb4f-c9fe-4c6d-ac48-65f8ee2de389,qwen1-14B,1721068796,1721068873,finished,1721068815,1721068873,A100-SXM4-80GB,8,1,64,896,19,58
b6d2ed34-beb7-404b-b4fb-d52b884078e6,qwen1-14B,1721068951,1721069049,finished,1721068970,1721069049,A100-SXM4-80GB,8,1,64,896,19,79
05293b9b-e741-47ed-881a-ca547e27dcfb,qwen1-14B,1721069128,1721069206,finished,1721069147,1721069206,A100-SXM4-80GB,8,1,64,896,19,59
186bfe8d-d82d-46dd-95e4-f8f35d564172,qwen1-14B,1721069284,1721069363,finished,1721069304,1721069363,A100-SXM4-80GB,8,1,64,896,20,59
4eb42599-17a2-4424-8eaa-6cc2d2e8d72f,qwen1-14B,1721069441,1721069520,finished,1721069461,1721069520,A100-SXM4-80GB,8,1,64,896,20,59
034088fa-f8e9-4345-aea0-acfb0b8d2534,qwen1-14B,1721069598,1721069676,finished,1721069619,1721069676,A100-SXM4-80GB,8,1,64,896,21,57
7a3d02b1-f35b-4d96-84fe-1dd2bdc4d8f9,qwen1-14B,1721069756,1721069834,finished,1721069775,1721069834,A100-SXM4-80GB,8,1,64,896,19,59
4b985e90-58c8-4256-9aa1-511c9baca64a,qwen1-14B,1721069913,1721070009,finished,1721069932,1721070009,A100-SXM4-80GB,8,1,64,896,19,77
bdcd263d-cced-4f3b-9094-1aa4cceffb76,qwen1-14B,1721070087,1721070166,finished,1721070107,1721070166,A100-SXM4-80GB,8,1,64,896,20,59
d92facbb-3f0e-4085-a947-b616903722f2,qwen1-14B,1721070245,1721070341,finished,1721070265,1721070341,A100-SXM4-80GB,8,1,64,896,20,76
7a873035-0371-437b-8608-acdf6ca2f345,qwen1-14B,1721070420,1721070497,finished,1721070439,1721070497,A100-SXM4-80GB,8,1,64,896,19,58
1f7e0749-0a5e-49b1-8cd2-1463f273c5ee,qwen1-14B,1721070576,1721070655,finished,1721070595,1721070655,A100-SXM4-80GB,8,1,64,896,19,60
1a08f868-6a95-4cb2-8645-cfe1badd0bd4,qwen1-14B,1721070733,1721070811,finished,1721070753,1721070811,A100-SXM4-80GB,8,1,64,896,20,58
91cb2368-8e05-48f1-90aa-dd07918e0ed2,qwen1-14B,1721070891,1721070968,finished,1721070911,1721070968,A100-SXM4-80GB,8,1,64,896,20,57
fd943b3a-f5b2-44ce-82e9-7a4fe9e8edfb,qwen1-14B,1721071045,1721071123,finished,1721071065,1721071123,A100-SXM4-80GB,8,1,64,896,20,58
cf66bd8f-b01a-4a1b-92d1-e216fb8d4a2e,qwen1-14B,1721071200,1721071278,finished,1721071220,1721071278,A100-SXM4-80GB,8,1,64,896,20,58
e4742ee8-6c8d-4919-ab21-410c151a0d50,qwen1-14B,1721071356,1721071434,finished,1721071375,1721071434,A100-SXM4-80GB,8,1,64,896,19,59
a2341beb-d8bd-4f83-8d83-3e889c90f238,qwen1-14B,1721071512,1721071591,finished,1721071532,1721071591,A100-SXM4-80GB,8,1,64,896,20,59
56b1cee2-5a53-46bd-ba8e-7883c769547c,qwen1-14B,1721071669,1721071747,finished,1721071688,1721071747,A100-SXM4-80GB,8,1,64,896,19,59
8957fa28-8635-46f3-9d23-f57eb8544365,qwen1-14B,1721071825,1721071902,finished,1721071845,1721071902,A100-SXM4-80GB,8,1,64,896,20,57
89e41452-20dc-48c0-875a-1863a5fd026c,qwen1-14B,1721071980,1721072058,finished,1721072000,1721072058,A100-SXM4-80GB,8,1,64,896,20,58
853e02a7-5959-4853-b5a5-51919211dbeb,qwen1-14B,1721072135,1721072232,finished,1721072155,1721072232,A100-SXM4-80GB,8,1,64,896,20,77
7cfdeaa9-91fd-4cc1-b256-258df9a52366,qwen1-14B,1721072312,1721072388,finished,1721072331,1721072388,A100-SXM4-80GB,8,1,64,896,19,57
88139a09-81b7-42b4-97c9-5c41f8232aef,qwen1-14B,1721072466,1721072545,finished,1721072485,1721072545,A100-SXM4-80GB,8,1,64,896,19,60
303affdb-2c1d-4ba9-8bc0-3b7bc77c50d6,qwen1-14B,1721072623,1721072721,finished,1721072643,1721072721,A100-SXM4-80GB,8,1,64,896,20,78
5f58c47d-15c1-4cc0-b657-5ce2fc453d92,qwen1-14B,1721072798,1721072876,finished,1721072818,1721072876,A100-SXM4-80GB,8,1,64,896,20,58
ccab8d2a-8099-4516-a71c-610764702bdc,qwen1-14B,1721072954,1721073032,finished,1721072974,1721073032,A100-SXM4-80GB,8,1,64,896,20,58
ef56754f-27e5-4fa5-b77e-20492bb7c5bd,qwen1-14B,1721073110,1721073187,finished,1721073129,1721073187,A100-SXM4-80GB,8,1,64,896,19,58
109bf739-59d0-4459-a4bf-72ebc3f14729,qwen1-14B,1721073266,1721073345,finished,1721073286,1721073345,A100-SXM4-80GB,8,1,64,896,20,59
effa979e-bc9c-44b5-a387-04bc054c0647,qwen1-14B,1721073424,1721073522,finished,1721073443,1721073522,A100-SXM4-80GB,8,1,64,896,19,79
bae14265-f8dd-4190-a416-a247f98f4593,qwen1-14B,1721073600,1721073679,finished,1721073621,1721073679,A100-SXM4-80GB,8,1,64,896,21,58
ac98fc0a-1721-46c9-99f2-bbaba6677737,qwen1-14B,1721073758,1721073833,finished,1721073777,1721073833,A100-SXM4-80GB,8,1,64,896,19,56
73b38bd7-7f27-469d-9fb6-3cdb49414076,qwen1-14B,1721073911,1721073989,finished,1721073930,1721073989,A100-SXM4-80GB,8,1,64,896,19,59
a7e1a73a-f991-4c0d-9188-370da5da57f9,qwen1-14B,1721074067,1721074145,finished,1721074087,1721074145,A100-SXM4-80GB,8,1,64,896,20,58
fadcaf29-87c6-4144-882b-750c8de200bc,qwen1-14B,1721074224,1721074302,finished,1721074244,1721074302,A100-SXM4-80GB,8,1,64,896,20,58
a19155f4-a74b-4cf4-82de-00763ed9df8d,qwen1-14B,1721074380,1721074457,finished,1721074399,1721074457,A100-SXM4-80GB,8,1,64,896,19,58
c08b58bf-4c93-4f32-8fa0-44ff0aa20f38,qwen1-14B,1721074534,1721074612,finished,1721074554,1721074612,A100-SXM4-80GB,8,1,64,896,20,58
095d2617-b821-48b0-b47f-ba751b0cf13a,qwen1-14B,1721074691,1721074770,finished,1721074711,1721074770,A100-SXM4-80GB,8,1,64,896,20,59
dcd78b6d-4231-44ee-bbd9-350359fb5bb6,qwen1-14B,1721074848,1721074926,finished,1721074868,1721074926,A100-SXM4-80GB,8,1,64,896,20,58
cc38feda-f928-4d36-99bd-9e17769f3fd1,qwen1-14B,1721075004,1721075101,finished,1721075023,1721075101,A100-SXM4-80GB,8,1,64,896,19,78
6dcf79d6-fe3a-47d5-b9ba-8eed1183554d,qwen1-14B,1721075180,1721075257,finished,1721075199,1721075257,A100-SXM4-80GB,8,1,64,896,19,58
6d658449-452d-4386-a0a0-3776218b9b9c,qwen1-14B,1721075335,1721075431,finished,1721075354,1721075431,A100-SXM4-80GB,8,1,64,896,19,77
c085c576-b539-4ca2-b895-229bb2effddd,qwen1-14B,1721075508,1721075586,finished,1721075528,1721075586,A100-SXM4-80GB,8,1,64,896,20,58
cf1cb431-0139-4e2b-ac86-3e0372a3eefd,qwen1-14B,1721075664,1721075743,finished,1721075684,1721075743,A100-SXM4-80GB,8,1,64,896,20,59
f560a4dc-55fc-499c-a820-d142255a6d8d,qwen1-14B,1721075820,1721075916,finished,1721075839,1721075916,A100-SXM4-80GB,8,1,64,896,19,77
25b2744a-f452-48d1-adfd-b462e87efafd,qwen1-14B,1721075994,1721076074,finished,1721076014,1721076074,A100-SXM4-80GB,8,1,64,896,20,60
f32d7913-0cf9-4377-ae2e-410dcace6674,qwen1-14B,1721076152,1721076250,finished,1721076172,1721076250,A100-SXM4-80GB,8,1,64,896,20,78
888e0015-555e-40ca-a95a-c34f27c0e6d6,qwen1-14B,1721076329,1721076406,finished,1721076348,1721076406,A100-SXM4-80GB,8,1,64,896,19,58
581ab255-6aed-4c9b-af87-1580794e0b8c,qwen1-14B,1721076483,1721076562,finished,1721076503,1721076562,A100-SXM4-80GB,8,1,64,896,20,59
1985343e-ff66-4100-8ad9-5c933f905a67,qwen1-14B,1721076640,1721076717,finished,1721076660,1721076717,A100-SXM4-80GB,8,1,64,896,20,57
5533647c-d9aa-40df-b3f7-b75b72ee28a0,qwen1-14B,1721076795,1721076872,finished,1721076814,1721076872,A100-SXM4-80GB,8,1,64,896,19,58
82bd82e7-2dce-4db7-9d45-d97a6a12206c,qwen1-14B,1721076951,1721077028,finished,1721076970,1721077028,A100-SXM4-80GB,8,1,64,896,19,58
2b3babce-d5b2-4b0c-8ccd-f0b0ef8e1399,qwen1-14B,1721077107,1721077187,finished,1721077127,1721077187,A100-SXM4-80GB,8,1,64,896,20,60
d4f198c5-3a3f-43a3-be6e-9635e2ff4d5f,qwen1-14B,1721077266,1721077343,finished,1721077285,1721077343,A100-SXM4-80GB,8,1,64,896,19,58
984f9c0a-aa38-4bbf-9ef1-b94f4613151a,qwen1-14B,1721077421,1721077498,finished,1721077440,1721077498,A100-SXM4-80GB,8,1,64,896,19,58
7300d6e1-7559-4c3d-9e0b-e22ef79bb4ac,qwen1-14B,1721077577,1721077655,finished,1721077596,1721077655,A100-SXM4-80GB,8,1,64,896,19,59
9d1a1eb6-04db-49fc-9f95-d7f94738c018,qwen1-14B,1721077734,1721077812,finished,1721077753,1721077812,A100-SXM4-80GB,8,1,64,896,19,59
e5a5f56c-0cf5-4091-b3f6-815fc3a5170c,qwen1-14B,1721077891,1721077988,finished,1721077910,1721077988,A100-SXM4-80GB,8,1,64,896,19,78
e663f7ab-45d4-4e94-a4bd-a1702e833dad,qwen1-14B,1721078066,1721078144,finished,1721078085,1721078144,A100-SXM4-80GB,8,1,64,896,19,59
bb6d91dc-e6d8-4005-9bed-f46bc3d390f7,qwen1-14B,1721078220,1721078298,finished,1721078240,1721078298,A100-SXM4-80GB,8,1,64,896,20,58
fca52e62-b438-4cce-aef4-1fa800587d85,qwen1-14B,1721078377,1721078455,finished,1721078397,1721078455,A100-SXM4-80GB,8,1,64,896,20,58
097bfdf6-e1f8-4918-b7f6-9516da5d70cb,qwen1-14B,1721078532,1721078610,finished,1721078551,1721078610,A100-SXM4-80GB,8,1,64,896,19,59
1840cc7b-e375-489b-aec8-073934754ec6,qwen1-14B,1721078688,1721078766,finished,1721078708,1721078766,A100-SXM4-80GB,8,1,64,896,20,58
896e9c7a-5382-46b3-aa89-7b3991f41834,qwen1-14B,1721078843,1721078920,finished,1721078863,1721078920,A100-SXM4-80GB,8,1,64,896,20,57
185b0431-78ab-46d0-8c14-5fc09fac1c1d,qwen1-14B,1721078998,1721079076,finished,1721079017,1721079076,A100-SXM4-80GB,8,1,64,896,19,59
8e70479c-9f5e-4ef7-8ab8-bb55b555923d,qwen1-14B,1721079155,1721079234,finished,1721079174,1721079234,A100-SXM4-80GB,8,1,64,896,19,60
1ac1ed48-a32f-410e-b481-dbaef74c929d,qwen1-14B,1721079311,1721079388,finished,1721079330,1721079388,A100-SXM4-80GB,8,1,64,896,19,58
ce3e61aa-4a68-4ff6-afc0-5d77ae6e6fa2,qwen1-14B,1721079467,1721079544,finished,1721079486,1721079544,A100-SXM4-80GB,8,1,64,896,19,58
f83eaf5c-f1f1-4771-b374-a5a7023823e3,qwen1-14B,1721079622,1721079700,finished,1721079642,1721079700,A100-SXM4-80GB,8,1,64,896,20,58
e5fb74b0-7449-4980-8d2c-6c719700ec16,qwen1-14B,1721079778,1721079856,finished,1721079797,1721079856,A100-SXM4-80GB,8,1,64,896,19,59
ebdde55f-0594-4a1f-a9f5-3c1f7d273f45,qwen1-14B,1721079935,1721080012,finished,1721079954,1721080012,A100-SXM4-80GB,8,1,64,896,19,58
b5803766-9ad7-4a0c-b4bf-6363b5bd92eb,qwen1-14B,1721080090,1721080169,finished,1721080109,1721080169,A100-SXM4-80GB,8,1,64,896,19,60
79eed05c-095d-4202-bfb7-e4616c4bb851,qwen1-14B,1721080246,1721080324,finished,1721080266,1721080324,A100-SXM4-80GB,8,1,64,896,20,58
dadadedc-0fab-4aa4-bfbf-aac72c8a5e97,qwen1-14B,1721080403,1721080502,finished,1721080423,1721080502,A100-SXM4-80GB,8,1,64,896,20,79
fae5362f-0fcc-4fdb-8a52-ef534099e6c1,qwen1-14B,1721080581,1721080659,finished,1721080600,1721080659,A100-SXM4-80GB,8,1,64,896,19,59
c3d5f691-e320-4b26-84d0-6b14c15c8cbe,qwen1-14B,1721080737,1721080815,finished,1721080756,1721080815,A100-SXM4-80GB,8,1,64,896,19,59
a7b21efe-22c4-412c-ba36-727ea4ebeca2,qwen1-14B,1721080893,1721080971,finished,1721080912,1721080971,A100-SXM4-80GB,8,1,64,896,19,59
bfa9e77e-f1db-4969-960d-dba7afef42a0,qwen1-14B,1721081049,1721081126,finished,1721081068,1721081126,A100-SXM4-80GB,8,1,64,896,19,58
3736a4e2-4949-489d-92c7-c6842e4ace25,qwen1-14B,1721081203,1721081282,finished,1721081223,1721081282,A100-SXM4-80GB,8,1,64,896,20,59
dc9b738a-c1b6-4fdc-a87d-d489dedb934f,qwen1-14B,1721081360,1721081439,finished,1721081380,1721081439,A100-SXM4-80GB,8,1,64,896,20,59
8d2f909a-d8b2-4c1f-b6dc-d64bbd41c012,qwen1-14B,1721081516,1721081594,finished,1721081536,1721081594,A100-SXM4-80GB,8,1,64,896,20,58
ed3a8cba-b3fe-420e-9494-0ed78d1d0a5e,qwen1-14B,1721081673,1721081751,finished,1721081692,1721081751,A100-SXM4-80GB,8,1,64,896,19,59
cd62a3ce-69c0-4cc3-9553-25d67c0428b1,qwen1-14B,1721081830,1721081907,finished,1721081849,1721081907,A100-SXM4-80GB,8,1,64,896,19,58
e1e75ef5-b87c-4bfc-a455-8d957a1a5cda,qwen1-14B,1721081985,1721082082,finished,1721082004,1721082082,A100-SXM4-80GB,8,1,64,896,19,78
9c1ecee5-acdb-4d72-85df-82bf513722de,qwen1-14B,1721082160,1721082239,finished,1721082179,1721082239,A100-SXM4-80GB,8,1,64,896,19,60
7188f0fe-cf50-454d-8a50-2bea89bf5639,qwen1-14B,1721082317,1721082396,finished,1721082337,1721082396,A100-SXM4-80GB,8,1,64,896,20,59
80a9011e-4951-4490-b7aa-62eb121bd7dc,qwen1-14B,1721082474,1721082551,finished,1721082493,1721082551,A100-SXM4-80GB,8,1,64,896,19,58
a64920a5-9197-493d-8019-39bfaaf4d9a8,qwen1-14B,1721082631,1721082728,finished,1721082650,1721082728,A100-SXM4-80GB,8,1,64,896,19,78
85e49ccd-b3c9-46ac-a7ce-bd8d9a8eb3ce,qwen1-14B,1721082807,1721082885,finished,1721082826,1721082885,A100-SXM4-80GB,8,1,64,896,19,59
9084a7bc-8aca-4563-8e1f-4301d72de827,qwen1-14B,1721082963,1721083042,finished,1721082983,1721083042,A100-SXM4-80GB,8,1,64,896,20,59
1e635872-b0c9-4a5d-b3ff-1138c9468990,qwen1-14B,1721083119,1721083197,finished,1721083138,1721083197,A100-SXM4-80GB,8,1,64,896,19,59
e423ec5d-a752-4e3a-8bc2-a3d8c8d18f78,qwen1-14B,1721083276,1721083354,finished,1721083295,1721083354,A100-SXM4-80GB,8,1,64,896,19,59
bd0a476f-2d23-4787-8047-e946ec5cae00,qwen1-14B,1721083433,1721083511,finished,1721083452,1721083511,A100-SXM4-80GB,8,1,64,896,19,59
f8d6258c-fa4a-41b4-b976-3997b4831a72,qwen1-14B,1721083589,1721083687,finished,1721083609,1721083687,A100-SXM4-80GB,8,1,64,896,20,78
c8b7e7c5-0d1d-4524-8530-9f0382f05d9f,qwen1-14B,1721083766,1721083844,finished,1721083786,1721083844,A100-SXM4-80GB,8,1,64,896,20,58
2ba6924c-986e-4e87-a80a-bce6f5e2e5f9,qwen1-14B,1721083922,1721084000,finished,1721083941,1721084000,A100-SXM4-80GB,8,1,64,896,19,59
90158873-d6ee-4d06-bb75-02bfb6211317,qwen1-14B,1721084078,1721084158,finished,1721084098,1721084158,A100-SXM4-80GB,8,1,64,896,20,60
a9a8bac9-c330-4216-bcee-5a2f4f44e7b0,qwen1-14B,1721084237,1721084315,finished,1721084257,1721084315,A100-SXM4-80GB,8,1,64,896,20,58
798c1705-428c-4bf9-bd89-265cc404bd09,qwen1-14B,1721084392,1721084470,finished,1721084412,1721084470,A100-SXM4-80GB,8,1,64,896,20,58
a0cbe624-e7a6-41ae-834a-b4cd29e62cd9,qwen1-14B,1721084549,1721084629,finished,1721084569,1721084629,A100-SXM4-80GB,8,1,64,896,20,60
4ef0dbb6-a786-4341-81e0-1445a153bc22,qwen1-14B,1721084707,1721084785,finished,1721084726,1721084785,A100-SXM4-80GB,8,1,64,896,19,59
d2a443cd-f2f9-42f1-90e1-935e7daac63b,qwen1-14B,1721084863,1721084960,finished,1721084883,1721084960,A100-SXM4-80GB,8,1,64,896,20,77
d773eb10-3a73-44d4-9bd2-caa72341f7c3,qwen1-14B,1721085037,1721085114,finished,1721085056,1721085114,A100-SXM4-80GB,8,1,64,896,19,58
f30ef1fa-f054-48c9-ad12-8f34c97576a7,qwen1-14B,1721085192,1721085269,finished,1721085211,1721085269,A100-SXM4-80GB,8,1,64,896,19,58
4c4d0f62-a69e-4903-b6d1-3bc7292a727e,qwen1-14B,1721085347,1721085425,finished,1721085367,1721085425,A100-SXM4-80GB,8,1,64,896,20,58
e430d327-f2d7-4544-84e0-585820f2feba,qwen1-14B,1721085503,1721085581,finished,1721085522,1721085581,A100-SXM4-80GB,8,1,64,896,19,59
9a7977b8-adf2-4eb3-b662-29cd745d791e,qwen1-14B,1721085660,1721085737,finished,1721085680,1721085737,A100-SXM4-80GB,8,1,64,896,20,57
4cebeb01-ee52-4dd9-ad47-95c72dd5c0cc,qwen1-14B,1721085815,1721085894,finished,1721085835,1721085894,A100-SXM4-80GB,8,1,64,896,20,59
23286a02-75c9-4cbe-b868-f2644f16a31b,qwen1-14B,1721085974,1721086053,finished,1721085993,1721086053,A100-SXM4-80GB,8,1,64,896,19,60
7f0898ef-18ca-43fc-947e-769233a2cb59,qwen1-14B,1721086131,1721086208,finished,1721086150,1721086208,A100-SXM4-80GB,8,1,64,896,19,58
15588402-4244-408b-9a0b-bb92f201ef72,qwen1-14B,1721086287,1721086385,finished,1721086306,1721086385,A100-SXM4-80GB,8,1,64,896,19,79
9dd0d612-d130-4a9f-9b33-fcc4a7eed64e,qwen1-14B,1721086464,1721086543,finished,1721086483,1721086543,A100-SXM4-80GB,8,1,64,896,19,60
75c072ea-7c5a-440d-8a44-b34937b5946a,qwen1-14B,1721086621,1721086698,finished,1721086640,1721086698,A100-SXM4-80GB,8,1,64,896,19,58
5dc88dd1-36e9-4567-bfb9-8fa18ced5692,qwen1-14B,1721086777,1721086855,finished,1721086797,1721086855,A100-SXM4-80GB,8,1,64,896,20,58
459ff47b-05c5-4f93-ab01-f45f79e1c182,qwen1-14B,1721086933,1721087010,finished,1721086953,1721087010,A100-SXM4-80GB,8,1,64,896,20,57
bd846be8-a230-420a-9a2b-56078979d884,qwen1-14B,1721087089,1721087187,finished,1721087109,1721087187,A100-SXM4-80GB,8,1,64,896,20,78
7c47f238-5015-48b6-a08c-08ec784e6dd2,qwen1-14B,1721087266,1721087345,finished,1721087286,1721087345,A100-SXM4-80GB,8,1,64,896,20,59
7a57f510-8663-46ad-997f-dbcff022d1f6,qwen1-14B,1721087423,1721087501,finished,1721087443,1721087501,A100-SXM4-80GB,8,1,64,896,20,58
56ee0785-3d88-4a9b-af41-35e5ea833cea,qwen1-14B,1721087580,1721087680,finished,1721087600,1721087680,A100-SXM4-80GB,8,1,64,896,20,80
a40633c8-8b44-405e-b6c2-bfc47f5b5296,qwen1-14B,1721087758,1721087856,finished,1721087778,1721087856,A100-SXM4-80GB,8,1,64,896,20,78
81be0be3-2c47-4ad7-a99c-d1cc7346865a,qwen1-14B,1721087935,1721088014,finished,1721087954,1721088014,A100-SXM4-80GB,8,1,64,896,19,60
c32e6f20-1e5a-4500-aeef-2599694ce6cc,qwen1-14B,1721088094,1721088173,finished,1721088114,1721088173,A100-SXM4-80GB,8,1,64,896,20,59
4db24d3a-4e75-40e1-954c-5835abb09c9e,qwen1-14B,1721088250,1721088327,finished,1721088269,1721088327,A100-SXM4-80GB,8,1,64,896,19,58
e2f54550-66b3-4845-853f-459cbb8102f7,qwen1-14B,1721088404,1721088484,finished,1721088424,1721088484,A100-SXM4-80GB,8,1,64,896,20,60
34c585c3-19f5-4beb-a587-dfaf3eb64d53,qwen1-14B,1721088562,1721088661,finished,1721088582,1721088661,A100-SXM4-80GB,8,1,64,896,20,79
c335d82a-58d1-4822-bea4-eb1004cfd9a8,qwen1-14B,1721088739,1721088818,finished,1721088759,1721088818,A100-SXM4-80GB,8,1,64,896,20,59
4fc29912-9566-46e4-a403-4625827e2438,qwen1-14B,1721088896,1721088975,finished,1721088916,1721088975,A100-SXM4-80GB,8,1,64,896,20,59
9d11d4e7-460c-4345-a849-29f35686a71a,qwen1-14B,1721089054,1721089132,finished,1721089073,1721089132,A100-SXM4-80GB,8,1,64,896,19,59
868eaeff-cf7c-4e68-8417-e1b79894e983,qwen1-14B,1721089211,1721089288,finished,1721089230,1721089288,A100-SXM4-80GB,8,1,64,896,19,58
aec311a3-ad9f-4b91-962f-90e4f194ccdb,qwen1-14B,1721089366,1721089444,finished,1721089386,1721089444,A100-SXM4-80GB,8,1,64,896,20,58
1fad41c2-1f63-4f53-8542-58398670c902,qwen1-14B,1721089524,1721089602,finished,1721089544,1721089602,A100-SXM4-80GB,8,1,64,896,20,58
9afd8d68-b8ff-43b8-8ce0-4dc179820c3e,qwen1-14B,1721089680,1721089758,finished,1721089700,1721089758,A100-SXM4-80GB,8,1,64,896,20,58
921f36c2-5a87-44e8-9d05-20c8996a6b42,qwen1-14B,1721089834,1721089913,finished,1721089854,1721089913,A100-SXM4-80GB,8,1,64,896,20,59
421feee5-ec0e-4c0e-bff1-508ba41de8c2,qwen1-14B,1721089992,1721090070,finished,1721090012,1721090070,A100-SXM4-80GB,8,1,64,896,20,58
e2c4283e-c8eb-464b-9374-b94aa4179a50,qwen1-14B,1721090149,1721090227,finished,1721090168,1721090227,A100-SXM4-80GB,8,1,64,896,19,59
bd17560d-48e8-4be2-9eaf-86d7ec98efc5,qwen1-14B,1721090304,1721090382,finished,1721090324,1721090382,A100-SXM4-80GB,8,1,64,896,20,58
cef4cfbb-fa95-426a-9f9d-ab5125b0554e,qwen1-14B,1721090461,1721090539,finished,1721090480,1721090539,A100-SXM4-80GB,8,1,64,896,19,59
e29f91c0-c5af-4f1b-a51f-2bb26a2afb07,qwen1-14B,1721090617,1721090694,finished,1721090636,1721090694,A100-SXM4-80GB,8,1,64,896,19,58
07e342f7-d3ea-4766-ab66-16bc254bcf97,qwen1-14B,1721090771,1721090848,finished,1721090790,1721090848,A100-SXM4-80GB,8,1,64,896,19,58
6c7bb162-50fd-4985-bfb6-07459977e183,qwen1-14B,1721090927,1721091024,finished,1721090947,1721091024,A100-SXM4-80GB,8,1,64,896,20,77
d4723e5e-c552-4bc1-823c-c8d933ad21dd,qwen1-14B,1721091101,1721091178,finished,1721091121,1721091178,A100-SXM4-80GB,8,1,64,896,20,57
9dbe2e0b-e1ee-49eb-b80c-1feb871f0a3f,qwen1-14B,1721091259,1721091337,finished,1721091278,1721091337,A100-SXM4-80GB,8,1,64,896,19,59
04b9d01f-41ff-460c-b2ae-389b460c2bc2,qwen1-14B,1721091415,1721091493,finished,1721091434,1721091493,A100-SXM4-80GB,8,1,64,896,19,59
ab3a568a-92b5-4b8d-8a3d-e646402a3a5d,qwen1-14B,1721091570,1721091648,finished,1721091589,1721091648,A100-SXM4-80GB,8,1,64,896,19,59
d43aa489-200e-46db-bcc9-d657241f701d,qwen1-14B,1721091727,1721091809,finished,1721091748,1721091809,A100-SXM4-80GB,8,1,64,896,21,61
613bd136-39ca-4fc6-9134-95f05611bf04,qwen1-14B,1721091887,1721091967,finished,1721091907,1721091967,A100-SXM4-80GB,8,1,64,896,20,60
3389ee61-cee4-4b3b-8b78-d6e589a02016,gpt-megatron,1721091944,1721093190,finished,1721092003,1721093190,A100-SXM4-80GB,8,4,64,448,59,1187
3fcd3ff2-7358-4a39-889d-62ba05f42bcf,qwen1-14B,1721092047,1721092147,finished,1721092067,1721092147,A100-SXM4-80GB,8,1,64,896,20,80
3749ca10-7955-4ece-b4cf-373658f837d2,DeepSeek-V2-Chat-shumo-7e45b-auto,1721092092,1721093848,finished,1721092112,1721093848,A100-SXM4-80GB,8,1,64,896,20,1736
05c83463-d08a-4ee1-969c-8a555df8de99,qwen1-14B,1721092227,1721092306,finished,1721092246,1721092306,A100-SXM4-80GB,8,1,64,896,19,60
7285275b-b423-4b34-a38e-7885abb276e7,debug,1721092266,1721099546,finished,1721092286,1721099546,A100-SXM4-80GB,8,1,64,896,20,7260
39fe3b4d-fe58-4014-bc0c-027dcb9faf08,qwen1-14B,1721092384,1721092481,finished,1721092403,1721092481,A100-SXM4-80GB,8,1,64,896,19,78
4b5e4199-f866-410e-80a4-449126df046a,qwen1-14B,1721092561,1721092640,finished,1721092581,1721092640,A100-SXM4-80GB,8,1,64,896,20,59
96e0b1db-8f0a-459a-b97a-743bb327b5eb,qwen1-14B,1721092719,1721092798,finished,1721092739,1721092798,A100-SXM4-80GB,8,1,64,896,20,59
d77def51-a15c-4305-a567-7a6402446e13,qwen1-14B,1721092877,1721092955,finished,1721092896,1721092955,A100-SXM4-80GB,8,1,64,896,19,59
ef505917-3a21-45db-8663-84e3e7b74d67,llm-train,1721092897,1721094228,finished,1721092916,1721094228,A100-SXM4-80GB,8,1,64,896,19,1312
875c0a59-0900-4815-9ebe-01792ccdb4e6,qwen1-14B,1721093034,1721093113,finished,1721093053,1721093113,A100-SXM4-80GB,8,1,64,896,19,60
50e9589d-0dc6-4bc7-addb-baf3d1334365,geogpt-sft-finetune-eval-yxs,1721093121,1721115304,finished,1721093141,1721115304,A100-SXM4-80GB,8,1,64,896,20,22163
b9e3c321-dd9a-4cde-b6de-a22e6539b9d1,qwen1-14B,1721093194,1721093273,finished,1721093214,1721093273,A100-SXM4-80GB,8,1,64,896,20,59
b4a37353-21e5-4677-a0aa-2d769ba6617a,geogpt-qwen15-moe-alpaca-sft,1721093350,1721094123,finished,1721093371,1721094123,A100-SXM4-80GB,8,1,64,448,21,752
9659f783-2274-4842-bccc-b7c8ab7e13bf,qwen1-14B,1721093354,1721093440,finished,1721093375,1721093440,A100-SXM4-80GB,8,1,64,896,21,65
dd8cff1c-a66c-46eb-999d-205298d18310,sfr-ft-2,1721093373,1721095341,finished,1721093393,1721095341,A100-SXM4-80GB,8,1,64,448,20,1948
778c99ec-e72c-4aa6-88ee-1b76dccb2dab,llamafactory-zj-test-cpt-cg,1721093417,1721094086,finished,1721093481,1721094086,A100-SXM4-80GB,8,4,64,896,64,605
af6c9087-fe83-4db9-a581-c032ed4b71eb,llamafactory-zj-test-cpt,1721093417,1721094086,finished,1721093459,1721094086,A100-SXM4-80GB,8,4,64,896,42,627
8098fdaa-43f7-42dd-9283-e44709a6a42a,gpt-megatron,1721093456,1721698616,finished,1721093519,1721698616,A100-SXM4-80GB,8,8,64,448,63,605097
de5958a8-bdd7-460b-922f-33fd800ed2e3,linux-env,1721093461,1721093583,finished,1721093482,1721093583,A100-SXM4-80GB,8,1,64,448,21,101
ead503d9-c223-4a83-99b5-62e55e9186df,qwen1-14B,1721093525,1721093646,finished,1721093544,1721093646,A100-SXM4-80GB,8,1,64,896,19,102
a85f30b9-eebe-49fb-a5e9-b67e5e592743,llama-actsave,1721093565,1721112441,finished,1721093585,1721112441,A100-SXM4-80GB,8,1,64,448,20,18856
b6aefae3-f09b-487f-9f8d-25968d8eeef5,qwen1-14B,1721093726,1721093825,finished,1721093745,1721093825,A100-SXM4-80GB,8,1,64,896,19,80
33f678f9-a0c5-4830-ae2b-4e9fa4810f5b,DeepSeek-V2-Chat-shumo-7e45b-auto,1721093848,1721094092,finished,1721093869,1721094092,A100-SXM4-80GB,8,1,64,896,21,223
70ba5f23-240e-4f3b-b75a-43b410bc30a3,qwen1-14B,1721093906,1721093986,finished,1721093926,1721093986,A100-SXM4-80GB,8,1,64,896,20,60
fb84346c-5d8d-40cb-9c4d-7d2789f03496,qwen1-14B,1721094068,1721094146,finished,1721094088,1721094146,A100-SXM4-80GB,8,1,64,896,20,58
c30d1e80-ed14-41a6-b1e9-1ada41b46bc4,DeepSeek-V2-Chat-shumo-7e45b-auto,1721094170,1721097902,finished,1721094191,1721097902,A100-SXM4-80GB,8,1,64,896,21,3711
7a44384b-6a95-44f6-93de-32aa806d1d92,qwen1-14B,1721094228,1721094307,finished,1721094248,1721094307,A100-SXM4-80GB,8,1,64,896,20,59
3045e22b-72f7-4482-9f67-27a7a6559120,qwen1-14B,1721094385,1721094464,finished,1721094405,1721094464,A100-SXM4-80GB,8,1,64,896,20,59
e9b8e207-fa6f-435b-b9d6-93018c570082,qwen1-14B,1721094544,1721094623,finished,1721094564,1721094623,A100-SXM4-80GB,8,1,64,896,20,59
e4a3bc30-5d52-408c-a167-0575ac442906,qwen1-14B,1721094702,1721094779,finished,1721094721,1721094779,A100-SXM4-80GB,8,1,64,896,19,58
d0f4d33a-985e-4cc7-9258-2b0fd3d2be41,qwen1-14B,1721094859,1721094940,finished,1721094879,1721094940,A100-SXM4-80GB,8,1,64,896,20,61
a653ed2c-3b31-4b43-8e93-973cf873106d,qwen1-14B,1721095019,1721095098,finished,1721095039,1721095098,A100-SXM4-80GB,8,1,64,896,20,59
c58563f2-5093-4902-9a02-1da595fa6ef2,qwen1-14B,1721095181,1721095263,finished,1721095201,1721095263,A100-SXM4-80GB,8,1,64,896,20,62
8249fdb4-ea64-4664-b95b-2846fdc22a14,sfr-ft-3,1721095301,1721377780,finished,1721095321,1721377780,A100-SXM4-80GB,8,1,64,448,20,282459
abc1b34f-5ea7-4156-9a70-d2badf2874a7,qwen1-14B,1721095343,1721095423,finished,1721095363,1721095423,A100-SXM4-80GB,8,1,64,896,20,60
4d68622e-4065-42a4-ab99-557658f7ac28,geogpt-qwen15-moe-alpaca-sft,1721095419,1721098617,finished,1721095440,1721098617,A100-SXM4-80GB,8,1,64,448,21,3177
653b4218-ac70-4b8d-b042-24eb2c4a8bf6,qwen1-14B,1721095504,1721095582,finished,1721095524,1721095582,A100-SXM4-80GB,8,1,64,896,20,58
bf8342e5-4b2a-4647-8eff-373c68ae908c,qwen1-14B,1721095660,1721095740,finished,1721095680,1721095740,A100-SXM4-80GB,8,1,64,896,20,60
8d65e831-90ba-4322-b2d5-6a0f41f4b821,qwen1-14B,1721095821,1721095899,finished,1721095840,1721095899,A100-SXM4-80GB,8,1,64,896,19,59
325dbad5-b46d-4977-a93e-c8bdb8bd262a,linux-env,1721095977,1721096099,finished,1721095997,1721096099,A100-SXM4-80GB,8,1,64,448,20,102
2cdefef8-c1f0-4596-b899-24bd1735cfb7,qwen1-14B,1721095978,1721096057,finished,1721095998,1721096057,A100-SXM4-80GB,8,1,64,896,20,59
12054769-6d45-4a26-9843-70d1e4264724,llamafactory-zj-test-cpt-cg,1721096119,1721096900,finished,1721096181,1721096900,A100-SXM4-80GB,8,4,64,896,62,719
65d3f924-97af-42ee-b181-1aa04f85a39b,llamafactory-zj-test-cpt,1721096119,1721096900,finished,1721096160,1721096900,A100-SXM4-80GB,8,4,64,896,41,740
19c197b0-724b-438d-b7d4-47ed652a32c5,qwen1-14B,1721096121,1721096202,finished,1721096142,1721096202,A100-SXM4-80GB,8,1,64,896,21,60
a86bdab2-da04-4299-9ef7-ae011be6dfd9,linux-env,1721096161,1721097039,finished,1721096181,1721097039,A100-SXM4-80GB,8,1,64,448,20,858
80ec2e12-4be1-4c24-97e6-225fd3daaa2b,qwen1-14B,1721096281,1721096361,finished,1721096301,1721096361,A100-SXM4-80GB,8,1,64,896,20,60
c339dd87-0628-4231-973f-0bd61ad8b91c,qwen1-14B,1721096440,1721096519,finished,1721096460,1721096519,A100-SXM4-80GB,8,1,64,896,20,59
2f52bec8-0ce6-4984-93cb-8f36d7ab4845,qwen1-14B,1721096599,1721096681,finished,1721096620,1721096681,A100-SXM4-80GB,8,1,64,896,21,61
c7801c3f-253b-4e8d-841c-feff32c13e35,training-data-processing,1721096677,1721181013,finished,1721096698,1721181013,A100-SXM4-80GB,4,1,32,448,21,84315
1691f2d1-4e69-4024-a616-6e0e5e09f911,qwen1-14B,1721096762,1721096841,finished,1721096782,1721096841,A100-SXM4-80GB,8,1,64,896,20,59
0f8143f9-937e-4a90-897b-b826df584d4d,geo-mod-05b-test,1721096884,1721104866,finished,1721103743,1721104866,A100-SXM4-80GB,8,1,64,448,6859,1123
e2b5d30c-67ff-42b2-8807-7e9c9c008240,qwen1-14B,1721096922,1721097021,finished,1721096942,1721097021,A100-SXM4-80GB,8,1,64,896,20,79
17dc22b4-863e-468a-8019-f9c21e8ecea7,linux-env,1721097039,1721097104,finished,1721097060,1721097104,A100-SXM4-80GB,8,1,64,448,21,44
92d7cb6b-4368-434b-a79e-57edb855ffac,llamafactory-zj-test-cpt-cg,1721097082,1721097293,finished,1721097145,1721097293,A100-SXM4-80GB,8,4,64,896,63,148
ad17b20e-99ca-454d-829b-4bfaec56699e,qwen1-14B,1721097085,1721097168,finished,1721097106,1721097168,A100-SXM4-80GB,8,1,64,896,21,62
f2d5cc54-dc6c-4307-a17d-b8e123c5566d,llamafactory-zj-test-cpt,1721097104,1721097293,finished,1721097145,1721097293,A100-SXM4-80GB,8,4,64,896,41,148
fbe2328f-c033-46ec-a9bf-04358d2009c1,qwen1-14B,1721097251,1721097335,finished,1721097274,1721097335,A100-SXM4-80GB,8,1,64,896,23,61
de808e72-a919-43fb-9359-bb084447b370,citysora-cele-ppm-cosmic-from-200k256-lr5em6,1721097255,1721116708,finished,1721097337,1721116708,A100-SXM4-80GB,8,4,64,896,82,19371
20e5134f-775d-48b8-8784-606893120d5f,qwen1-14B,1721097414,1721097496,finished,1721097435,1721097496,A100-SXM4-80GB,8,1,64,896,21,61
15fc7408-6e30-4923-8611-fda9f9b3fd5c,qwen1-14B,1721097578,1721097658,finished,1721097598,1721097658,A100-SXM4-80GB,8,1,64,896,20,60
e13706f0-c621-44f8-af7b-19402ca85485,qwen1-14B,1721097738,1721097817,finished,1721097757,1721097817,A100-SXM4-80GB,8,1,64,896,19,60
796fa168-f3df-4184-8bfb-88576d690f88,qwen1-14B,1721097898,1721097978,finished,1721097919,1721097978,A100-SXM4-80GB,8,1,64,896,21,59
4c88ad7d-f717-41da-b2aa-5c6eda849f6d,DeepSeek-V2-Chat-shumo-7e45b-auto,1721097902,1721098101,finished,1721097923,1721098101,A100-SXM4-80GB,8,1,64,896,21,178
7eed3df0-be7c-44be-9e32-3c207964e186,qwen1-14B,1721098056,1721098138,finished,1721098076,1721098138,A100-SXM4-80GB,8,1,64,896,20,62
d21d984a-5218-489d-9d0c-013459762da8,DeepSeek-V2-Chat-shumo-7e45b-auto,1721098143,1721099512,finished,1721098165,1721099512,A100-SXM4-80GB,8,1,64,896,22,1347
0e02611a-db9e-4033-b606-bd65030b994b,qwen1-14B,1721098222,1721098321,finished,1721098242,1721098321,A100-SXM4-80GB,8,1,64,896,20,79
4d686104-df4f-4831-85e8-b3e0860b023c,qwen1-14B,1721098400,1721098481,finished,1721098420,1721098481,A100-SXM4-80GB,8,1,64,896,20,61
161bc5bb-f6fb-45af-a4f2-5963186ad5c7,qwen1-14B,1721098561,1721098641,finished,1721098581,1721098641,A100-SXM4-80GB,8,1,64,896,20,60
11805768-f5bf-4f6f-a5b8-f3b6122eeb33,qwen1-14B,1721098721,1721098802,finished,1721098741,1721098802,A100-SXM4-80GB,8,1,64,896,20,61
4eb3f1f3-c57e-49e4-93f6-a8c70403f70d,qwen1-14B,1721098883,1721098966,finished,1721098903,1721098966,A100-SXM4-80GB,8,1,64,896,20,63
bab1923c-4eba-4b0c-9e43-364c34cdb890,llamafactory-zj-test-cpt,1721098965,1721099244,finished,1721099024,1721099244,A100-SXM4-80GB,8,4,64,896,59,220
f0b29e23-b269-4668-89e9-f01d38337b92,llamafactory-zj-test-cpt-cg,1721098965,1721099244,finished,1721099024,1721099244,A100-SXM4-80GB,8,4,64,896,59,220
8bbe48a4-2328-4e97-b718-dd67c3bd76a0,qwen1-14B,1721099047,1721099146,finished,1721099067,1721099146,A100-SXM4-80GB,8,1,64,896,20,79
d6b1e253-9407-4ceb-a667-890535cda932,geogpt-ultrafuser-direct-eval,1721099071,1721144294,finished,1721099092,1721144294,A100-SXM4-80GB,8,1,64,448,21,45202
023d897b-96e7-42b2-9e01-86f4f23ed3bd,qwen1-14B,1721099225,1721099307,finished,1721099246,1721099307,A100-SXM4-80GB,8,1,64,896,21,61
82d13a71-831a-4937-a29b-19969113292a,geogpt-cot-train-cp-d1,1721099274,1721108490,finished,1721099336,1721108490,A100-SXM4-80GB,8,4,64,896,62,9154
25df421a-aaa7-4814-9e99-8cb28d21bdc7,qwen1-14B,1721099390,1721099469,finished,1721099410,1721099469,A100-SXM4-80GB,8,1,64,896,20,59
488d4259-4333-4046-8114-0c95e676476c,qwen1-14B,1721099546,1721099623,finished,1721099566,1721099623,A100-SXM4-80GB,8,1,64,896,20,57
793e86cc-ae47-4557-b49d-d2f3efdbb834,qwen1-14B,1721099700,1721099797,finished,1721099720,1721099797,A100-SXM4-80GB,8,1,64,896,20,77
4dd7e67a-918f-4bca-ba66-cca9eaf9c801,geogpt-dairui-model-merge-exp-2,1721099860,1721104604,finished,1721104231,1721104604,A100-SXM4-80GB,8,1,64,448,4371,373
6cf54e9f-a629-43a1-a574-f293ec334ec7,qwen1-14B,1721099877,1721099955,finished,1721099897,1721099955,A100-SXM4-80GB,8,1,64,896,20,58
34d1ce21-f451-418d-a789-e25abcd6da0d,qwen1-14B,1721100034,1721100111,finished,1721100053,1721100111,A100-SXM4-80GB,8,1,64,896,19,58
1123999d-172f-4c57-bb3f-1c0db56747e5,qwen1-14B,1721100190,1721100291,finished,1721100210,1721100291,A100-SXM4-80GB,8,1,64,896,20,81
1d8519a2-b3de-4f8d-951d-c517b82290c0,sfr-ft-4,1721100369,1721100528,finished,1721100390,1721100528,A100-SXM4-80GB,8,1,64,448,21,138
a4e2247a-4a96-4d7d-9564-28062cca2cd8,citysora-modelv4-cele-65-512-5k512-lr5m-6,1721100555,1721112505,finished,1721100675,1721112505,A100-SXM4-80GB,8,4,64,896,120,11830
a78a2193-b7bf-4cff-b59d-d6bbb3764d04,linux-env,1721100731,1721100841,finished,1721100753,1721100841,A100-SXM4-80GB,8,1,64,448,22,88
d7c0bd97-76ac-4578-bddf-df555ae9ecbc,geogpt-lxz-2-9m-mix-data-3ep-llama3-8b,1721100737,1721198638,finished,1721100798,1721198638,A100-SXM4-80GB,8,16,64,448,61,97840
88ef51b3-693e-43aa-a34a-b52bab8ba4c0,llamafactory-zj-test-cpt,1721100841,1721104364,finished,1721100881,1721104364,A100-SXM4-80GB,8,4,64,896,40,3483
2a573381-91a2-4dcb-a34e-7a7d9af5b74f,train-0716,1721100940,1721101707,finished,1721100960,1721101707,A100-SXM4-80GB,8,1,64,896,20,747
ed26192f-977b-4f6b-a0ab-d209fd4c746c,linux-env,1721101021,1721101140,finished,1721101040,1721101140,A100-SXM4-80GB,8,1,64,448,19,100
94154977-2622-4c62-bc6b-fd68816ec0bb,geogpt-prompt-tuning-tg-infer3,1721101252,1721110287,finished,1721101272,1721110287,A100-SXM4-80GB,8,1,64,448,20,9015
b2b610f7-4ceb-4497-ad1b-a9b79e2faab0,geogpt-s2-base-eval,1721101776,1721150887,finished,1721101797,1721150887,A100-SXM4-80GB,8,1,64,448,21,49090
d9412a57-571e-4724-96a6-919fd6eca542,train-0716,1721101787,1721138701,finished,1721101807,1721138701,A100-SXM4-80GB,8,1,64,896,20,36894
5acc30a7-8dc3-4572-9595-08c695f5aa17,geogpt-s2-base-eval-c,1721101837,1721308865,finished,1721101857,1721308865,A100-SXM4-80GB,8,1,64,448,20,207008
831ad010-b835-4608-a001-2197ff0d0cf6,geogpt-lxz-2-9m-mix-data-qwen1-5-14b,1721103765,1721116196,finished,1721103827,1721116196,A100-SXM4-80GB,8,32,64,448,62,12369
0edf3f4f-6e10-454e-878e-0d6dc6609b05,geogpt-cot-eval-cp-r1,1721104433,1721104929,finished,1721104454,1721104929,A100-SXM4-80GB,8,1,64,896,21,475
088a0ce4-c04c-4db7-add3-90d1f3584c48,marker-xiaodian,1721104441,1721700730,finished,1721104461,1721700730,A100-SXM4-80GB,8,1,64,896,20,596269
4c5515cb-59cb-4e09-9ecd-e2689f709eae,sp-3-dp-0612-cf68f-auto,1721104685,1721106704,finished,1721104707,1721106704,A100-SXM4-80GB,8,1,64,448,22,1997
009caf2b-9ffc-43cd-9ae4-c9f338dfce67,sp-5-dp-0612-2425c-auto,1721104686,1721106840,finished,1721104707,1721106840,A100-SXM4-80GB,8,1,64,448,21,2133
38c29e2b-34df-429a-9543-6f25739b8c2c,tqme-vllm-base,1721104992,1721111194,finished,1721105013,1721111194,A100-SXM4-80GB,8,1,64,448,21,6181
e1aa6c6e-adec-404a-a4e7-2d559fa0e6cd,geogpt-cot-eval-cp-r1,1721105091,1721108531,finished,1721105110,1721108531,A100-SXM4-80GB,8,1,64,896,19,3421
5c327a55-2642-4eff-9a65-2f6c09d4091a,sp-8-dp-q72b-chat-5ce90-auto,1721106030,1721108207,finished,1721106050,1721108207,A100-SXM4-80GB,8,1,64,448,20,2157
a9274c78-415a-4ce6-a95f-3a4b4570e58a,sp-9-dp-q72b-chat-4b7be-auto,1721106051,1721108188,finished,1721106072,1721108188,A100-SXM4-80GB,8,1,64,448,21,2116
ec85e331-9032-45a3-b3c2-2e2d52713c76,sp-10-18-dp-q72b-chat-f235b-auto,1721106131,1721108228,finished,1721106151,1721108228,A100-SXM4-80GB,8,1,64,448,20,2077
e5a5ebe4-e84b-471b-a211-d70ac6748e8b,linux-env-cp,1721106186,1721108998,finished,1721106206,1721108998,A100-SXM4-80GB,8,1,64,448,20,2792
2e8f2ae5-b76e-4bfa-8473-fe5641978bd9,geogpt-distillation-mozhu,1721107736,1721110605,finished,1721110306,1721110605,A100-SXM4-80GB,8,1,64,896,2570,299
7afe6d33-2f11-4a31-bb9c-a1f996f3d530,qwen2-72b-0612-dpo-31b01-auto,1721107870,1721109941,finished,1721107891,1721109941,A100-SXM4-80GB,8,1,64,448,21,2050
363a2d55-984b-4c7b-86ab-b250469b3c4f,q72b-chat-c93d7-auto,1721108229,1721110340,finished,1721108249,1721110340,A100-SXM4-80GB,8,1,64,448,20,2091
0b1fddf9-ed43-46c6-9414-f25b23afb44b,geogpt-cot-eval-cp-r1,1721108844,1721117627,finished,1721108865,1721117627,A100-SXM4-80GB,8,1,64,896,21,8762
770ad21a-9a22-495c-8f1f-8043481ce55b,lf-sft-32k-2nodes,1721108877,1721109196,finished,1721108938,1721109196,A100-SXM4-80GB,8,2,64,448,61,258
81ca3d3b-873d-4657-973f-06b88ec6809a,linux-env-cp,1721108998,1721109608,finished,1721109018,1721109608,A100-SXM4-80GB,8,1,64,448,20,590
2e1f45da-babe-4ef9-855d-7196be9738c1,geogpt-qwen15-moe-alpaca-sft,1721109172,1721116428,finished,1721109194,1721116428,A100-SXM4-80GB,8,1,64,448,22,7234
8097cb7e-109d-4331-bdf1-53a689236dc8,lf-sft-32k-2nodes,1721109196,1721110555,finished,1721109239,1721110555,A100-SXM4-80GB,8,2,64,448,43,1316
d3876fad-bec4-4d85-836b-e66a9e50d243,sp-35-10-12-dp-0612-036f5-auto,1721109204,1721111366,finished,1721109224,1721111366,A100-SXM4-80GB,8,1,64,448,20,2142
03f82e75-c17e-47b0-8638-1863960d4f2b,sp-35-0-12-dp-0612-34277-auto,1721109308,1721111536,finished,1721109330,1721111536,A100-SXM4-80GB,8,1,64,448,22,2206
8c6423b1-a377-4241-8530-c8ded101828e,sp-35-0-15-dp-0612-4b5d3-auto,1721109392,1721111774,finished,1721109412,1721111774,A100-SXM4-80GB,8,1,64,448,20,2362
5e3eb53b-8a30-4da3-a473-172c18754edb,linux-env-cp,1721109608,1721182060,finished,1721109632,1721182060,A100-SXM4-80GB,8,1,64,448,24,72428
c1688a46-b1f8-4949-81e2-576317659233,qwen1-5-14b-10bcpt-1ep-7e49b-auto,1721109642,1721141215,finished,1721109663,1721141215,A100-SXM4-80GB,8,1,64,448,21,31552
32de3e3b-891b-4c9a-a48a-dbe422fa03be,ragas-eval-0716,1721109973,1721822937,finished,1721109993,1721822937,A100-SXM4-80GB,8,1,64,896,20,712944
9ae379f9-63ce-4771-86d7-c074b7c1c8d7,debug,1721110357,1721114041,finished,1721110376,1721114041,A100-SXM4-80GB,8,1,64,896,19,3665
8bd1d1a2-96b8-4048-bd8e-05b05335adda,sfr-ft-4,1721110634,1721110956,finished,1721110654,1721110956,A100-SXM4-80GB,8,1,64,448,20,302
6b822444-e3eb-42c7-a3bb-34f2baf683f2,sfr-ft-2,1721110634,1721110816,finished,1721110654,1721110816,A100-SXM4-80GB,8,1,64,448,20,162
1d239275-372c-44ea-a51e-1d2870e47e7a,sp-35-10-15-dp-0612-e2f07-auto,1721110904,1721113213,finished,1721110924,1721113213,A100-SXM4-80GB,8,1,64,448,20,2289
0d68714e-8fef-4bc1-9e1f-d136270714a7,geogpt-distillation-mozhu,1721111010,1721111093,finished,1721111031,1721111093,A100-SXM4-80GB,8,1,64,896,21,62
e98db817-1f4d-4dc9-a648-a2cc2c4a4528,sp-chat-dp-0612dpo-linear-w55-5050d-auto,1721111368,1721113507,finished,1721111390,1721113507,A100-SXM4-80GB,8,1,64,448,22,2117
3a224a17-0dab-43ed-82b7-71742dce8773,geogpt-eval-common-latest,1721111411,1721189197,finished,1721111431,1721189197,A100-SXM4-80GB,8,1,64,896,20,77766
9d2cd82f-e51e-4521-ad48-013f443554ae,sfr-ft-4,1721111467,1721111748,finished,1721111487,1721111748,A100-SXM4-80GB,8,1,64,448,20,261
82c9a15e-5b70-4d27-b532-782125a0fc53,geogpt-distillation-mozhu,1721111520,1721111602,finished,1721111542,1721111602,A100-SXM4-80GB,8,1,64,896,22,60
f9ca8282-7019-4a05-9708-220d8c4dca67,lf-sft-32k-2nodes,1721111710,1721113087,finished,1721111748,1721113087,A100-SXM4-80GB,8,2,64,448,38,1339
d846336d-3495-443c-8158-d7a3d6856f96,geogpt-eval-abductive,1721111820,1721113965,finished,1721111841,1721113965,A100-SXM4-80GB,8,1,64,896,21,2124
da5b2230-f4b3-4d64-b3eb-2aa0afead583,sfr-ft-4,1721111932,1721112195,finished,1721111952,1721112195,A100-SXM4-80GB,8,1,64,448,20,243
5562d6e0-0e4d-4b4b-898e-596e2b482186,sfr-ft-2,1721112318,1721112520,finished,1721112339,1721112520,A100-SXM4-80GB,8,1,64,448,21,181
f1245ce9-85f3-44d4-914c-a650d9e065b7,sfr-ft-4,1721112319,1721112580,finished,1721112340,1721112580,A100-SXM4-80GB,8,1,64,448,21,240
6f2f5e04-68b2-464d-8beb-98cb430dfab3,DeepSeek-V2-Chat-shumo-7e45b-auto,1721112326,1721121813,finished,1721112346,1721121813,A100-SXM4-80GB,8,1,64,896,20,9467
594ac827-6224-4da6-96e0-2bd3f28861e1,citysora-modelv4-cele-ppm-65-256-fp,1721112445,1721113172,finished,1721112564,1721113172,A100-SXM4-80GB,8,4,64,896,119,608
4966fd98-471a-4adf-b98b-ad2d633f4f55,llama-actsave,1721112889,1721113129,finished,1721112909,1721113129,A100-SXM4-80GB,8,1,64,448,20,220
1dff0de7-4313-4d8d-819b-3887148dc160,geogpt-distillation-mozhu,1721112898,1721112980,finished,1721112919,1721112980,A100-SXM4-80GB,8,1,64,896,21,61
58a31aa7-cb02-4718-b3d3-06d0dcdd9e58,sfr-ft-4,1721112907,1721113106,finished,1721112927,1721113106,A100-SXM4-80GB,8,1,64,448,20,179
ba7eaa77-8158-408e-825b-ac848119b76b,citysora-modelv4-cele-ppm-65-256-fp,1721113172,1721116583,finished,1721113231,1721116583,A100-SXM4-80GB,8,4,64,896,59,3352
27e711b3-1ff1-4b6e-bdca-b34b287fe2f6,llama-actsave,1721113307,1721113979,finished,1721113327,1721113979,A100-SXM4-80GB,8,1,64,448,20,652
677b2916-4a11-4bdd-9d58-44a60ab42d6f,sfr-ft-4,1721113600,1721114080,finished,1721113620,1721114080,A100-SXM4-80GB,8,1,64,448,20,460
3555f60a-00d5-4a67-aa35-9b2be0453515,tax,1721113712,1721113791,finished,1721113732,1721113791,A100-SXM4-80GB,8,1,64,896,20,59
95d2b0fc-9c3c-4c7f-b25a-240a770a97d0,tax,1721113850,1721113930,finished,1721113870,1721113930,A100-SXM4-80GB,8,1,64,896,20,60
e33f9842-d6ce-4cbd-b0f4-238c7fc7d4cf,tax,1721113992,1721114073,finished,1721114012,1721114073,A100-SXM4-80GB,8,1,64,896,20,61
cbefbbee-0cd9-4e0b-8717-15d0173817d5,llama-actsave,1721114021,1721114273,finished,1721114041,1721114273,A100-SXM4-80GB,8,1,64,448,20,232
e2a12a6b-ac6f-4950-9087-a55f4187a149,geogpt-distillation-mozhu,1721114031,1721114154,finished,1721114051,1721114154,A100-SXM4-80GB,8,1,64,896,20,103
70d013b0-c769-4142-a2db-785fcb38e3c5,tax,1721114134,1721114221,finished,1721114156,1721114221,A100-SXM4-80GB,8,1,64,896,22,65
99060616-c6d2-4697-9c36-5a7b697a8307,geogpt-14b-10bcpt,1721114150,1721302144,finished,1721114191,1721302144,A100-SXM4-80GB,8,8,64,448,41,187953
76551a3c-0805-493b-81d4-0af6ce62ceff,geogpt-14b-10bcpt-freezeembed,1721114193,1721240224,finished,1721114257,1721240224,A100-SXM4-80GB,8,8,64,448,64,125967
e2aaf549-3f72-4254-aae8-944d9a5fd8db,geogpt-14b-5bmath-5bcode,1721114215,1721114439,finished,1721114280,1721114439,A100-SXM4-80GB,8,8,64,448,65,159
fd622aef-cab0-47a2-abbf-1f9c444b834b,tax,1721114287,1721114365,finished,1721114306,1721114365,A100-SXM4-80GB,8,1,64,896,19,59
12428c35-3244-4d0f-91be-1ec619740236,llama-actsave,1721114334,1721114716,finished,1721114353,1721114716,A100-SXM4-80GB,8,1,64,448,19,363
2e2be3d2-77e8-42cb-9062-6560f1b35352,m8x22b-instruct-v01-3f4ba-auto,1721114397,1721118196,finished,1721114417,1721118196,A100-SXM4-80GB,8,1,64,448,20,3779
1eaf7f2f-0ec0-4e98-a00e-d44503ce9f40,tax,1721114424,1721114505,finished,1721114444,1721114505,A100-SXM4-80GB,8,1,64,896,20,61
6cf11085-c6bc-4e78-b357-67f5bf4e3fda,m8x22b-instruct-v01-e26a8-auto,1721114457,1721133961,finished,1721114477,1721133961,A100-SXM4-80GB,8,1,64,448,20,19484
027631eb-7c54-4ecf-b896-3590600fa289,tax,1721114567,1721114646,finished,1721114587,1721114646,A100-SXM4-80GB,8,1,64,896,20,59
4ad24d33-060b-4ade-99c0-2508d26f83c5,tax,1721114707,1721114787,finished,1721114727,1721114787,A100-SXM4-80GB,8,1,64,896,20,60
0c190d7d-d424-4266-a791-81bd057b3e09,llama-actsave,1721114776,1721115017,finished,1721114795,1721115017,A100-SXM4-80GB,8,1,64,448,19,222
125f8c43-105f-421a-9383-aa416c8b43c4,tax,1721114849,1721114927,finished,1721114869,1721114927,A100-SXM4-80GB,8,1,64,896,20,58
d41458f2-cc9c-43b2-85f4-57acf56ec22d,geo-05B-zero3,1721114939,1721115119,finished,1721114958,1721115119,A100-SXM4-80GB,8,1,64,896,19,161
23fbefb0-d7de-41ec-a153-c6a7a628b9d1,tax,1721114988,1721115068,finished,1721115009,1721115068,A100-SXM4-80GB,8,1,64,896,21,59
a72e4cbc-2e28-4ca4-90ef-5bcb0f60d526,llama-actsave,1721115096,1721115336,finished,1721115117,1721115336,A100-SXM4-80GB,8,1,64,448,21,219
e1ba3f03-785b-45a1-ad96-6da14a762826,tax,1721115128,1721115207,finished,1721115148,1721115207,A100-SXM4-80GB,8,1,64,896,20,59
a0f458ca-9b63-4f45-8b3f-612957c4ddda,tax,1721115268,1721115346,finished,1721115289,1721115346,A100-SXM4-80GB,8,1,64,896,21,57
139e9f9b-d194-42e0-8afe-d2e5da8db02e,llama-actsave,1721115374,1721115640,finished,1721115395,1721115640,A100-SXM4-80GB,8,1,64,448,21,245
74307f78-a14d-41c4-972f-b5fcb751b8d7,tax,1721115407,1721115488,finished,1721115428,1721115488,A100-SXM4-80GB,8,1,64,896,21,60
bbcb5256-4eec-4a59-9819-ffb30b2c463f,geogpt-distillation-mozhu,1721115485,1721115944,finished,1721115507,1721115944,A100-SXM4-80GB,8,1,64,896,22,437
2807ce53-2ece-4631-a26e-52a15b5dd5af,tax,1721115551,1721115631,finished,1721115571,1721115631,A100-SXM4-80GB,8,1,64,896,20,60
ee9a654b-7aee-4a0f-9cdc-2d2e0a439f82,sp-chat-dp-0612dpo-ties-w55-150e5-auto,1721115663,1721118071,finished,1721115686,1721118071,A100-SXM4-80GB,8,1,64,448,23,2385
36675440-23bc-4019-bcde-c9326a5a8f0c,tax,1721115693,1721115778,finished,1721115714,1721115778,A100-SXM4-80GB,8,1,64,896,21,64
920c991f-5a06-41e8-89c9-32b60e6fa48c,llamafactory-zj-test-cpt-cg,1721115700,1721118640,finished,1721115742,1721118640,A100-SXM4-80GB,8,4,64,896,42,2898
7be3a386-63ab-4b68-bb62-706d9e848794,sp-chat-dp-0612dpo-linear-w55-9ca91-auto,1721115748,1721118196,finished,1721115770,1721118196,A100-SXM4-80GB,8,1,64,448,22,2426
88793b9b-2a45-4873-91c4-21ab71077d8c,geogpt-14b-5bmath-5bcode,1721115752,1721302713,finished,1721115794,1721302713,A100-SXM4-80GB,8,8,64,448,42,186919
daa0f6c9-b2ca-4594-b426-c6a299f59c84,sp-chat-dp-0612dpo-linear-w55-955b7-auto,1721115770,1721127576,finished,1721115790,1721127576,A100-SXM4-80GB,8,1,64,448,20,11786
91b761f7-a53a-4d3b-b28c-546724905803,sp-chat-dp-0612dpo-ties-w55-23452-auto,1721115791,1721129729,finished,1721118092,1721129729,A100-SXM4-80GB,8,1,64,448,2301,11637
0384c213-b90c-4bb6-bfbf-43149af75a20,geogpt-sft-3-9m-all-llama3-8b,1721115835,1721124216,finished,1721120590,1721124216,A100-SXM4-80GB,8,16,64,448,4755,3626
402a4170-3656-49cd-bb44-42668277a66a,tax,1721115844,1721115925,finished,1721115863,1721115925,A100-SXM4-80GB,8,1,64,896,19,62
bea5b260-aa1a-4e7c-9dbf-7decae10f171,geogpt-prompt-tuning-tg-infer1,1721115964,1721116463,finished,1721115986,1721116463,A100-SXM4-80GB,8,1,64,448,22,477
a2c599c8-9916-4836-9757-bccda1463cde,tax,1721115988,1721116068,finished,1721116008,1721116068,A100-SXM4-80GB,8,1,64,896,20,60
41a7df56-51c1-45de-8cdc-2f05bc21f588,geo-base-e16,1721116125,1721119336,finished,1721116215,1721119336,A100-SXM4-80GB,8,28,64,448,90,3121
5e6e54d7-cea0-40b2-9e33-25ca2f090877,tax,1721116134,1721116236,finished,1721116161,1721116236,A100-SXM4-80GB,8,1,64,896,27,75
1e3af8fd-6656-4ab4-b811-bc60345ab16e,llama-actsave,1721116170,1721116732,finished,1721116192,1721116732,A100-SXM4-80GB,8,1,64,448,22,540
0b05c05f-8dda-4998-ab8a-05dc77b12559,geogpt-distillation-mozhu,1721116181,1721117077,finished,1721116484,1721117077,A100-SXM4-80GB,8,1,64,896,303,593
4a37f458-1b64-42c1-afbe-e27440b17cdd,tax,1721116299,1721116380,finished,1721116320,1721116380,A100-SXM4-80GB,8,1,64,896,21,60
35ce2420-3bad-464c-84e8-bba63a124780,sfr-ft-4,1721116386,1721217232,finished,1721117658,1721217232,A100-SXM4-80GB,8,1,64,448,1272,99574
a552d6b4-de50-422a-8b48-9e08ca137806,tax,1721116445,1721116527,finished,1721116464,1721116527,A100-SXM4-80GB,8,1,64,896,19,63
04e04ddf-3a00-4ab3-828a-ca6db00c0696,geo-05B-zero3,1721116562,1721200565,finished,1721116584,1721200565,A100-SXM4-80GB,8,1,64,896,22,83981
7bdfc833-3d97-4f65-86e5-91a1dde9fff7,citysora-modelv4-cele-ppm-65-256-fp,1721116584,1721116754,finished,1721116624,1721116754,A100-SXM4-80GB,8,4,64,896,40,130
d96535c3-69f7-413c-a719-8262652758f4,tax,1721116593,1721116678,finished,1721116613,1721116678,A100-SXM4-80GB,8,1,64,896,20,65
29255d76-ffaf-4c8f-a028-c77931f8b0f9,citysora-modelv4-cele-ppm-cosmic-256-fp,1721116646,1721116820,finished,1721116775,1721116820,A100-SXM4-80GB,8,4,64,896,129,45
dc46f81f-c157-4962-82a2-25b27e353651,tax,1721116743,1721116830,finished,1721116763,1721116830,A100-SXM4-80GB,8,1,64,896,20,67
ba533369-a3f3-4811-bc86-e0d3471fd231,citysora-modelv4-cele-ppm-cosmic-256-fp,1721116820,1721117374,finished,1721116884,1721117374,A100-SXM4-80GB,8,4,64,896,64,490
8c9f8af3-5b62-4bbf-a46a-bab03bbc57c2,citysora-modelv4-cele-ppm-65-256-fp,1721116841,1721118237,finished,1721116906,1721118237,A100-SXM4-80GB,8,4,64,896,65,1331
a306a6d4-97e8-4c63-9046-bb332808a72d,sfr-ft-2,1721116879,1721158392,finished,1721118232,1721158392,A100-SXM4-80GB,8,1,64,448,1353,40160
cf85d334-9776-4523-ac8a-fc13500e940a,tq-llm-chat-infer-1,1721116892,1721123154,finished,1721116913,1721123154,A100-SXM4-80GB,4,1,32,448,21,6241
9bc4f9ba-8717-4510-8ad6-829d787913ca,tax,1721116895,1721116976,finished,1721116916,1721116976,A100-SXM4-80GB,8,1,64,896,21,60
d08159f1-d57f-478b-a0d1-e5de348d239c,fwj-debug,1721117024,1721120312,finished,1721118232,1721120312,A100-SXM4-80GB,8,1,64,896,1208,2080
14712a6f-50fa-4f5c-8171-79e762dc706a,tax,1721117038,1721117117,finished,1721117058,1721117117,A100-SXM4-80GB,8,1,64,896,20,59
5f368eae-ffff-413c-abdb-0378fe8daa2f,tax,1721117179,1721117261,finished,1721117199,1721117261,A100-SXM4-80GB,8,1,64,896,20,62
c6333cd5-b89c-466b-9d28-36bb52c11824,lf-sft-32k-2nodes,1721117186,1721118600,finished,1721117247,1721118600,A100-SXM4-80GB,8,2,64,448,61,1353
2d467196-acdc-4a3d-a2d1-c4527087e6f4,citysora-512-cele-ppm-from-5k512,1721117251,1721118216,finished,1721117415,1721118216,A100-SXM4-80GB,8,4,64,896,164,801
255224de-e7b2-4db1-8b98-7c43b315a442,tax,1721117322,1721117403,finished,1721117343,1721117403,A100-SXM4-80GB,8,1,64,896,21,60
73921c5e-2696-450c-a559-753abc364706,tax,1721117467,1721117549,finished,1721117488,1721117549,A100-SXM4-80GB,8,1,64,896,21,61
33b06eb6-f962-4499-aa6f-dcaf81394be3,geo-mod-05b-test,1721117500,1721119662,finished,1721117520,1721119662,A100-SXM4-80GB,8,1,64,448,20,2142
a4fdcc78-f82d-47e6-8e6d-79c3e331ee2f,tax,1721117610,1721117692,finished,1721117631,1721117692,A100-SXM4-80GB,8,1,64,896,21,61
3e1c2698-6ea8-47a6-8fa8-b38b590107d8,geogpt-distillation-mozhu,1721117650,1721223002,finished,1721117671,1721223002,A100-SXM4-80GB,8,1,64,896,21,105331
69234ab7-6504-4145-b0fc-4e9e424a7fa7,tax,1721117755,1721117837,finished,1721117775,1721117837,A100-SXM4-80GB,8,1,64,896,20,62
6825563b-26eb-4768-bc7d-bce4f3460a97,llm-train,1721117784,1721166925,finished,1721117805,1721166925,A100-SXM4-80GB,8,1,64,896,21,49120
d5914586-6a43-4df1-91c5-d32dfb0f4312,tax,1721117899,1721117979,finished,1721117919,1721117979,A100-SXM4-80GB,8,1,64,896,20,60
c6ff2d7c-7f8b-412e-9759-d6689ebe60e3,tax,1721118040,1721118120,finished,1721118059,1721118120,A100-SXM4-80GB,8,1,64,896,19,61
8331ec5c-8a89-4515-b52b-4a764d3180ae,tax,1721118181,1721118268,finished,1721118204,1721118268,A100-SXM4-80GB,8,1,64,896,23,64
428d16ae-b116-4c7f-b1a3-524757be7d13,citysora-512-cele-ppm-from-5k512,1721118216,1721138665,finished,1721118258,1721138665,A100-SXM4-80GB,8,4,64,896,42,20407
abb168c7-6fef-4718-81ed-3b522d6695d8,citysora-modelv4-cele-ppm-65-256-fp,1721118237,1721139286,finished,1721118299,1721139286,A100-SXM4-80GB,8,4,64,896,62,20987
e388e471-1a9c-43e1-9b14-6a7d3310e82d,tax,1721118331,1721118412,finished,1721118352,1721118412,A100-SXM4-80GB,8,1,64,896,21,60
c0d50b6c-001d-4339-8987-ab7900a6ca9b,tax,1721118472,1721118551,finished,1721118492,1721118551,A100-SXM4-80GB,8,1,64,896,20,59
ae7f1a26-2258-47fb-819f-9d8efbfaabab,tax,1721118613,1721118692,finished,1721118633,1721118692,A100-SXM4-80GB,8,1,64,896,20,59
160fb55e-1575-4366-8206-0579e52063d7,tax,1721118753,1721118832,finished,1721118772,1721118832,A100-SXM4-80GB,8,1,64,896,19,60
0a36a2a0-004a-4fd6-8790-7dc3db6f6877,tax,1721118893,1721118974,finished,1721118914,1721118974,A100-SXM4-80GB,8,1,64,896,21,60
b6e69cb0-1180-4293-90f1-3f1f6af142b8,tax,1721119039,1721119118,finished,1721119059,1721119118,A100-SXM4-80GB,8,1,64,896,20,59
ad7ad27b-372e-4b31-9b79-f6f1823782cc,tax,1721119178,1721119260,finished,1721119198,1721119260,A100-SXM4-80GB,8,1,64,896,20,62
a0b37003-2165-4705-b121-f0801ed08221,d,1721119247,1721119392,finished,1721119311,1721119392,A100-SXM4-80GB,8,2,64,896,64,81
7bfb8e1e-d319-4d4e-bd49-9d960c6ecd93,lf-sft-32k-2nodes,1721119289,1721120673,finished,1721119332,1721120673,A100-SXM4-80GB,8,2,64,448,43,1341
11c7ca3a-5fcc-4854-827f-8f6ddfa9943e,llama-actsave,1721119291,1721119679,finished,1721119314,1721119679,A100-SXM4-80GB,8,1,64,448,23,365
82841163-9b22-43d0-a99a-d6e93438ba73,tax,1721119325,1721119405,finished,1721119345,1721119405,A100-SXM4-80GB,8,1,64,896,20,60
c51dee36-aeab-432b-8d33-1dbd63713e61,tax,1721119465,1721119545,finished,1721119485,1721119545,A100-SXM4-80GB,8,1,64,896,20,60
547bfdd1-7760-433f-be3a-5b939decf6bf,tax,1721119607,1721119690,finished,1721119630,1721119690,A100-SXM4-80GB,8,1,64,896,23,60
b63dec83-ae57-44a4-8472-1d9e31a0dbaa,tax,1721119750,1721119831,finished,1721119770,1721119831,A100-SXM4-80GB,8,1,64,896,20,61
14460d84-e697-4e5a-8c6a-f169aa0f4156,tq-geo-extractor-cpu,1721119828,1721821599,finished,1721119849,1721821599,A100-SXM4-80GB,1,1,8,112,21,701750
f883156b-70bb-4e0b-8c16-3362b35b66b8,tax,1721119893,1721119974,finished,1721119914,1721119974,A100-SXM4-80GB,8,1,64,896,21,60
39a18391-61c1-4adb-9c67-acaedb14de6f,llama-actsave,1721119922,1721179774,finished,1721119943,1721179774,A100-SXM4-80GB,8,1,64,448,21,59831
2b374aba-6dce-4764-b9d3-80d206e902d3,tax,1721120033,1721120113,finished,1721120053,1721120113,A100-SXM4-80GB,8,1,64,896,20,60
a97df46a-8e1e-40d0-861e-05ac55b1292c,zjllm-sci-llama-3-7b-infer,1721120138,1721206884,finished,1721120160,1721206884,A100-SXM4-80GB,8,1,64,448,22,86724
ab6dab45-444f-4136-b145-cbdeae360edd,d,1721120142,1721120499,finished,1721120207,1721120499,A100-SXM4-80GB,8,2,64,896,65,292
e8f61ebe-b7fd-45d4-9357-480cda3469e6,tax,1721120178,1721120262,finished,1721120200,1721120262,A100-SXM4-80GB,8,1,64,896,22,62
a7a1c91d-e81f-4ca0-9436-99ac85355ba2,rag-bert-online,1721120249,1723023878,finished,1721120270,1723023878,A100-SXM4-40GB,1,1,8,32,21,1903608
b6bd03fc-bf2c-47e5-8ef2-cf96c69769c2,rag-embedding-sfr-online,1721120290,1723023878,finished,1721120314,1723023878,A100-SXM4-40GB,1,1,16,256,24,1903564
109e7dba-69fd-4727-a510-1524efa6d40a,fwj-debug,1721120312,1721122543,finished,1721120335,1721122543,A100-SXM4-80GB,8,1,64,896,23,2208
011a3a6d-bcb3-4e2a-bed9-b772e4323710,rag-embedding-sfr-offline,1721120313,1723023878,finished,1721120336,1723023878,A100-SXM4-40GB,1,1,8,32,23,1903542
695de579-e80a-43cd-a10d-c9b27fb3f32c,rag-reranker-online,1721120315,1721199045,finished,1721120336,1721199045,A100-SXM4-40GB,1,1,8,32,21,78709
c74d4dd9-22ea-4afc-88c6-535e1553fa81,tax,1721120328,1721120409,finished,1721120349,1721120409,A100-SXM4-80GB,8,1,64,896,21,60
df582c0e-227f-4266-b3ed-ff25a12248d9,tax,1721120470,1721120555,finished,1721120491,1721120555,A100-SXM4-80GB,8,1,64,896,21,64
04ad9b8e-045f-4d5b-8ad0-dbf01d335d51,d,1721120499,1721120632,finished,1721120562,1721120632,A100-SXM4-80GB,8,2,64,896,63,70
ee26506e-dbf7-4913-9540-d42c329ef947,tax,1721120625,1721120707,finished,1721120646,1721120707,A100-SXM4-80GB,8,1,64,896,21,61
f5b7fbb3-6887-4e89-b40d-2e3c7c41c27d,tax,1721120770,1721120854,finished,1721120790,1721120854,A100-SXM4-80GB,8,1,64,896,20,64
a582ada6-8069-4c5c-b199-bf7e362f9101,d,1721120777,1721120987,finished,1721120838,1721120987,A100-SXM4-80GB,8,2,64,896,61,149
a1ed9561-16a2-46e7-b28d-bf024cbf3320,tqme-vllm-base,1721120850,1721128841,finished,1721120872,1721128841,A100-SXM4-80GB,8,1,64,448,22,7969
5c7432b2-5ae3-4f0d-b22a-d9e5c76452af,tax,1721120917,1721121001,finished,1721120939,1721121001,A100-SXM4-80GB,8,1,64,896,22,62
d6de2f0f-336d-47ca-84e3-bc7ac76ae166,tax,1721121064,1721121147,finished,1721121084,1721121147,A100-SXM4-80GB,8,1,64,896,20,63
d7815dd2-3909-4ca7-a09a-697bc3ce8147,d,1721121133,1721121298,finished,1721121196,1721121298,A100-SXM4-80GB,8,2,64,896,63,102
be49e6e0-b30b-4a1b-986f-03b25a7fc08f,tax,1721121209,1721121291,finished,1721121231,1721121291,A100-SXM4-80GB,8,1,64,896,22,60
ac2150bf-69a6-46f5-a17c-f7ab1d7f7d20,tax,1721121353,1721121435,finished,1721121373,1721121435,A100-SXM4-80GB,8,1,64,896,20,62
317bd24f-e479-4225-ad02-6b276ebd08c5,tax,1721121497,1721121576,finished,1721121517,1721121576,A100-SXM4-80GB,8,1,64,896,20,59
c24cdcfb-299a-4c97-b3e1-be78ed92f354,d,1721121504,1721121705,finished,1721121563,1721121705,A100-SXM4-80GB,8,2,64,896,59,142
3e881b39-4c54-4412-a613-6f85e96cdd20,tax,1721121637,1721121719,finished,1721121658,1721121719,A100-SXM4-80GB,8,1,64,896,21,61
737d7201-e923-4ec6-9b8c-4b591db9ea7e,tax,1721121781,1721121864,finished,1721121801,1721121864,A100-SXM4-80GB,8,1,64,896,20,63
072cf030-abda-4dc2-bbb9-6c6d3880f2ec,qwen2-72b-0612-dpo-wanda5-42a4b-auto,1721121884,1721124320,finished,1721121906,1721124320,A100-SXM4-80GB,8,1,64,448,22,2414
542f87b6-f776-4559-95fc-2168cd806a80,geo-base-e16,1721121904,1721125358,finished,1721121970,1721125358,A100-SXM4-80GB,8,28,64,448,66,3388
f903c179-31fa-4997-b805-f495e3505c8e,tax,1721121938,1721122012,finished,1721121959,1721122012,A100-SXM4-80GB,8,1,64,896,21,53
74b8709e-659e-431f-a8f8-6329f3e562d3,tax,1721122075,1721124244,finished,1721122095,1721124244,A100-SXM4-80GB,8,1,64,896,20,2149
1d85cc32-b4b1-4fd4-b96b-715da862c49e,train-7b,1721122114,1721124709,finished,1721122137,1721124709,A100-SXM4-80GB,4,1,32,448,23,2572
68ff6e79-0c23-4962-af33-7440755aeda7,geogpt-chat-lp40-s2-sft40w,1721122177,1721170492,finished,1721122200,1721170492,A100-SXM4-80GB,8,1,64,448,23,48292
1cbf08a4-07d8-4114-adb2-5fe7cb322dbf,d,1721122190,1721122671,finished,1721122211,1721122671,A100-SXM4-80GB,8,2,64,896,21,460
ffc7679b-b29c-4d4c-bd9b-a615452c25be,geogpt-eval-abductive,1721122221,1721124808,finished,1721122242,1721124808,A100-SXM4-80GB,8,1,64,896,21,2566
a07a3770-fb65-4718-9f05-e5e8e957a259,geo-05B-zero3-2,1721122305,1721197755,finished,1721122327,1721197755,A100-SXM4-80GB,8,1,64,896,22,75428
2146e1e0-a292-45ab-81a5-675ab6b9712d,geo-base-offline-eval,1721122416,1721122548,finished,1721122438,1721122548,A100-SXM4-80GB,8,1,64,448,22,110
7d796992-8d65-4845-b550-a19d6031f254,fwj-debug,1721122544,1721126601,finished,1721122565,1721126601,A100-SXM4-80GB,8,1,64,896,21,4036
081b525a-31ff-4558-b0f7-0a6c6565deaa,lf-sft-32k-2nodes,1721122840,1721125489,finished,1721124211,1721125489,A100-SXM4-80GB,8,2,64,448,1371,1278
28761b17-6287-46e0-999e-794a38b6e841,tq-llm-chat-infer-1,1721123154,1721129218,finished,1721123176,1721129218,A100-SXM4-80GB,4,1,32,448,22,6042
079620f6-75d6-4193-ac55-e7c6edd3d82b,geogpt-prompt-tuning-tg-train-all,1721123761,1721301735,finished,1721223023,1721301735,A100-SXM4-80GB,8,1,64,448,99262,78712
085d1086-dd14-4b41-8386-4f0edc56dd15,geogpt-sft-3-9m-all-llama3-8b,1721124217,1721132897,finished,1721131762,1721132897,A100-SXM4-80GB,8,16,64,448,7545,1135
3d9b4ea0-239c-40aa-8103-38dc2478829a,tax,1721124307,1721124387,finished,1721124328,1721124387,A100-SXM4-80GB,8,1,64,896,21,59
6dab0ee0-1a16-476a-b7df-de76c4436fad,tax,1721124446,1721124526,finished,1721124467,1721124526,A100-SXM4-80GB,8,1,64,896,21,59
d7cb169e-85bc-41ce-a587-e8e2192f3859,tax,1721124587,1721124670,finished,1721124607,1721124670,A100-SXM4-80GB,8,1,64,896,20,63
bc7d0021-2814-4edb-9007-ad4c8a15908c,train-7b,1721124709,1721133317,finished,1721124730,1721133317,A100-SXM4-80GB,4,1,32,448,21,8587
5acc9c6b-c328-457c-b77e-dd4720799d6d,tax,1721124733,1721124812,finished,1721124753,1721124812,A100-SXM4-80GB,8,1,64,896,20,59
c9904551-ce7b-48c1-849a-13340ccb7594,tax,1721124873,1721124953,finished,1721124893,1721124953,A100-SXM4-80GB,8,1,64,896,20,60
60563457-8641-4009-bdaa-80affade5fa6,tax,1721125014,1721125094,finished,1721125035,1721125094,A100-SXM4-80GB,8,1,64,896,21,59
306b1009-51d0-4734-bdfc-287c612c48d0,tax,1721125153,1721125235,finished,1721125174,1721125235,A100-SXM4-80GB,8,1,64,896,21,61
8765d8a3-4235-457c-ac9e-1b3e90a71fde,tax,1721125297,1721125420,finished,1721125318,1721125420,A100-SXM4-80GB,8,1,64,896,21,102
d36955ae-bce8-4d6b-b56f-96ccf0ab0797,qwen2-0-5B-geocpt-5B-lr-5e-5-67ea8-auto,1721125337,1721142589,finished,1721125358,1721142589,A100-SXM4-80GB,1,1,8,112,21,17231
2d8b0deb-6805-44ee-8000-f9f5c0e49336,geo-base-e16,1721125358,1721125581,finished,1721125399,1721125581,A100-SXM4-80GB,8,28,64,448,41,182
baa5015b-3b9c-4dff-96fc-57fe01909607,geogpt-qwen15-moe-alpaca-sft-math,1721125373,1721132353,finished,1721125393,1721132353,A100-SXM4-80GB,8,1,64,448,20,6960
f95dc7f4-c014-4fad-88f2-d9dc8b60f348,tax,1721125482,1721125570,finished,1721125502,1721125570,A100-SXM4-80GB,8,1,64,896,20,68
c42c5413-6cec-468d-845a-ee19039ba669,geo-base-e16,1721125581,1721370834,finished,1721125643,1721370834,A100-SXM4-80GB,8,28,64,448,62,245191
89ac2916-8573-4acd-8e8e-8a66e4ac5401,tax,1721125632,1721125725,finished,1721125663,1721125725,A100-SXM4-80GB,8,1,64,896,31,62
1821fe2f-6dbb-4113-8dfd-8efbc550394e,tax,1721125788,1721125870,finished,1721125809,1721125870,A100-SXM4-80GB,8,1,64,896,21,61
c384a975-c94a-49c8-a71a-6f6098b6bf7a,tax,1721125934,1721126017,finished,1721125955,1721126017,A100-SXM4-80GB,8,1,64,896,21,62
bcc72a56-dafc-4ade-a1c7-85281d81c0d7,geogpt-eval-abductive,1721125971,1721126569,finished,1721125992,1721126569,A100-SXM4-80GB,8,1,64,896,21,577
f136ef07-2af4-4ad0-a914-a4bfd857a526,tax,1721126079,1721126160,finished,1721126099,1721126160,A100-SXM4-80GB,8,1,64,896,20,61
553ee415-3085-4a22-a0eb-264ce26c5edc,tax,1721126222,1721126305,finished,1721126242,1721126305,A100-SXM4-80GB,8,1,64,896,20,63
0d28f73e-ebd0-4d98-9704-5aed4dbd1dce,tax,1721126367,1721126449,finished,1721126387,1721126449,A100-SXM4-80GB,8,1,64,896,20,62
c83e0c67-d812-442b-9124-3caf9cd2f7be,tax,1721126511,1721126594,finished,1721126532,1721126594,A100-SXM4-80GB,8,1,64,896,21,62
b4470af7-f757-4877-85c1-c8ff9e7482dd,fwj-debug,1721126601,1721133870,finished,1721126621,1721133870,A100-SXM4-80GB,8,1,64,896,20,7249
fb84fffc-6add-4286-ad01-dcf4f6712533,tax,1721126655,1721126734,finished,1721126675,1721126734,A100-SXM4-80GB,8,1,64,896,20,59
a39c62bc-3463-46b7-9396-d187264ad432,tax,1721126796,1721126878,finished,1721126817,1721126878,A100-SXM4-80GB,8,1,64,896,21,61
3fd4602b-ba66-4492-a519-823246b56c45,tax,1721126938,1721127019,finished,1721126959,1721127019,A100-SXM4-80GB,8,1,64,896,21,60
722f972c-339d-4d5e-ab56-a4542c538dfe,debug,1721127070,1721129076,finished,1721127090,1721129076,A100-SXM4-80GB,8,1,64,896,20,1986
e9a17e09-7907-485e-b586-478832a23024,tax,1721127081,1721127162,finished,1721127101,1721127162,A100-SXM4-80GB,8,1,64,896,20,61
80f659ea-38bd-4095-86de-5c9c505a8b28,geogpt-cot-eval-cp-r1,1721127158,1721130618,finished,1721127178,1721130618,A100-SXM4-80GB,8,1,64,896,20,3440
cf3b41fb-f673-4c81-a63e-1abf00fd8878,tax,1721127221,1721127300,finished,1721127241,1721127300,A100-SXM4-80GB,8,1,64,896,20,59
86d9a39b-a349-4c04-9a0e-0334f35adcd5,tax,1721127362,1721127442,finished,1721127382,1721127442,A100-SXM4-80GB,8,1,64,896,20,60
cf5c1f68-508b-4495-96cd-e02abd960f0c,tax,1721127502,1721127583,finished,1721127523,1721127583,A100-SXM4-80GB,8,1,64,896,21,60
af4875e6-4d83-4fcc-abcc-e83e321ddc6a,ttt,1721127586,1721228681,finished,1721127606,1721228681,A100-SXM4-80GB,8,1,64,896,20,101075
01955ce2-1336-4981-a28e-c98443cd7cdf,tax,1721127645,1721127726,finished,1721127666,1721127726,A100-SXM4-80GB,8,1,64,896,21,60
944f2acd-8409-42e6-ace4-22611a445e8b,tax,1721127787,1721127868,finished,1721127808,1721127868,A100-SXM4-80GB,8,1,64,896,21,60
647a1b2f-b066-4b81-ad4f-c6ac17073031,tax,1721127929,1721128008,finished,1721127948,1721128008,A100-SXM4-80GB,8,1,64,896,19,60
390d5204-4552-4ca2-8aef-911986421855,tax,1721128069,1721128150,finished,1721128090,1721128150,A100-SXM4-80GB,8,1,64,896,21,60
d6c59646-6db1-4486-af0a-3a05ffdec268,tax,1721128211,1721128293,finished,1721128233,1721128293,A100-SXM4-80GB,8,1,64,896,22,60
c1897238-676b-48c2-ba9d-3d16cdb7121a,tax,1721128354,1721128436,finished,1721128375,1721128436,A100-SXM4-80GB,8,1,64,896,21,61
8d65c2fc-ec8c-4893-860a-157897756f4e,geogpt-lxz-2-9m-mix-data-qwen1-5-14b,1721128367,1721227108,finished,1721133393,1721227108,A100-SXM4-80GB,8,16,64,448,5026,93715
5ccf31cd-ce3d-492f-9787-9d1a1b60a38c,tax,1721128497,1721128577,finished,1721128517,1721128577,A100-SXM4-80GB,8,1,64,896,20,60
e620a130-c5f4-4252-95a5-8037f65ca3f7,sp-8-dp-0701-4249b-auto,1721128631,1721131028,finished,1721128651,1721131028,A100-SXM4-80GB,8,1,64,448,20,2377
9878212d-516b-4667-94b6-b0dc24ef6cb1,tax,1721128639,1721128725,finished,1721128659,1721128725,A100-SXM4-80GB,8,1,64,896,20,66
dd14e54d-cd45-4569-95c8-d037e08f4d41,sp-9-dp-0701-40afe-auto,1721128673,1721133697,finished,1721131378,1721133697,A100-SXM4-80GB,8,1,64,448,2705,2319
1a1bbe73-ad98-4012-bab0-a355b5457ac0,sp-5-dp-0701-ec7a6-auto,1721128674,1721131358,finished,1721129081,1721131358,A100-SXM4-80GB,8,1,64,448,407,2277
0b9db54e-ce79-4c9e-bcbf-ab1d880fdfa0,sp-3-dp-0701-21281-auto,1721128676,1721131213,finished,1721128858,1721131213,A100-SXM4-80GB,8,1,64,448,182,2355
566b830a-fdac-4879-b37a-eac735663a0f,geogpt-14b-new10bcpt,1721128739,1721132429,finished,1721128811,1721132429,A100-SXM4-80GB,8,8,64,448,72,3618
4167fc85-07a4-4845-a058-6e56f4e08502,tax,1721128791,1721128889,finished,1721128818,1721128889,A100-SXM4-80GB,8,1,64,896,27,71
6e02e6df-f47b-46bb-b954-02b76693080e,llama-factory-zj-test,1721128825,1721133536,finished,1721131755,1721133536,A100-SXM4-80GB,8,4,64,896,2930,1781
718b9031-0cdd-489b-804a-e52df709a890,geo-sae-train,1721128830,1721128977,finished,1721128856,1721128977,A100-SXM4-80GB,8,1,64,896,26,121
9408b3fb-9ef8-49f2-b48c-a46ca9ce72f0,geogpt-lp40-6bgo,1721128838,1721227091,finished,1721226907,1721227091,A100-SXM4-80GB,8,16,64,448,98069,184
232d9fb9-5686-480d-9177-e759ee846e53,tqme-vllm-base,1721128841,1721140421,finished,1721129757,1721140421,A100-SXM4-80GB,8,1,64,448,916,10664
6454d08e-f90b-42a2-a00f-7af610da94a2,tax,1721128987,1721129089,finished,1721129007,1721129089,A100-SXM4-80GB,8,1,64,896,20,82
adb85210-7d53-45f4-b6c1-8f1bff50859f,tax,1721129152,1721129529,finished,1721129173,1721129529,A100-SXM4-80GB,8,1,64,896,21,356
4ed5917f-d3d1-4db4-8efe-3e4ebd7e860a,geo-sae-train,1721129163,1721129498,finished,1721129184,1721129498,A100-SXM4-80GB,8,1,64,896,21,314
e93f9e96-32d0-46be-a371-eaff485d939b,geogpt-chat-lp40-s2-sft9wgeo,1721129214,1721154541,finished,1721131723,1721154541,A100-SXM4-80GB,8,1,64,448,2509,22818
32a43c15-00a5-49db-bbcf-c1b6e09502bb,tq-llm-chat-infer-1,1721129218,1721133338,finished,1721129239,1721133338,A100-SXM4-80GB,4,1,32,448,21,4099
e476d302-f04b-4703-abe1-43c761cc7feb,tax,1721129591,1721129673,finished,1721129612,1721129673,A100-SXM4-80GB,8,1,64,896,21,61
cdd3a38a-fc91-4597-9822-e0ab4db54d0e,tax,1721129737,1721130104,finished,1721129758,1721130104,A100-SXM4-80GB,8,1,64,896,21,346
5f681d1e-e6d0-456e-b39d-083ee9827d22,geo-sae-train,1721129791,1721131233,finished,1721129812,1721131233,A100-SXM4-80GB,8,1,64,896,21,1421
a04a796c-2c6d-4ebe-abfa-e817f8ba2f8d,tax,1721130165,1721130245,finished,1721130185,1721130245,A100-SXM4-80GB,8,1,64,896,20,60
3dba717d-2713-4e54-9cd5-ee864767772c,tax,1721130307,1721130389,finished,1721130328,1721130389,A100-SXM4-80GB,8,1,64,896,21,61
8f70ed1b-7e04-48e8-83df-2261cc07b39a,debug,1721130376,1721132316,finished,1721131063,1721132316,A100-SXM4-80GB,8,1,64,896,687,1253
7541c359-0d10-451e-88ec-20e787a054df,tax,1721130452,1721130534,finished,1721130472,1721130534,A100-SXM4-80GB,8,1,64,896,20,62
551feedc-cfa8-4ae3-9f12-455e83fc84ba,sp-q72b-dp-0612-dp-linear-w55-63316-auto,1721130569,1721133167,finished,1721130634,1721133167,A100-SXM4-80GB,8,1,64,448,65,2533
bab9cf7a-16bf-497b-93d6-148cdd439a34,sp-q72b-dp-0612-dp-ties-w55-736ea-auto,1721130570,1721143583,finished,1721131235,1721143583,A100-SXM4-80GB,8,1,64,448,665,12348
e1d7ff4c-17a3-46de-9b52-e39874c1417f,sp-q72b-dp-0612-dp-linear-w55-6db98-auto,1721130572,1721143708,finished,1721131720,1721143708,A100-SXM4-80GB,8,1,64,448,1148,11988
bc874eeb-044b-4efb-b03e-86b2c8c280cc,tax,1721130601,1721130684,finished,1721130622,1721130684,A100-SXM4-80GB,8,1,64,896,21,62
62ce8ac3-7a40-4fa5-97f5-e96d6b1e7d39,tax,1721130745,1721130829,finished,1721130767,1721130829,A100-SXM4-80GB,8,1,64,896,22,62
4fa76ac4-1f10-4840-8f00-08c700f19cf2,geogpt-dairui-model-merge-exp-2,1721130819,1721131107,finished,1721130841,1721131107,A100-SXM4-80GB,8,1,64,448,22,266
1859f436-f99f-4191-8d8f-dd9f36697d7f,tax,1721130891,1721131096,finished,1721130911,1721131096,A100-SXM4-80GB,8,1,64,896,20,185
a4458585-3e03-45c8-85b6-f4517c00350a,geogpt-dairui-eval-code-3,1721131027,1721212853,finished,1721143373,1721212853,A100-SXM4-80GB,8,4,64,896,12346,69480
9de0405c-9af8-400a-bbd9-d4108f452630,tax,1721131158,1721131243,finished,1721131177,1721131243,A100-SXM4-80GB,8,1,64,896,19,66
5b3739da-d83a-4d31-ab3e-b2a911fd7bb6,tax,1721131305,1721131386,finished,1721131325,1721131386,A100-SXM4-80GB,8,1,64,896,20,61
980d3731-12e3-4c49-9693-bf36df74e0d7,geogpt-dairui-model-merge-exp-2,1721131336,1721131500,finished,1721131357,1721131500,A100-SXM4-80GB,8,1,64,448,21,143
d56e0127-da17-4fe0-8b9c-8140589dee75,tax,1721131448,1721131529,finished,1721131469,1721131529,A100-SXM4-80GB,8,1,64,896,21,60
de2e6eed-5d5d-4c8a-896f-c1dd3cc39ed1,geogpt-dairui-model-merge-exp-2,1721131561,1721131760,finished,1721131583,1721131760,A100-SXM4-80GB,8,1,64,448,22,177
5f0b6c3d-7ea1-469e-a2ad-1a66363f1502,tax,1721131592,1721131938,finished,1721131613,1721131938,A100-SXM4-80GB,8,1,64,896,21,325
4d88a0af-a270-4adc-8d86-893ee08695af,geo-sae-train,1721131603,1721133185,finished,1721131623,1721133185,A100-SXM4-80GB,8,1,64,896,20,1562
b8fb47df-1db4-4c90-b59f-53959c25806c,geogpt-dairui-model-merge-exp-2,1721131760,1721131970,finished,1721131787,1721131970,A100-SXM4-80GB,8,1,64,448,27,183
1120482f-7683-4882-ab76-bed4a72c59de,geogpt-dairui-model-merge-exp-2,1721131970,1721133440,finished,1721131992,1721133440,A100-SXM4-80GB,8,1,64,448,22,1448
0cac0082-3c8e-4bd1-ae5b-0c80554bb019,tax,1721132001,1721132083,finished,1721132021,1721132083,A100-SXM4-80GB,8,1,64,896,20,62
c00363b5-6641-42cf-9e6c-fe7388ddb8be,geogpt-cot-train-cp-d1,1721132057,1721132635,finished,1721132119,1721132635,A100-SXM4-80GB,8,4,64,896,62,516
668e99e4-1d0c-407b-93fa-97a08ce65eb9,tax,1721132145,1721132225,finished,1721132165,1721132225,A100-SXM4-80GB,8,1,64,896,20,60
007a994b-cf23-4e6c-917e-a55ea5e0dead,tax,1721132287,1721132371,finished,1721132307,1721132371,A100-SXM4-80GB,8,1,64,896,20,64
74eaea08-4f01-497c-8680-2b78424c3c57,sp-q72b-dp-0612-dp-ties-w55-6f1dd-auto,1721132362,1721134686,finished,1721132383,1721134686,A100-SXM4-80GB,8,1,64,448,21,2303
b5c58c41-e447-411a-926d-a701a9b52088,geogpt-14b-new10bcpt,1721132429,1721302218,finished,1721132696,1721302218,A100-SXM4-80GB,8,8,64,448,267,169522
adca9267-9839-4027-910a-1ad2e6e8f351,tax,1721132435,1721132515,finished,1721132455,1721132515,A100-SXM4-80GB,8,1,64,896,20,60
42462152-0d2a-4827-b581-bdc2975c3371,tax,1721132579,1721132659,finished,1721132600,1721132659,A100-SXM4-80GB,8,1,64,896,21,59
22d2c544-cc8e-426f-b2eb-8b6664b47b64,tax,1721132724,1721132803,finished,1721132745,1721132803,A100-SXM4-80GB,8,1,64,896,21,58
0b38e53b-f1d7-40cf-b55b-caaa481bf318,geogpt-cot-train-cp-d1,1721132859,1721134628,finished,1721132941,1721134628,A100-SXM4-80GB,8,4,64,896,82,1687
2f6cc0ce-cddd-4ab4-88cf-1d8a3c0a44b3,tax,1721132864,1721132946,finished,1721132885,1721132946,A100-SXM4-80GB,8,1,64,896,21,61
00eec5f3-d9cb-4f5b-92d6-1c32716c6b47,tax,1721133011,1721133092,finished,1721133031,1721133092,A100-SXM4-80GB,8,1,64,896,20,61
65e7765a-6fec-4edd-9c88-b2f654fe3f3a,tax,1721133154,1721133235,finished,1721133175,1721133235,A100-SXM4-80GB,8,1,64,896,21,60
c395016e-8b66-460b-9f67-2e355f1bd518,tax,1721133299,1721133381,finished,1721133320,1721133381,A100-SXM4-80GB,8,1,64,896,21,61
5a941b37-b7eb-48a9-9883-ed2c5f02879c,geogpt-dairui-model-merge-exp-2,1721133440,1721133563,finished,1721133460,1721133563,A100-SXM4-80GB,8,1,64,448,20,103
9dc36fea-42a7-483b-ba37-84582bd23f3b,tax,1721133449,1721133530,finished,1721133469,1721133530,A100-SXM4-80GB,8,1,64,896,20,61
50c78154-ca64-4135-be6e-a7d0016c92e4,geo-sae-train,1721133583,1721135199,finished,1721133606,1721135199,A100-SXM4-80GB,8,1,64,896,23,1593
e234e619-b85f-455a-9102-f7da9ce99b7c,tax,1721133595,1721133684,finished,1721133616,1721133684,A100-SXM4-80GB,8,1,64,896,21,68
7b416fc8-4728-4ee0-8be9-59625d68482a,sp-3-dp-0701-59c4b-auto,1721133630,1721144928,finished,1721133655,1721144928,A100-SXM4-80GB,8,1,64,448,25,11273
060e9f74-4217-43fa-a197-40b969ab7013,sp-9-dp-0701-93599-auto,1721133632,1721145210,finished,1721133655,1721145210,A100-SXM4-80GB,8,1,64,448,23,11555
1a2aaf36-3ffb-4c9b-b51f-fb0db0c775fc,sp-5-dp-0701-8bca7-auto,1721133634,1721145169,finished,1721133655,1721145169,A100-SXM4-80GB,8,1,64,448,21,11514
2ae96d75-da26-405a-9637-d53d1ec8c161,tax,1721133745,1721133844,finished,1721133765,1721133844,A100-SXM4-80GB,8,1,64,896,20,79
253bb822-75e0-42f4-ab34-1b3729d3e7c8,geogpt-mixtral-test,1721133899,1721157483,finished,1721144577,1721157483,A100-SXM4-80GB,8,16,64,448,10678,12906
cfb14826-736e-4453-a137-d4f0517392e5,tax,1721133909,1721133993,finished,1721133929,1721133993,A100-SXM4-80GB,8,1,64,896,20,64
ecabce79-c5f1-49dc-b2c1-330c67f17f96,geogpt-sft-3-9m-all-llama3-8b,1721133985,1721232091,finished,1721227179,1721232091,A100-SXM4-80GB,8,16,64,448,93194,4912
d43af273-6857-4dc0-9bf2-4a60d5d53755,tax,1721134055,1721134139,finished,1721134077,1721134139,A100-SXM4-80GB,8,1,64,896,22,62
558be227-f2b4-4f72-9306-083eba867765,train-7b,1721134073,1721143255,finished,1721134095,1721143255,A100-SXM4-80GB,4,1,32,448,22,9160
21bd43b2-0644-4cb5-81b2-19fe2a88c9d2,tax,1721134200,1721134281,finished,1721134220,1721134281,A100-SXM4-80GB,8,1,64,896,20,61
6ff71620-1977-4982-8462-e293e6251908,tax,1721134343,1721134424,finished,1721134363,1721134424,A100-SXM4-80GB,8,1,64,896,20,61
2f4be602-1419-4e50-b139-27fc16b05342,tax,1721134487,1721134570,finished,1721134508,1721134570,A100-SXM4-80GB,8,1,64,896,21,62
0ba333bb-1dee-43ba-9a71-eb85206a9e3c,tax,1721134632,1721134714,finished,1721134652,1721134714,A100-SXM4-80GB,8,1,64,896,20,62
a0c07af1-cb62-4146-b03e-1072319bf06a,tax,1721134776,1721134858,finished,1721134796,1721134858,A100-SXM4-80GB,8,1,64,896,20,62
9f68f7af-7321-4d1d-865c-7b84a14bd5e9,geogpt-cot-train-cp-d1,1721134896,1721144911,finished,1721134938,1721144911,A100-SXM4-80GB,8,4,64,896,42,9973
7b81c75a-26e6-411a-b284-bcf2a87a4db2,tax,1721134922,1721135025,finished,1721134943,1721135025,A100-SXM4-80GB,8,1,64,896,21,82
f6f86e38-470f-4751-aba4-e49124dbf7d0,tax,1721135087,1721135168,finished,1721135108,1721135168,A100-SXM4-80GB,8,1,64,896,21,60
e87bca74-e918-4aca-b89c-a91b73bae0b8,tax,1721135230,1721135311,finished,1721135250,1721135311,A100-SXM4-80GB,8,1,64,896,20,61
56b0b220-fd54-44a0-8cee-0df8c148d381,tax,1721135374,1721135456,finished,1721135394,1721135456,A100-SXM4-80GB,8,1,64,896,20,62
d2a01b33-a2c6-41de-9886-531ca4d1e2f7,tax,1721135519,1721135601,finished,1721135540,1721135601,A100-SXM4-80GB,8,1,64,896,21,61
86af35cc-8dfd-443b-bd00-1c3f04faa670,tax,1721135662,1721135743,finished,1721135682,1721135743,A100-SXM4-80GB,8,1,64,896,20,61
abc8b1dd-e2bf-412c-aa79-90d85011c511,tax,1721135805,1721135887,finished,1721135825,1721135887,A100-SXM4-80GB,8,1,64,896,20,62
a8fcc253-a361-4c4e-a7b3-36328e30fffc,tax,1721135949,1721136033,finished,1721135970,1721136033,A100-SXM4-80GB,8,1,64,896,21,63
6b3b4902-f67f-493a-88da-22aea06e192c,tax,1721136096,1721136178,finished,1721136117,1721136178,A100-SXM4-80GB,8,1,64,896,21,61
3cb5ec0c-03db-47ce-8ba7-517afd4b3796,tax,1721136240,1721136322,finished,1721136261,1721136322,A100-SXM4-80GB,8,1,64,896,21,61
2f059ec9-dcea-4cf5-b391-7799c0e5a012,tax,1721136385,1721136466,finished,1721136405,1721136466,A100-SXM4-80GB,8,1,64,896,20,61
18eb9960-8ee5-46e9-b78f-8d169c7c7fc2,tax,1721136527,1721136608,finished,1721136548,1721136608,A100-SXM4-80GB,8,1,64,896,21,60
7333e9ae-9904-486c-9499-99142d979005,tax,1721136669,1721136750,finished,1721136689,1721136750,A100-SXM4-80GB,8,1,64,896,20,61
0d015188-2920-43e4-b70a-b5887a9c0cf9,tax,1721136812,1721136892,finished,1721136832,1721136892,A100-SXM4-80GB,8,1,64,896,20,60
6f437548-3489-4377-95b0-3b477d3e3436,tax,1721136954,1721137035,finished,1721136974,1721137035,A100-SXM4-80GB,8,1,64,896,20,61
57aec794-70d1-41be-ba89-b9c22b7cbe87,tax,1721137097,1721137178,finished,1721137117,1721137178,A100-SXM4-80GB,8,1,64,896,20,61
5bc5f3d1-e986-42c6-a270-5bea73891167,tax,1721137241,1721137323,finished,1721137261,1721137323,A100-SXM4-80GB,8,1,64,896,20,62
0ffd11c2-a5a8-4fcf-938d-a8f09c00dc08,geogpt-sft-swift-math-yxs,1721137297,1721137421,finished,1721137318,1721137421,A100-SXM4-80GB,8,1,64,896,21,103
215125ad-021a-4a34-80d0-e38c450e533f,tax,1721137384,1721137465,finished,1721137405,1721137465,A100-SXM4-80GB,8,1,64,896,21,60
c57cd837-4301-418c-988e-ce16fb4d9b70,tax,1721137527,1721137607,finished,1721137547,1721137607,A100-SXM4-80GB,8,1,64,896,20,60
9091fc4b-fe6e-4492-9955-91a077075923,tax,1721137668,1721137750,finished,1721137689,1721137750,A100-SXM4-80GB,8,1,64,896,21,61
304ec6f6-2781-4848-94f5-2ee593bd92aa,geogpt-sft-swift-math-yxs,1721137725,1721137869,finished,1721137746,1721137869,A100-SXM4-80GB,8,1,64,896,21,123
be25891e-0455-4e9b-a28b-16a0ae88254f,tax,1721137812,1721137893,finished,1721137833,1721137893,A100-SXM4-80GB,8,1,64,896,21,60
b2c83585-4e08-420c-b3a3-ad9daa1f828e,tax,1721137954,1721138036,finished,1721137976,1721138036,A100-SXM4-80GB,8,1,64,896,22,60
dab7aa97-53d5-4088-bedf-df6fa9f5bdb7,geogpt-sft-swift-math-yxs,1721137992,1721139020,finished,1721138012,1721139020,A100-SXM4-80GB,8,1,64,896,20,1008
5bbf03fe-afca-46f2-9366-f69a315e56c4,tax,1721138098,1721138181,finished,1721138119,1721138181,A100-SXM4-80GB,8,1,64,896,21,62
7b6d6487-0d70-4551-8c80-51de9fabb207,geogpt-dairui-model-merge-exp-2,1721138234,1721186691,finished,1721138255,1721186691,A100-SXM4-80GB,8,1,64,448,21,48436
d0795ee6-612d-47f8-9434-a14951a8b21f,tax,1721138244,1721138324,finished,1721138265,1721138324,A100-SXM4-80GB,8,1,64,896,21,59
1d407e88-eade-4b4a-95d7-7356a1e4dc30,tax,1721138386,1721138467,finished,1721138406,1721138467,A100-SXM4-80GB,8,1,64,896,20,61
5f5b0e42-61e9-43b2-af26-25b636f42f6f,tax,1721138528,1721138611,finished,1721138549,1721138611,A100-SXM4-80GB,8,1,64,896,21,62
4ccfb773-790c-415b-9564-baa9dbc4ae4c,citysora-512-cele-ppm-from-5k512,1721138665,1721146040,finished,1721138708,1721146040,A100-SXM4-80GB,8,4,64,896,43,7332
fcb78540-ca9a-4e95-be56-01defa800a23,tax,1721138675,1721138778,finished,1721138696,1721138778,A100-SXM4-80GB,8,1,64,896,21,82
12c8b3fd-073f-48d1-8aca-3b843e4fa6fc,train-0716B,1721138702,1721139195,finished,1721138723,1721139195,A100-SXM4-80GB,8,1,64,896,21,472
834565fb-8094-485a-b26a-6c92054555ab,tax,1721138839,1721138920,finished,1721138859,1721138920,A100-SXM4-80GB,8,1,64,896,20,61
f1d70d52-6648-48cf-9e5c-e826e53bb9d5,tax,1721138982,1721139064,finished,1721139003,1721139064,A100-SXM4-80GB,8,1,64,896,21,61
0d3b715f-6366-49d8-ae6c-61f95e38b5f0,geogpt-sft-swift-math-yxs,1721139080,1721139373,finished,1721139103,1721139373,A100-SXM4-80GB,8,1,64,896,23,270
619c4c0d-d4e9-47e2-88e9-120f0b87b939,tax,1721139128,1721139210,finished,1721139148,1721139210,A100-SXM4-80GB,8,1,64,896,20,62
f7418575-ef2e-4700-82e2-005b3eb5342b,train-0716B,1721139258,1721271014,finished,1721139280,1721271014,A100-SXM4-80GB,8,1,64,896,22,131734
95e7639e-6531-4b19-a631-e342358cd085,tax,1721139274,1721139357,finished,1721139296,1721139357,A100-SXM4-80GB,8,1,64,896,22,61
23186cae-af68-407e-802b-c6b9180d6831,citysora-modelv4-cele-ppm-65-256-fp,1721139286,1721147817,finished,1721139347,1721147817,A100-SXM4-80GB,8,4,64,896,61,8470
a70b572b-fec1-4a91-bc68-23af31ecf41f,tax,1721139419,1721139500,finished,1721139439,1721139500,A100-SXM4-80GB,8,1,64,896,20,61
f69c05d6-b9ca-4406-80ed-c62f24a9a667,tax,1721139562,1721139643,finished,1721139582,1721139643,A100-SXM4-80GB,8,1,64,896,20,61
a5c28ad6-6bd8-45b8-8b4b-c30f140d5a6c,tax,1721139705,1721139788,finished,1721139726,1721139788,A100-SXM4-80GB,8,1,64,896,21,62
c0f16f44-6ace-4a38-8855-dcb34063a80e,geogpt-sft-swift-math-yxs,1721139763,1721140213,finished,1721139783,1721140213,A100-SXM4-80GB,8,1,64,896,20,430
25674ba1-a42a-4172-9c71-d18e91f36e13,tax,1721139850,1721139930,finished,1721139870,1721139930,A100-SXM4-80GB,8,1,64,896,20,60
3e2a8cd5-8c4f-494a-a0db-2fcc0d636836,tax,1721139993,1721140075,finished,1721140013,1721140075,A100-SXM4-80GB,8,1,64,896,20,62
1bb60ed4-4b95-4f5c-b607-d21704c01dea,tax,1721140137,1721140218,finished,1721140157,1721140218,A100-SXM4-80GB,8,1,64,896,20,61
3730de1d-238b-43e1-9e45-3d068ed3e54f,tax,1721140279,1721140363,finished,1721140301,1721140363,A100-SXM4-80GB,8,1,64,896,22,62
7af930ad-57d0-442d-9d0a-f592044d9540,geogpt-sft-2m-of-3-9m-all-llama3-8b,1721140292,1721179388,finished,1721163518,1721179388,A100-SXM4-80GB,8,16,64,448,23226,15870
7f4f7a57-c324-4b40-ba09-a92c6c11698d,geogpt-sft-swift-math-yxs,1721140317,1721398387,finished,1721140339,1721398387,A100-SXM4-80GB,8,1,64,896,22,258048
4351fe67-e16b-44c6-af87-32f58940673f,tax,1721140423,1721140505,finished,1721140444,1721140505,A100-SXM4-80GB,8,1,64,896,21,61
20a48cac-580b-46f9-9873-4347e91d50d0,tax,1721140567,1721140647,finished,1721140587,1721140647,A100-SXM4-80GB,8,1,64,896,20,60
85e90a49-dd5f-4cd2-8282-f01eba775f6d,tax,1721140709,1721140790,finished,1721140729,1721140790,A100-SXM4-80GB,8,1,64,896,20,61
2b8006cf-6d60-4a90-b67a-b63f1ab96ef0,tax,1721140853,1721140934,finished,1721140874,1721140934,A100-SXM4-80GB,8,1,64,896,21,60
e146b9d8-202f-45f2-b6a3-92e615a903bd,tax,1721140996,1721141076,finished,1721141015,1721141076,A100-SXM4-80GB,8,1,64,896,19,61
dcbc7129-f4d7-4f48-bf2d-d5d46b8b6ddc,tax,1721141139,1721141220,finished,1721141159,1721141220,A100-SXM4-80GB,8,1,64,896,20,61
2bfc3f17-6e20-487f-93fd-e3682ddc730d,sp-3-dp-0701-cpt-aeef0-auto,1721141253,1721143583,finished,1721141278,1721143583,A100-SXM4-80GB,8,1,64,448,25,2305
9598ee89-a3ce-4f73-b104-c8ebb30d3d48,sp-9-dp-0701-cpt-0473c-auto,1721141255,1721143627,finished,1721141278,1721143627,A100-SXM4-80GB,8,1,64,448,23,2349
21523a58-1400-4855-b378-47072234a854,sp-5-dp-0701-cpt-a3b62-auto,1721141278,1721143647,finished,1721141302,1721143647,A100-SXM4-80GB,8,1,64,448,24,2345
e9187910-38ed-491f-a023-3e52cafb4be4,sp-8-dp-0701-cpt-48a71-auto,1721141281,1721143627,finished,1721141302,1721143627,A100-SXM4-80GB,8,1,64,448,21,2325
9186f793-aac8-4f5b-90ed-7c64bb0b9187,tax,1721141289,1721141370,finished,1721141310,1721141370,A100-SXM4-80GB,8,1,64,896,21,60
6ea171bd-24b4-4b06-8cab-d9a4d3398e66,tax,1721141433,1721141512,finished,1721141453,1721141512,A100-SXM4-80GB,8,1,64,896,20,59
0d6d25da-f37e-42ab-bc85-d104543ae006,tax,1721141575,1721141656,finished,1721141595,1721141656,A100-SXM4-80GB,8,1,64,896,20,61
190f2071-b9df-42e0-b34a-96fac9279e2a,tax,1721141719,1721141801,finished,1721141740,1721141801,A100-SXM4-80GB,8,1,64,896,21,61
898b010e-ad5c-4ee7-b555-db83340b8d79,tax,1721141862,1721141947,finished,1721141883,1721141947,A100-SXM4-80GB,8,1,64,896,21,64
990ceff7-a33b-460e-b924-24da6a14a7d1,tax,1721142011,1721142095,finished,1721142032,1721142095,A100-SXM4-80GB,8,1,64,896,21,63
2e7c5248-05b3-4415-bb6b-a87fde13d22d,tax,1721142159,1721142242,finished,1721142180,1721142242,A100-SXM4-80GB,8,1,64,896,21,62
e95cd801-2ddb-43a8-aca3-b53b45e138cb,tax,1721142305,1721142390,finished,1721142327,1721142390,A100-SXM4-80GB,8,1,64,896,22,63
d0a125d9-7a42-4032-a51d-50c32bc475b8,tax,1721142453,1721142536,finished,1721142474,1721142536,A100-SXM4-80GB,8,1,64,896,21,62
eded39e5-bd9f-4227-b58f-c2917dd8bafa,tax,1721142600,1721142682,finished,1721142621,1721142682,A100-SXM4-80GB,8,1,64,896,21,61
8c4645ba-2e56-40f3-9fc5-b6805b8897a2,tax,1721142745,1721142824,finished,1721142765,1721142824,A100-SXM4-80GB,8,1,64,896,20,59
b6803a56-206b-4c4f-a446-681776f7d452,tax,1721142887,1721142968,finished,1721142907,1721142968,A100-SXM4-80GB,8,1,64,896,20,61
0549823f-e947-442e-90c6-d15fd9efdb34,tax,1721143030,1721143112,finished,1721143051,1721143112,A100-SXM4-80GB,8,1,64,896,21,61
7b603a37-9803-497c-b422-5d95c31b0f0c,tax,1721143174,1721143258,finished,1721143194,1721143258,A100-SXM4-80GB,8,1,64,896,20,64
b8a56405-2fbf-401a-828c-cdae4cb0d074,tax,1721143320,1721143403,finished,1721143341,1721143403,A100-SXM4-80GB,8,1,64,896,21,62
563369da-556d-4863-b16e-654ecfd9bad0,tax,1721143465,1721143550,finished,1721143486,1721143550,A100-SXM4-80GB,8,1,64,896,21,64
d8f3c9bc-5015-4d57-9bc8-8833b1051f03,tax,1721143614,1721143716,finished,1721143635,1721143716,A100-SXM4-80GB,8,1,64,896,21,81
8ea8ab7c-4017-4e3d-8dcf-ca71774e5e69,tax,1721143779,1721143859,finished,1721143799,1721143859,A100-SXM4-80GB,8,1,64,896,20,60
525df236-d1bf-4d4e-8dfa-a396456b36fb,tax,1721143920,1721144000,finished,1721143940,1721144000,A100-SXM4-80GB,8,1,64,896,20,60
037a1679-0dcc-4f1d-9ade-6687333ed1b4,tax,1721144061,1721144141,finished,1721144082,1721144141,A100-SXM4-80GB,8,1,64,896,21,59
9a1375ed-6167-4bcf-8e09-d733b817c333,tax,1721144202,1721144282,finished,1721144222,1721144282,A100-SXM4-80GB,8,1,64,896,20,60
50815e0a-fb11-435e-bc2f-f85da4122e9e,tax,1721144341,1721144423,finished,1721144361,1721144423,A100-SXM4-80GB,8,1,64,896,20,62
5fd9bc63-4355-46f2-bfa7-dae53f841b38,sp-q72b-dp-0701-dp-linear-w55-c9fb2-auto,1721144477,1721146779,finished,1721144498,1721146779,A100-SXM4-80GB,8,1,64,448,21,2281
682c14d4-4c89-4f9f-b8ef-f09095974688,tax,1721144486,1721144566,finished,1721144506,1721144566,A100-SXM4-80GB,8,1,64,896,20,60
980ca3be-c1a9-427e-bc6f-44c8020b1f84,tax,1721144630,1721144710,finished,1721144650,1721144710,A100-SXM4-80GB,8,1,64,896,20,60
52aafd6b-92cb-4ee9-949b-5e12bcaa8a91,sp-q72b-dp-0701-dp-ties-w55-d4cc9-auto,1721144723,1721146979,finished,1721144743,1721146979,A100-SXM4-80GB,8,1,64,448,20,2236
9539adac-5e1f-4a13-b2d1-3ccde26181b3,tax,1721144772,1721144853,finished,1721144793,1721144853,A100-SXM4-80GB,8,1,64,896,21,60
2c47a204-fe35-4f7a-84b0-764464aa62bc,tax,1721144915,1721144995,finished,1721144936,1721144995,A100-SXM4-80GB,8,1,64,896,21,59
6c9b4d63-0b9c-45cf-b178-7076caeca406,tax,1721145055,1721145137,finished,1721145076,1721145137,A100-SXM4-80GB,8,1,64,896,21,61
82f3bfc4-5ea8-4041-bac0-dc7d0019c373,tax,1721145197,1721145279,finished,1721145218,1721145279,A100-SXM4-80GB,8,1,64,896,21,61
3eed7030-3291-4736-a6d5-f5239cae2831,sp-8-dp-0701-afa78-auto,1721145293,1721157017,finished,1721145313,1721157017,A100-SXM4-80GB,8,1,64,448,20,11704
3dcd9b20-66ca-43d1-914b-82739b60ab6d,tax,1721145342,1721145424,finished,1721145363,1721145424,A100-SXM4-80GB,8,1,64,896,21,61
6615c6bb-4198-4b2f-abff-1780fe6a7845,sp-5-dp-0701-cpt-73a3f-auto,1721145436,1721156895,finished,1721145456,1721156895,A100-SXM4-80GB,8,1,64,448,20,11439
8139080d-ad5b-4606-ae97-cb3aa83d65cb,tax,1721145486,1721145565,finished,1721145506,1721145565,A100-SXM4-80GB,8,1,64,896,20,59
07574131-01e8-4fbb-a6fc-4189208b0100,q72b-sft-ep1-v1-4-0701-dpo-ea243-auto,1721145619,1721147982,finished,1721145640,1721147982,A100-SXM4-80GB,8,1,64,448,21,2342
19f10772-46c9-495a-a430-eb2d68f4d31d,tax,1721145628,1721145706,finished,1721145648,1721145706,A100-SXM4-80GB,8,1,64,896,20,58
6fe504ca-4c9d-4d49-bcea-25f08b3ba7b0,tax,1721145767,1721145845,finished,1721145786,1721145845,A100-SXM4-80GB,8,1,64,896,19,59
2598fb7e-b759-4add-8a01-fe1448b02286,tax,1721145906,1721145987,finished,1721145926,1721145987,A100-SXM4-80GB,8,1,64,896,20,61
4c8a31a3-dd6f-4ba0-965c-a7fea64ed408,citysora-512-cele-ppm-from-5k512,1721146041,1721146467,finished,1721146101,1721146467,A100-SXM4-80GB,8,4,64,896,60,366
b6b00c23-4b9e-4e9b-9560-4a8dcb41dfe7,tax,1721146050,1721146131,finished,1721146070,1721146131,A100-SXM4-80GB,8,1,64,896,20,61
18df197e-631d-4f76-846c-52c3893633d1,tax,1721146192,1721146273,finished,1721146212,1721146273,A100-SXM4-80GB,8,1,64,896,20,61
b28cbcb8-ebd3-4c91-970e-4b2fed940b62,tax,1721146333,1721146415,finished,1721146355,1721146415,A100-SXM4-80GB,8,1,64,896,22,60
fb39be39-1ac7-4dce-a5a0-5f7013115d1d,sp-3-dp-0701-cpt-9ab38-auto,1721146347,1721157483,finished,1721146368,1721157483,A100-SXM4-80GB,8,1,64,448,21,11115
1f274efc-03e2-4f7b-afe4-9654537e55de,tax,1721146475,1721146558,finished,1721146496,1721146558,A100-SXM4-80GB,8,1,64,896,21,62
43a9ab8a-bb3d-406b-87e2-7d0bea93db85,citysora-512-cele-ppm-from-5k512,1721146529,1721147266,finished,1721146569,1721147266,A100-SXM4-80GB,8,4,64,896,40,697
bdda9b88-7761-44fa-bae1-0842d5ef87d2,sp-8-dp-0701-cpt-b096c-auto,1721146613,1721158075,finished,1721146635,1721158075,A100-SXM4-80GB,8,1,64,448,22,11440
91b33921-fa0c-4458-a18b-67e5dd16fd3c,tax,1721146622,1721146705,finished,1721146643,1721146705,A100-SXM4-80GB,8,1,64,896,21,62
0c68c46f-fd96-4560-8e78-404842730c33,sp-9-dp-0701-cpt-c09c4-auto,1721146676,1721158235,finished,1721146697,1721158235,A100-SXM4-80GB,8,1,64,448,21,11538
2f6b330a-eb0c-4cda-a352-9906f4e0321d,tax,1721146767,1721146845,finished,1721146787,1721146845,A100-SXM4-80GB,8,1,64,896,20,58
ed93a1a8-9f93-4797-bceb-50985d6adf67,tax,1721146906,1721146988,finished,1721146926,1721146988,A100-SXM4-80GB,8,1,64,896,20,62
a59ec8ad-d148-4ec5-9c69-c2e3f303fc36,tax,1721147050,1721147131,finished,1721147071,1721147131,A100-SXM4-80GB,8,1,64,896,21,60
f30f379d-f90f-4b76-b867-c0344bc20302,tax,1721147192,1721147275,finished,1721147212,1721147275,A100-SXM4-80GB,8,1,64,896,20,63
063ad256-54ea-4010-859f-548f89064388,citysora-512-cele-ppm-from-5k512,1721147266,1721184633,finished,1721147305,1721184633,A100-SXM4-80GB,8,4,64,896,39,37328
cadedb04-6986-4f7c-bb77-1a868c6c6ff3,tax,1721147337,1721147417,finished,1721147357,1721147417,A100-SXM4-80GB,8,1,64,896,20,60
f7cbec44-b5e2-4c3b-bda5-95fc3f835c18,tax,1721147479,1721147560,finished,1721147500,1721147560,A100-SXM4-80GB,8,1,64,896,21,60
9e31fee2-8774-47ba-aa0b-32d2e0dc7c47,tax,1721147622,1721147703,finished,1721147642,1721147703,A100-SXM4-80GB,8,1,64,896,20,61
412ddf5a-7332-47cc-bc65-93cb16fbc484,tax,1721147764,1721147846,finished,1721147785,1721147846,A100-SXM4-80GB,8,1,64,896,21,61
dabcef97-4c01-4786-b63c-b2ccf7168d4e,citysora-modelv4-cele-ppm-65-256-fp,1721147817,1721165298,finished,1721147899,1721165298,A100-SXM4-80GB,8,4,64,896,82,17399
92d4c9c5-c629-4000-8251-89a452448134,tax,1721147909,1721147989,finished,1721147930,1721147989,A100-SXM4-80GB,8,1,64,896,21,59
cac3f576-dc43-47a5-af63-0884a2d998f5,tax,1721148051,1721148131,finished,1721148071,1721148131,A100-SXM4-80GB,8,1,64,896,20,60
c424c9a2-f53a-4472-a8e6-79bf5ae5313c,tax,1721148192,1721148273,finished,1721148212,1721148273,A100-SXM4-80GB,8,1,64,896,20,61
467dcd95-2e26-477a-8661-428536e6add0,tax,1721148333,1721148412,finished,1721148353,1721148412,A100-SXM4-80GB,8,1,64,896,20,59
03b15e13-6de8-4b80-9f6a-b9bf9c153250,tax,1721148473,1721148554,finished,1721148492,1721148554,A100-SXM4-80GB,8,1,64,896,19,62
7ac6b621-8226-4ad3-96ce-f806f25a0c28,tax,1721148616,1721148696,finished,1721148636,1721148696,A100-SXM4-80GB,8,1,64,896,20,60
d3758559-3486-4839-8504-7d60b655a225,tax,1721148757,1721148838,finished,1721148778,1721148838,A100-SXM4-80GB,8,1,64,896,21,60
0cdcd6cf-f015-4b0d-b7c8-4bcac3b16896,tax,1721148900,1721148982,finished,1721148921,1721148982,A100-SXM4-80GB,8,1,64,896,21,61
300f8862-1378-461e-aa56-ccfedf0d5cd0,tax,1721149042,1721149122,finished,1721149063,1721149122,A100-SXM4-80GB,8,1,64,896,21,59
5c518511-6613-4e4e-a4ff-d015b0724d77,tax,1721149185,1721149264,finished,1721149205,1721149264,A100-SXM4-80GB,8,1,64,896,20,59
448155b2-933c-44f0-9287-8f0f3e45fd05,tax,1721149327,1721149409,finished,1721149347,1721149409,A100-SXM4-80GB,8,1,64,896,20,62
998e7d96-d5fe-4f71-9fc5-b42276c50d29,tax,1721149470,1721149551,finished,1721149491,1721149551,A100-SXM4-80GB,8,1,64,896,21,60
ae4dbafa-a4ea-446b-b6ca-75e55c62e6d9,tax,1721149612,1721149694,finished,1721149633,1721149694,A100-SXM4-80GB,8,1,64,896,21,61
215d598f-b477-4fd3-9e5f-83bc28be8489,tax,1721149756,1721149838,finished,1721149777,1721149838,A100-SXM4-80GB,8,1,64,896,21,61
e9d65b7e-05ca-49e6-9b57-f37f713b4efa,tax,1721149899,1721149978,finished,1721149918,1721149978,A100-SXM4-80GB,8,1,64,896,19,60
508e52d9-115b-4279-bedb-e6a4a1a09ca7,tax,1721150040,1721150119,finished,1721150060,1721150119,A100-SXM4-80GB,8,1,64,896,20,59
4e5ee7b7-7cd2-4f66-a80c-bd75b6cd7c10,tax,1721150181,1721150261,finished,1721150201,1721150261,A100-SXM4-80GB,8,1,64,896,20,60
8eae9087-4ad9-4021-ae2c-0da5a73ecf96,tax,1721150323,1721150403,finished,1721150343,1721150403,A100-SXM4-80GB,8,1,64,896,20,60
1d6b4826-574f-4c38-96b8-9a3bb5d97aeb,tax,1721150464,1721150544,finished,1721150484,1721150544,A100-SXM4-80GB,8,1,64,896,20,60
26b46a2b-c258-4d29-a4d8-9ea0e310765a,tax,1721150606,1721150686,finished,1721150626,1721150686,A100-SXM4-80GB,8,1,64,896,20,60
eb79790f-020c-4ab4-b7c4-c62286ed79f4,tax,1721150749,1721150831,finished,1721150770,1721150831,A100-SXM4-80GB,8,1,64,896,21,61
85135b25-0f66-4c8c-9ad0-cd764dc4907d,tax,1721150892,1721150972,finished,1721150912,1721150972,A100-SXM4-80GB,8,1,64,896,20,60
48f4721b-8fec-4b37-a990-b2705542fd11,tax,1721151033,1721151112,finished,1721151052,1721151112,A100-SXM4-80GB,8,1,64,896,19,60
9862adcc-32e1-4c85-8715-cbedd4f30bad,tax,1721151174,1721151254,finished,1721151194,1721151254,A100-SXM4-80GB,8,1,64,896,20,60
74f0b6a8-08f6-4965-82b5-1f324bb800c1,tax,1721151315,1721151396,finished,1721151335,1721151396,A100-SXM4-80GB,8,1,64,896,20,61
22e98fa8-13e6-4d34-a2ae-a97901487f33,tax,1721151457,1721151537,finished,1721151477,1721151537,A100-SXM4-80GB,8,1,64,896,20,60
675ce388-4f83-4d89-b332-ea5d68d616b9,tax,1721151598,1721151678,finished,1721151619,1721151678,A100-SXM4-80GB,8,1,64,896,21,59
ae84d2bb-2694-4184-82df-c300a8f8d5fc,tax,1721151739,1721151818,finished,1721151759,1721151818,A100-SXM4-80GB,8,1,64,896,20,59
d5b4e991-d300-40e5-961e-018efb050409,tax,1721151880,1721151959,finished,1721151900,1721151959,A100-SXM4-80GB,8,1,64,896,20,59
59ed2d2f-4668-4877-8d47-534e8ea7cd4a,tax,1721152020,1721152098,finished,1721152039,1721152098,A100-SXM4-80GB,8,1,64,896,19,59
09ec93e0-3dc7-453c-91a6-bcc2a69df2a5,tax,1721152160,1721152240,finished,1721152180,1721152240,A100-SXM4-80GB,8,1,64,896,20,60
b92a2218-f166-4dbf-a908-997c680833dd,tax,1721152301,1721152382,finished,1721152322,1721152382,A100-SXM4-80GB,8,1,64,896,21,60
1a5562b6-7df2-4627-a29a-b49bc41b21cf,tax,1721152444,1721152524,finished,1721152464,1721152524,A100-SXM4-80GB,8,1,64,896,20,60
bc58d662-871f-4c43-bc17-18139d94104f,tax,1721152586,1721152667,finished,1721152607,1721152667,A100-SXM4-80GB,8,1,64,896,21,60
d0e6b281-bbef-4887-b9fb-67d001fc0965,tax,1721152729,1721152809,finished,1721152748,1721152809,A100-SXM4-80GB,8,1,64,896,19,61
e91d01ab-d00e-4170-885d-0911457e69f1,tax,1721152869,1721152950,finished,1721152889,1721152950,A100-SXM4-80GB,8,1,64,896,20,61
814c726e-f8e8-4715-b7c5-afe9f2f43390,tax,1721153011,1721153091,finished,1721153030,1721153091,A100-SXM4-80GB,8,1,64,896,19,61
952adf06-583a-4e64-961a-d6a173e863d6,tax,1721153151,1721153232,finished,1721153171,1721153232,A100-SXM4-80GB,8,1,64,896,20,61
669cd034-4d2f-4840-8185-4bc02a57b093,tax,1721153295,1721153376,finished,1721153315,1721153376,A100-SXM4-80GB,8,1,64,896,20,61
18fd4f5b-50ae-45a5-9269-c88a9c09a3b2,tax,1721153437,1721153519,finished,1721153458,1721153519,A100-SXM4-80GB,8,1,64,896,21,61
9fde9bd7-b0c0-49ed-9b57-9067cd9cf10e,tax,1721153580,1721153659,finished,1721153599,1721153659,A100-SXM4-80GB,8,1,64,896,19,60
e2a19342-05d8-4ca2-9c0e-2ee2af1da027,tax,1721153719,1721153799,finished,1721153739,1721153799,A100-SXM4-80GB,8,1,64,896,20,60
38f4633e-db1e-41cc-9d1b-d9fc01b44dfa,tax,1721153862,1721153942,finished,1721153883,1721153942,A100-SXM4-80GB,8,1,64,896,21,59
b83ab555-13c6-4967-b01c-93465e55808d,tax,1721154002,1721154080,finished,1721154022,1721154080,A100-SXM4-80GB,8,1,64,896,20,58
a2336efb-3736-4585-b5ce-c31227c60703,tax,1721154141,1721154220,finished,1721154160,1721154220,A100-SXM4-80GB,8,1,64,896,19,60
e64cb971-aab3-46f1-acb6-773b25096327,tax,1721154282,1721154362,finished,1721154302,1721154362,A100-SXM4-80GB,8,1,64,896,20,60
1f912f9c-4876-420b-a2dc-c39e93676a3c,tax,1721154424,1721154506,finished,1721154445,1721154506,A100-SXM4-80GB,8,1,64,896,21,61
9037c3a1-42f8-4efd-a65c-bd3fabf9c37e,tax,1721154567,1721154647,finished,1721154586,1721154647,A100-SXM4-80GB,8,1,64,896,19,61
4f548596-5955-47d2-92eb-1fb1bbb4bcd8,tax,1721154708,1721154790,finished,1721154729,1721154790,A100-SXM4-80GB,8,1,64,896,21,61
44a4d682-73ca-4e83-9faf-2a25f1ac8d21,tax,1721154851,1721154931,finished,1721154871,1721154931,A100-SXM4-80GB,8,1,64,896,20,60
5444c9c8-4dc6-449e-b0b4-98150aa390d6,tax,1721154992,1721155071,finished,1721155012,1721155071,A100-SXM4-80GB,8,1,64,896,20,59
6427d3d0-222b-4dd3-bd66-424a3933b78c,tax,1721155133,1721155212,finished,1721155152,1721155212,A100-SXM4-80GB,8,1,64,896,19,60
ae9466dd-1c58-4f00-92e8-9375086e0cf6,tax,1721155273,1721155353,finished,1721155293,1721155353,A100-SXM4-80GB,8,1,64,896,20,60
140efdb8-0584-4932-9555-93d545e89b8c,tax,1721155415,1721155494,finished,1721155434,1721155494,A100-SXM4-80GB,8,1,64,896,19,60
cab3a403-c459-4fe6-9714-c53e5daeaa0a,tax,1721155556,1721155637,finished,1721155577,1721155637,A100-SXM4-80GB,8,1,64,896,21,60
f69f7ea3-75d0-4178-8972-b056eb6f68e0,tax,1721155697,1721155777,finished,1721155716,1721155777,A100-SXM4-80GB,8,1,64,896,19,61
d1422522-ceaf-4fce-8c62-fdb63da00a71,tax,1721155838,1721155918,finished,1721155859,1721155918,A100-SXM4-80GB,8,1,64,896,21,59
da78a5f3-b7b8-407c-baef-b9de7aae1117,tax,1721155980,1721156059,finished,1721156000,1721156059,A100-SXM4-80GB,8,1,64,896,20,59
578925d3-3b1b-4c30-8915-9b63506c9cda,tax,1721156121,1721156203,finished,1721156142,1721156203,A100-SXM4-80GB,8,1,64,896,21,61
0f00bf46-c109-47d8-921d-e1006b3e26a9,tax,1721156264,1721156344,finished,1721156284,1721156344,A100-SXM4-80GB,8,1,64,896,20,60
ea35a675-6a40-4c46-ad63-834127b9d0db,tax,1721156405,1721156485,finished,1721156425,1721156485,A100-SXM4-80GB,8,1,64,896,20,60
06f9cde6-3e2f-49b4-874d-07edc45def38,tax,1721156545,1721156625,finished,1721156565,1721156625,A100-SXM4-80GB,8,1,64,896,20,60
0c6b62f8-2922-44be-b8a2-0f17bb039d05,tax,1721156685,1721156764,finished,1721156705,1721156764,A100-SXM4-80GB,8,1,64,896,20,59
663b5d47-504a-4491-951a-9a9d59c84cad,tax,1721156824,1721156903,finished,1721156844,1721156903,A100-SXM4-80GB,8,1,64,896,20,59
ee54f97d-57b2-4369-98aa-d05e519d9fc1,tax,1721156964,1721157046,finished,1721156984,1721157046,A100-SXM4-80GB,8,1,64,896,20,62
840caf2d-79b0-4ae6-8031-3c0c05440bc1,tax,1721157107,1721157185,finished,1721157126,1721157185,A100-SXM4-80GB,8,1,64,896,19,59
fdd50f78-b7d5-4ce3-87bf-d7075a229f4b,tax,1721157245,1721157325,finished,1721157265,1721157325,A100-SXM4-80GB,8,1,64,896,20,60
3c611271-22cc-4101-8ef4-3fad1cd70ed3,tax,1721157384,1721157471,finished,1721157405,1721157471,A100-SXM4-80GB,8,1,64,896,21,66
9e786e9c-372a-4981-9a03-3ef29a861994,eval-llama2-7b-chat,1721157433,1721157584,finished,1721157459,1721157584,A100-SXM4-80GB,8,1,64,448,26,125
3017aa1c-57e1-42c4-9711-199d1a7eea1b,geogpt-mixtral-test,1721157483,1721202056,finished,1721157543,1721202056,A100-SXM4-80GB,8,16,64,448,60,44513
66a59cd2-901b-4fc6-a355-3f939d2a6748,tax,1721157531,1721157635,finished,1721157556,1721157635,A100-SXM4-80GB,8,1,64,896,25,79
98be990d-da00-4c73-b287-0225cb2b38ca,tax,1721157696,1721157778,finished,1721157717,1721157778,A100-SXM4-80GB,8,1,64,896,21,61
f1a8ddfa-8f4a-4705-8d06-abbe06bed24f,eval-llama2-7b-chat,1721157827,1721157971,finished,1721157848,1721157971,A100-SXM4-80GB,8,1,64,448,21,123
82d1173d-dd84-4e5f-bcfb-8b39f0bdec61,tax,1721157839,1721157920,finished,1721157860,1721157920,A100-SXM4-80GB,8,1,64,896,21,60
dc42fd42-c975-459b-913e-6981d133c7be,tax,1721157983,1721158063,finished,1721158004,1721158063,A100-SXM4-80GB,8,1,64,896,21,59
ef9ae395-4f9c-407d-b834-5a4a970fc04f,tax,1721158124,1721158203,finished,1721158144,1721158203,A100-SXM4-80GB,8,1,64,896,20,59
5623906e-4ec7-48fd-9c59-1c9999d2b362,tax,1721158265,1721158345,finished,1721158284,1721158345,A100-SXM4-80GB,8,1,64,896,19,61
e18e2603-9dc1-485b-8b65-75c5495207e1,sp-q72b-dp-0701-dp-ties-w55-75506-auto,1721158358,1721170428,finished,1721158378,1721170428,A100-SXM4-80GB,8,1,64,448,20,12050
0c784f42-cb06-44f8-a5de-016e00ec4681,tax,1721158406,1721158485,finished,1721158425,1721158485,A100-SXM4-80GB,8,1,64,896,19,60
63f39575-fb2d-474f-8f03-b4ba2b29bd2d,sp-q72b-dp-0701-dp-linear-w55-e4768-auto,1721158497,1721170002,finished,1721158517,1721170002,A100-SXM4-80GB,8,1,64,448,20,11485
49f87dbf-ffdf-47ee-a343-be30d9def3b0,tax,1721158545,1721158624,finished,1721158566,1721158624,A100-SXM4-80GB,8,1,64,896,21,58
257b2123-698a-4a89-a70e-4205fff9902e,tax,1721158684,1721158763,finished,1721158703,1721158763,A100-SXM4-80GB,8,1,64,896,19,60
bfa18016-4606-4c9c-ad07-1f67b5408226,eval-llama2-7b-chat,1721158791,1721180283,finished,1721158813,1721180283,A100-SXM4-80GB,8,1,64,448,22,21470
88895c64-066c-4cee-af05-b359dba2ef14,tax,1721158825,1721158905,finished,1721158846,1721158905,A100-SXM4-80GB,8,1,64,896,21,59
a837086d-61f1-4234-8797-3458f5191ccd,tax,1721158966,1721159045,finished,1721158986,1721159045,A100-SXM4-80GB,8,1,64,896,20,59
7ab95d22-adae-4481-8ab9-8a41f3556615,q72b-sft-ep1-v1-4-0701-dpo-9c3ea-auto,1721159037,1721170265,finished,1721159058,1721170265,A100-SXM4-80GB,8,1,64,448,21,11207
5cd6c27c-aadf-4ca3-b0c3-d46a24ac748d,tax,1721159107,1721159187,finished,1721159127,1721159187,A100-SXM4-80GB,8,1,64,896,20,60
711198d9-86c7-41eb-8051-3948237c7e43,tax,1721159247,1721159328,finished,1721159267,1721159328,A100-SXM4-80GB,8,1,64,896,20,61
d2e75cc8-7ee3-4ff4-881f-c0726dbea3d4,tax,1721159390,1721159469,finished,1721159410,1721159469,A100-SXM4-80GB,8,1,64,896,20,59
61208e88-9ffd-4b4a-9358-a4725078fb87,tax,1721159530,1721159610,finished,1721159551,1721159610,A100-SXM4-80GB,8,1,64,896,21,59
c76c1c9c-b3c4-48c5-988c-fe7a97fe6b8f,tax,1721159671,1721159752,finished,1721159691,1721159752,A100-SXM4-80GB,8,1,64,896,20,61
f2fdae25-ee17-4870-aec6-d8206ed29568,tax,1721159815,1721159895,finished,1721159835,1721159895,A100-SXM4-80GB,8,1,64,896,20,60
1d44219e-507d-4848-ae6a-8cf48a285236,tax,1721159956,1721160037,finished,1721159976,1721160037,A100-SXM4-80GB,8,1,64,896,20,61
5750ddc7-79b5-496e-bf52-de8057c5ff88,tax,1721160098,1721160178,finished,1721160119,1721160178,A100-SXM4-80GB,8,1,64,896,21,59
0238dabf-2994-4f3d-9905-a2b8c9dc2205,tax,1721160239,1721160319,finished,1721160259,1721160319,A100-SXM4-80GB,8,1,64,896,20,60
9f091b96-40b9-46e0-af63-30cad49b454a,tax,1721160379,1721160459,finished,1721160399,1721160459,A100-SXM4-80GB,8,1,64,896,20,60
76426009-46dd-40e1-9b6a-0fe6bcadae98,tax,1721160520,1721160599,finished,1721160540,1721160599,A100-SXM4-80GB,8,1,64,896,20,59
2a5d18b5-8ad7-41f0-b160-31c200041d00,tax,1721160661,1721160739,finished,1721160681,1721160739,A100-SXM4-80GB,8,1,64,896,20,58
8f031e6e-46c0-45ff-9498-75facb5d8b11,tax,1721160800,1721160879,finished,1721160820,1721160879,A100-SXM4-80GB,8,1,64,896,20,59
e284da45-f012-4360-ac39-fbd4ed21a38b,tax,1721160938,1721161018,finished,1721160959,1721161018,A100-SXM4-80GB,8,1,64,896,21,59
70bc9a99-ab1c-428a-952f-378a9328d615,tax,1721161079,1721161159,finished,1721161100,1721161159,A100-SXM4-80GB,8,1,64,896,21,59
1a391fc8-c9e3-4034-b376-1819a967ecab,tax,1721161220,1721161299,finished,1721161240,1721161299,A100-SXM4-80GB,8,1,64,896,20,59
fe79681a-facd-4e31-a061-40936c909847,tax,1721161360,1721161439,finished,1721161379,1721161439,A100-SXM4-80GB,8,1,64,896,19,60
862d377c-1b82-4d79-87a3-49f6bea1559c,tax,1721161499,1721161581,finished,1721161520,1721161581,A100-SXM4-80GB,8,1,64,896,21,61
3a0029e6-9009-4ff6-979b-05fafcb6d701,tax,1721161642,1721161721,finished,1721161662,1721161721,A100-SXM4-80GB,8,1,64,896,20,59
61fe3e8e-95c6-420e-9c5b-cf9b7b321018,tax,1721161782,1721161862,finished,1721161803,1721161862,A100-SXM4-80GB,8,1,64,896,21,59
03624e29-e1a4-4b3e-a3cf-a78ad6c4584f,tax,1721161922,1721162001,finished,1721161942,1721162001,A100-SXM4-80GB,8,1,64,896,20,59
bc919930-e842-4bbb-949f-5de87eb6e7fe,tax,1721162063,1721162142,finished,1721162083,1721162142,A100-SXM4-80GB,8,1,64,896,20,59
586dcf34-969b-427f-a4e9-d8e5cf578047,tax,1721162203,1721162282,finished,1721162222,1721162282,A100-SXM4-80GB,8,1,64,896,19,60
a0e36e46-aa62-434c-abc8-880225458408,tax,1721162342,1721162422,finished,1721162363,1721162422,A100-SXM4-80GB,8,1,64,896,21,59
6c1195d1-1b7b-4723-bc13-e2c25e1545b7,tax,1721162484,1721162563,finished,1721162504,1721162563,A100-SXM4-80GB,8,1,64,896,20,59
cf0b6448-a28d-43f8-9564-048ebedc28b7,tax,1721162623,1721162705,finished,1721162643,1721162705,A100-SXM4-80GB,8,1,64,896,20,62
0a18a0ad-d5b7-4233-8f0c-827b713468bf,tax,1721162765,1721162844,finished,1721162785,1721162844,A100-SXM4-80GB,8,1,64,896,20,59
aeddc673-849a-413a-b113-1d753cb5aa4a,tax,1721162905,1721162984,finished,1721162926,1721162984,A100-SXM4-80GB,8,1,64,896,21,58
61a53614-8cc1-4b18-8fb6-ae39b3b21d22,tax,1721163044,1721163124,finished,1721163065,1721163124,A100-SXM4-80GB,8,1,64,896,21,59
dbd991b8-bc57-417c-aabc-6179b52b2bcf,tax,1721163185,1721163264,finished,1721163205,1721163264,A100-SXM4-80GB,8,1,64,896,20,59
a42163b3-5c24-449c-8d29-b85de78e91f0,tax,1721163325,1721163405,finished,1721163346,1721163405,A100-SXM4-80GB,8,1,64,896,21,59
132c9f78-1274-424e-aca9-366fb2832a3d,tax,1721163465,1721163551,finished,1721163486,1721163551,A100-SXM4-80GB,8,1,64,896,21,65
6778e451-6f8a-49b3-a247-f5044e20af78,tax,1721163614,1721165604,finished,1721163634,1721165604,A100-SXM4-80GB,8,1,64,896,20,1970
6b1306c8-387c-424c-a1d9-98004dd81d1f,citysora-modelv4-cele-ppm-65-256-fp,1721165358,1721182871,finished,1721165417,1721182871,A100-SXM4-80GB,8,4,64,896,59,17454
797805f5-25ff-485c-9bb5-71f724108f7f,tax,1721165664,1721166956,finished,1721165684,1721166956,A100-SXM4-80GB,8,1,64,896,20,1272
6338b6db-09da-4397-bb31-cda6d471b116,tax,1721167018,1721167096,finished,1721167037,1721167096,A100-SXM4-80GB,8,1,64,896,19,59
ff66a838-9059-4df1-a52c-6925c95dd4b5,tax,1721167157,1721167240,finished,1721167177,1721167240,A100-SXM4-80GB,8,1,64,896,20,63
f60823c6-b016-478b-b44d-5111197759a2,tax,1721167301,1721167380,finished,1721167321,1721167380,A100-SXM4-80GB,8,1,64,896,20,59
d2afbf15-c625-4fab-9591-1430e3566f30,tax,1721167439,1721167520,finished,1721167459,1721167520,A100-SXM4-80GB,8,1,64,896,20,61
f8ad203a-3bf3-4196-a4b3-e1242d9d046a,tax,1721167581,1721167662,finished,1721167602,1721167662,A100-SXM4-80GB,8,1,64,896,21,60
56b3ed98-33cf-46a5-b4f7-faef2017ac10,tax,1721167723,1721167802,finished,1721167743,1721167802,A100-SXM4-80GB,8,1,64,896,20,59
eba1a8e7-c7de-402c-8187-632d54e748bf,tax,1721167863,1721167943,finished,1721167883,1721167943,A100-SXM4-80GB,8,1,64,896,20,60
92694370-f8e5-4577-b1cd-c6dc5dea3288,tax,1721168004,1721168084,finished,1721168024,1721168084,A100-SXM4-80GB,8,1,64,896,20,60
de79949d-9955-4b8a-84c3-8b058d3c2e74,tax,1721168145,1721168225,finished,1721168165,1721168225,A100-SXM4-80GB,8,1,64,896,20,60
2a04537b-3967-4422-9516-6b5e99f8ce17,tax,1721168285,1721168363,finished,1721168305,1721168363,A100-SXM4-80GB,8,1,64,896,20,58
9f0cfc8b-fa2f-4e03-a462-4687cb39e709,tax,1721168423,1721168503,finished,1721168443,1721168503,A100-SXM4-80GB,8,1,64,896,20,60
71c10f71-96b5-4e98-b82d-410c5477adc2,tax,1721168563,1721168642,finished,1721168583,1721168642,A100-SXM4-80GB,8,1,64,896,20,59
1c2a733b-d65d-4931-9724-c25fce7f7245,tax,1721168702,1721168783,finished,1721168723,1721168783,A100-SXM4-80GB,8,1,64,896,21,60
de27254a-5d5a-4a86-a802-a3b908f2ad33,tax,1721168844,1721168924,finished,1721168864,1721168924,A100-SXM4-80GB,8,1,64,896,20,60
0c6b49f3-0657-4179-bf55-8a1e9372aa8f,tax,1721168985,1721169063,finished,1721169004,1721169063,A100-SXM4-80GB,8,1,64,896,19,59
133214b3-e045-4c3d-a366-288e20a98fd9,tax,1721169124,1721169204,finished,1721169145,1721169204,A100-SXM4-80GB,8,1,64,896,21,59
467131de-8731-4051-b39f-4f88129ba045,tax,1721169266,1721169345,finished,1721169286,1721169345,A100-SXM4-80GB,8,1,64,896,20,59
6c4d4052-7358-4a0b-a775-f5e9c92def45,tax,1721169407,1721169486,finished,1721169427,1721169486,A100-SXM4-80GB,8,1,64,896,20,59
388533a0-fe86-4960-b026-c58e3d7c5e3c,tax,1721169547,1721169627,finished,1721169567,1721169627,A100-SXM4-80GB,8,1,64,896,20,60
33a1aff0-a1f2-4c80-b593-fe89ddc3c062,tax,1721169688,1721169768,finished,1721169708,1721169768,A100-SXM4-80GB,8,1,64,896,20,60
bd20d8de-106a-47d2-ae64-1031a35b13b5,tax,1721169829,1721169909,finished,1721169849,1721169909,A100-SXM4-80GB,8,1,64,896,20,60
343bd6ff-cd40-4c2c-8f69-077fb5a85288,tax,1721169970,1721170050,finished,1721169989,1721170050,A100-SXM4-80GB,8,1,64,896,19,61
5ff6ce58-16fb-4325-88ca-828a8c7ed890,tax,1721170112,1721170191,finished,1721170132,1721170191,A100-SXM4-80GB,8,1,64,896,20,59
a26eed18-2a70-4a5e-a5b3-df3e7a865605,tax,1721170252,1721170336,finished,1721170273,1721170336,A100-SXM4-80GB,8,1,64,896,21,63
2f04fb1b-9700-40cb-8e67-bb8c5bf0dc75,tax,1721170396,1721170476,finished,1721170415,1721170476,A100-SXM4-80GB,8,1,64,896,19,61
a0b3526f-ab30-42bf-bc57-d2c1add4c8e1,tax,1721170539,1721170620,finished,1721170559,1721170620,A100-SXM4-80GB,8,1,64,896,20,61
a65df65b-9889-41d2-831f-a5e0ce40c737,tax,1721170679,1721170761,finished,1721170699,1721170761,A100-SXM4-80GB,8,1,64,896,20,62
ac769d13-ed64-47ec-9e35-1b44fdd7c10a,tax,1721170822,1721170903,finished,1721170842,1721170903,A100-SXM4-80GB,8,1,64,896,20,61
53dfda95-88f5-4ed4-9c3a-0e1d424bebf0,tax,1721170963,1721171042,finished,1721170983,1721171042,A100-SXM4-80GB,8,1,64,896,20,59
cbf6ecde-f093-4f93-a5cf-4663d84a0bce,tax,1721171103,1721171184,finished,1721171124,1721171184,A100-SXM4-80GB,8,1,64,896,21,60
4f514514-5904-4183-8bba-f667ea9cf0d8,tax,1721171245,1721171325,finished,1721171266,1721171325,A100-SXM4-80GB,8,1,64,896,21,59
7edbfb01-6747-49f4-a592-2bea5bc13209,tax,1721171386,1721171466,finished,1721171408,1721171466,A100-SXM4-80GB,8,1,64,896,22,58
2c8be1cd-96ad-401f-ab64-84f5710afb0d,tax,1721171528,1721171608,finished,1721171549,1721171608,A100-SXM4-80GB,8,1,64,896,21,59
4b44209d-733d-4843-be82-68cf7e04c219,tax,1721171671,1721171751,finished,1721171691,1721171751,A100-SXM4-80GB,8,1,64,896,20,60
7568824b-ac28-457b-ba12-45e692d1e2bd,tax,1721171812,1721171893,finished,1721171832,1721171893,A100-SXM4-80GB,8,1,64,896,20,61
3503a100-2880-4e4a-8e3d-0861f79b0ef1,tax,1721171955,1721172033,finished,1721171975,1721172033,A100-SXM4-80GB,8,1,64,896,20,58
c7a83903-9203-419c-bb5c-6b815b4e74d0,tax,1721172094,1721172176,finished,1721172114,1721172176,A100-SXM4-80GB,8,1,64,896,20,62
72989cde-8b1f-4de3-a534-3dccb35b58fd,tax,1721172236,1721172317,finished,1721172256,1721172317,A100-SXM4-80GB,8,1,64,896,20,61
b48e269b-4451-420e-b9c8-073fb8d70784,tax,1721172377,1721172459,finished,1721172397,1721172459,A100-SXM4-80GB,8,1,64,896,20,62
7c2cd521-5e2e-46f1-a87a-4fe688e504f1,tax,1721172518,1721172598,finished,1721172539,1721172598,A100-SXM4-80GB,8,1,64,896,21,59
b192167a-c845-43e4-8068-57a8927414d4,tax,1721172659,1721172738,finished,1721172678,1721172738,A100-SXM4-80GB,8,1,64,896,19,60
86845ea3-c3c9-401a-afa5-b060309f4b41,tax,1721172800,1721172880,finished,1721172820,1721172880,A100-SXM4-80GB,8,1,64,896,20,60
0e1d5f7d-c758-4fd8-9e66-33b1cb3fe478,tax,1721172943,1721173024,finished,1721172962,1721173024,A100-SXM4-80GB,8,1,64,896,19,62
429a647a-b116-409e-824b-91d8c6aa4d47,tax,1721173085,1721173164,finished,1721173105,1721173164,A100-SXM4-80GB,8,1,64,896,20,59
8802d2e1-7a4f-4145-a589-ff9e5970d89e,tax,1721173225,1721173306,finished,1721173246,1721173306,A100-SXM4-80GB,8,1,64,896,21,60
06dd1441-ec84-4f34-809a-e002ece817c5,tax,1721173367,1721173447,finished,1721173388,1721173447,A100-SXM4-80GB,8,1,64,896,21,59
2e226e08-6302-4da4-b4d5-67a82e44f8f8,tax,1721173508,1721173589,finished,1721173529,1721173589,A100-SXM4-80GB,8,1,64,896,21,60
8f76f839-bc87-4d02-a5e1-26209e66bd69,tax,1721173651,1721173729,finished,1721173670,1721173729,A100-SXM4-80GB,8,1,64,896,19,59
0f37086b-731a-4653-bc40-7fb881136434,tax,1721173790,1721173870,finished,1721173810,1721173870,A100-SXM4-80GB,8,1,64,896,20,60
5e29c5b9-7eab-4125-b3d7-e74f2b697774,tax,1721173931,1721174011,finished,1721173951,1721174011,A100-SXM4-80GB,8,1,64,896,20,60
fbe63723-e087-4e29-ad02-57fb63c0aff5,tax,1721174072,1721174153,finished,1721174093,1721174153,A100-SXM4-80GB,8,1,64,896,21,60
85a011fe-233e-4c0c-be21-7f182249b5dc,tax,1721174214,1721174295,finished,1721174235,1721174295,A100-SXM4-80GB,8,1,64,896,21,60
b2d709c4-9726-4e91-a763-ba2091bc6956,tax,1721174355,1721174436,finished,1721174375,1721174436,A100-SXM4-80GB,8,1,64,896,20,61
23867f20-791d-48d1-a9c3-e6f5821e24c4,tax,1721174498,1721174578,finished,1721174518,1721174578,A100-SXM4-80GB,8,1,64,896,20,60
f89c8a60-ec61-4497-83fa-53f85a1f4659,tax,1721174638,1721174718,finished,1721174658,1721174718,A100-SXM4-80GB,8,1,64,896,20,60
99843700-971a-4d3b-a4f4-afea0ea12d59,tax,1721174778,1721174860,finished,1721174798,1721174860,A100-SXM4-80GB,8,1,64,896,20,62
2a1d3140-fc5d-4eff-989e-0917c20926fa,tax,1721174920,1721175000,finished,1721174940,1721175000,A100-SXM4-80GB,8,1,64,896,20,60
a53b8fef-aa68-40fe-b929-9438aad76fdc,tax,1721175060,1721175140,finished,1721175080,1721175140,A100-SXM4-80GB,8,1,64,896,20,60
a5ec98a1-905b-4d32-8c97-1c606ac90cde,tax,1721175200,1721175280,finished,1721175220,1721175280,A100-SXM4-80GB,8,1,64,896,20,60
82b1fc5d-2f8e-4655-b075-a7946b6a50bb,tax,1721175341,1721175421,finished,1721175362,1721175421,A100-SXM4-80GB,8,1,64,896,21,59
590d2b1c-e322-4ee7-ab3f-03f710e4765c,tax,1721175483,1721175563,finished,1721175503,1721175563,A100-SXM4-80GB,8,1,64,896,20,60
73d36cd7-4baf-4bd0-ac06-938cbbc8ef01,tax,1721175623,1721175705,finished,1721175644,1721175705,A100-SXM4-80GB,8,1,64,896,21,61
e9cc2fb4-d216-4fe0-94de-a79d563e5a2e,tax,1721175765,1721175845,finished,1721175785,1721175845,A100-SXM4-80GB,8,1,64,896,20,60
77fa9e34-44d4-4911-8ebe-dc4afa23f0b6,tax,1721175907,1721175989,finished,1721175927,1721175989,A100-SXM4-80GB,8,1,64,896,20,62
b32765a9-c5b5-4d2f-886d-4569d78d176d,tax,1721176049,1721176129,finished,1721176069,1721176129,A100-SXM4-80GB,8,1,64,896,20,60
bfcb7750-3759-455f-b02b-4ed2d345a1e6,tax,1721176189,1721176272,finished,1721176210,1721176272,A100-SXM4-80GB,8,1,64,896,21,62
c51741b9-e0ce-4b4d-94e1-cc8ead728cfe,tax,1721176331,1721176411,finished,1721176351,1721176411,A100-SXM4-80GB,8,1,64,896,20,60
94def4d6-a224-472f-91e3-318900af513e,tax,1721176471,1721176550,finished,1721176491,1721176550,A100-SXM4-80GB,8,1,64,896,20,59
7bdee5ba-8960-41e5-bca0-be394985c898,tax,1721176612,1721176691,finished,1721176632,1721176691,A100-SXM4-80GB,8,1,64,896,20,59
a53bace3-c21d-4bc6-a2ff-a2abe45cd0a8,tax,1721176753,1721176831,finished,1721176774,1721176831,A100-SXM4-80GB,8,1,64,896,21,57
be88bf1c-2d15-4487-a146-e00fa220cb07,tax,1721176893,1721176972,finished,1721176913,1721176972,A100-SXM4-80GB,8,1,64,896,20,59
f066f7bf-de97-4524-a67e-48c6661e36a6,tax,1721177033,1721177112,finished,1721177054,1721177112,A100-SXM4-80GB,8,1,64,896,21,58
61cd81c6-90ba-4568-94a5-e26f0c144832,tax,1721177172,1721177254,finished,1721177193,1721177254,A100-SXM4-80GB,8,1,64,896,21,61
7cd3dd75-01a9-47ed-a5a0-bbbff4f1519b,tax,1721177314,1721177393,finished,1721177334,1721177393,A100-SXM4-80GB,8,1,64,896,20,59
53ec0ae6-2d8c-4074-9dfb-21672c969890,tax,1721177454,1721177537,finished,1721177474,1721177537,A100-SXM4-80GB,8,1,64,896,20,63
73b0966e-288d-48a7-94ce-49df52f0d4f4,tax,1721177597,1721177677,finished,1721177617,1721177677,A100-SXM4-80GB,8,1,64,896,20,60
b4ddac03-cb2c-47b4-96ec-5f76b314c7eb,tax,1721177738,1721177818,finished,1721177758,1721177818,A100-SXM4-80GB,8,1,64,896,20,60
0892b670-6aa9-4cbb-bb6a-141d1eae07b3,tax,1721177879,1721177961,finished,1721177899,1721177961,A100-SXM4-80GB,8,1,64,896,20,62
8dee8fe2-2987-409f-9cc0-b939e6a7244b,tax,1721178021,1721178103,finished,1721178041,1721178103,A100-SXM4-80GB,8,1,64,896,20,62
6d50064d-fe4e-49a8-b94b-91a2b75f39ef,tax,1721178163,1721178244,finished,1721178184,1721178244,A100-SXM4-80GB,8,1,64,896,21,60
98c30300-2cc5-4d69-9f7e-461388e91caf,tax,1721178305,1721178386,finished,1721178326,1721178386,A100-SXM4-80GB,8,1,64,896,21,60
d97e5b88-73dd-4236-9513-61d29b2e32c6,tax,1721178448,1721178528,finished,1721178468,1721178528,A100-SXM4-80GB,8,1,64,896,20,60
bbb8c9eb-1fd9-4d8a-b7cf-3579fadf8066,tax,1721178589,1721178669,finished,1721178610,1721178669,A100-SXM4-80GB,8,1,64,896,21,59
ae16a4a3-72b5-4ade-96f4-33b18c238637,tax,1721178731,1721178819,finished,1721178758,1721178819,A100-SXM4-80GB,8,1,64,896,27,61
04f3b248-4c92-4958-a7ae-bae40ef39702,tax,1721178881,1721178962,finished,1721178901,1721178962,A100-SXM4-80GB,8,1,64,896,20,61
63f30a4e-84a2-4d9b-82ae-ecd36971b197,debug,1721178970,1721190126,finished,1721179035,1721190126,A100-SXM4-80GB,8,2,64,896,65,11091
fdf01fa3-5e87-448c-b29d-a7d35af7a241,tax,1721179026,1721179106,finished,1721179046,1721179106,A100-SXM4-80GB,8,1,64,896,20,60
02bf24c9-eb73-4e4b-9a7e-a787b389933f,tax,1721179168,1721179247,finished,1721179189,1721179247,A100-SXM4-80GB,8,1,64,896,21,58
01d325d7-38ff-413d-8c07-8adb84817a50,tax,1721179308,1721179396,finished,1721179328,1721179396,A100-SXM4-80GB,8,1,64,896,20,68
8ec85f3c-d6bf-4a5b-aa0d-9fb2ea90b99a,d,1721179336,1721179530,finished,1721179381,1721179530,A100-SXM4-80GB,8,2,64,896,45,149
23e3a197-683c-4dc5-b6ee-9f1b267bb24b,geogpt-sft-2m-of-3-9m-all-llama3-8b,1721179388,1721185172,finished,1721181543,1721185172,A100-SXM4-80GB,8,16,64,448,2155,3629
7ea8fe69-503a-41ad-805e-e9a698b6767c,tax,1721179459,1721179543,finished,1721179481,1721179543,A100-SXM4-80GB,8,1,64,896,22,62
66b95eed-bae7-43c5-9357-56208ece7e91,d,1721179570,1721179772,finished,1721179630,1721179772,A100-SXM4-80GB,8,2,64,896,60,142
8be57fbb-7011-4f6d-8921-a41d5d2779a7,tax,1721179604,1721179685,finished,1721179623,1721179685,A100-SXM4-80GB,8,1,64,896,19,62
e56e8895-769d-4723-8ee5-26b5d09c0f34,tax,1721179745,1721179826,finished,1721179766,1721179826,A100-SXM4-80GB,8,1,64,896,21,60
bae42cde-2cc3-49fe-9907-0203a2aaed50,tax,1721179890,1721179969,finished,1721179909,1721179969,A100-SXM4-80GB,8,1,64,896,19,60
1bed62b7-8adb-461d-994f-87e382597a21,tax,1721180031,1721180112,finished,1721180051,1721180112,A100-SXM4-80GB,8,1,64,896,20,61
a251c5f3-e542-4fb6-b294-13579c90ce00,tax,1721180174,1721180254,finished,1721180194,1721180254,A100-SXM4-80GB,8,1,64,896,20,60
3bccc0bc-ab8f-43cd-a681-65c543a9e2c8,llama3-8b-cpt-80k-4b-07707-auto,1721180279,1721206886,finished,1721180301,1721206886,A100-SXM4-80GB,8,1,64,896,22,26585
c90891ff-6fa3-4991-85c4-0be91973cda1,llama3-8b-cpt-80k-3b-6198d-auto,1721180301,1721180754,finished,1721180322,1721180754,A100-SXM4-80GB,8,1,64,896,21,432
eeb2b2f8-3f41-406d-81c0-9e8226173cd6,tax,1721180317,1721180397,finished,1721180338,1721180397,A100-SXM4-80GB,8,1,64,896,21,59
03c487be-b89a-4062-a378-59bb3f66e972,d,1721180448,1721180611,finished,1721180488,1721180611,A100-SXM4-80GB,8,2,64,896,40,123
b38fac77-3697-4f47-84b6-b596aad86b38,tax,1721180461,1721180541,finished,1721180481,1721180541,A100-SXM4-80GB,8,1,64,896,20,60
1c5d5def-00ac-47f6-a867-b787cb5f7ccb,tax,1721180604,1721180686,finished,1721180625,1721180686,A100-SXM4-80GB,8,1,64,896,21,61
fa2d5f7a-e283-4ae1-b749-f81ab8b92ef6,d,1721180713,1721180901,finished,1721180756,1721180901,A100-SXM4-80GB,8,2,64,896,43,145
f893fab7-030b-4496-9d6d-1e3dc21224e7,llama-actsave,1721180715,1721195791,finished,1721180738,1721195791,A100-SXM4-80GB,8,1,64,448,23,15053
a228131e-f1f5-4bb5-bd7a-fb9002a771ad,tax,1721180749,1721180831,finished,1721180771,1721180831,A100-SXM4-80GB,8,1,64,896,22,60
0a492174-3571-482e-803a-e7239969254f,tax,1721180893,1721181007,finished,1721180914,1721181007,A100-SXM4-80GB,8,1,64,896,21,93
d27439ad-afc7-4108-8a25-e8a85195ecdc,geogpt-chat-s2-sft40w,1721180940,1721182745,finished,1721180960,1721182745,A100-SXM4-80GB,8,1,64,448,20,1785
14697e68-ca64-490e-a98d-f78ea4d3d8a2,geogpt-chat-s2-sft40-c,1721180981,1721358661,finished,1721181002,1721358661,A100-SXM4-80GB,8,1,64,448,21,177659
24d8bd24-bbd2-49c4-a660-83a9710eef85,geogpt-chat-s2-sft9w,1721181023,1721182086,finished,1721181046,1721182086,A100-SXM4-80GB,8,1,64,448,23,1040
ed4583e3-70e9-4320-b8ec-a822a9a1b917,geogpt-chat-s2-sft9w-c,1721181046,1721328473,finished,1721181079,1721328473,A100-SXM4-80GB,8,1,64,448,33,147394
bdaf53f2-4113-4c48-b5bd-7ad89bb316b9,tax,1721181084,1721181165,finished,1721181104,1721181165,A100-SXM4-80GB,8,1,64,896,20,61
6c3b874f-e58b-4d48-afc7-19472ac97e74,llama3-8b-cpt-80k-3b-6198d-auto,1721181190,1721207752,finished,1721181214,1721207752,A100-SXM4-80GB,8,1,64,896,24,26538
ca4e9632-658f-49de-bd1f-b513b07bdd8b,d,1721181216,1721181416,finished,1721181275,1721181416,A100-SXM4-80GB,8,2,64,896,59,141
5846ba1c-3f1b-4aeb-8ce9-1d35a7dc1f19,tax,1721181229,1721181311,finished,1721181249,1721181311,A100-SXM4-80GB,8,1,64,896,20,62
6a4b98eb-e090-4272-aeda-bbea0056f600,reranker-inference11,1721181295,1721354279,finished,1721181317,1721354279,A100-SXM4-80GB,8,1,64,448,22,172962
a87bbcf1-880b-4fd6-b507-5e98ebf62e79,reranker-base,1721181295,1721355208,finished,1721182118,1721355208,A100-SXM4-80GB,8,1,64,896,823,173090
2af494fb-6346-41c3-8624-b4e9e4e1506f,tax,1721181370,1721181449,finished,1721181391,1721181449,A100-SXM4-80GB,8,1,64,896,21,58
ec77ce4b-d0c5-4477-84f8-b4113a0c5aa2,tax,1721181510,1721181595,finished,1721181531,1721181595,A100-SXM4-80GB,8,1,64,896,21,64
43b4258a-f83a-4307-80e6-0076618d1fa9,d,1721181537,1721182182,finished,1721181602,1721182182,A100-SXM4-80GB,8,2,64,896,65,580
e6555fd9-b2a5-44d9-91ff-3e8f8c181376,tax,1721181661,1721182111,finished,1721181680,1721182111,A100-SXM4-80GB,8,1,64,896,19,431
01ae9de8-539d-4943-9b04-72745f54e4f2,linux-env-cp,1721182060,1721183429,finished,1721182079,1721183429,A100-SXM4-80GB,8,1,64,448,19,1350
c6e7527b-aa06-4b83-90b0-b7ed7ed4f692,tax,1721182176,1721182257,finished,1721182196,1721182257,A100-SXM4-80GB,8,1,64,896,20,61
669f750b-4a8d-4a8a-a3da-4108e78e9a35,d,1721182306,1721182845,finished,1721182347,1721182845,A100-SXM4-80GB,8,2,64,896,41,498
eb59b254-4289-4f83-82cf-6e2517ec6ff8,tax,1721182320,1721182816,finished,1721182340,1721182816,A100-SXM4-80GB,8,1,64,896,20,476
30db0f8e-e33d-496d-bb0b-827ba5f25896,sora-dev-001,1721182387,1721820933,finished,1721182777,1721820933,A100-SXM4-80GB,8,1,64,896,390,638156
03a83d59-43df-46be-ad84-5d14afca977e,citysora-modelv4-cele-ppm-65-256-fp,1721182871,1721193189,finished,1721182936,1721193189,A100-SXM4-80GB,8,4,64,896,65,10253
210b4162-ea72-44ca-a070-63d68a330b07,tax,1721182880,1721182968,finished,1721182903,1721182968,A100-SXM4-80GB,8,1,64,896,23,65
e921b631-dc7d-4465-83f1-d9a131bcf74f,train-0715B,1721182886,1721185037,finished,1721182908,1721185037,A100-SXM4-80GB,8,1,64,896,22,2129
e48e8faf-ee7f-4744-9a49-ad6257f0815a,d,1721182910,1721183265,finished,1721182974,1721183265,A100-SXM4-80GB,8,2,64,896,64,291
0179ddbd-0010-4994-a2bb-1d12d597f03b,tax,1721183030,1721183526,finished,1721183052,1721183526,A100-SXM4-80GB,8,1,64,896,22,474
56c29954-0e08-4aa3-8157-5581ea4d982b,geo-seesaw-sft-code-alpaca-ultra-eval-test,1721183125,1721284110,finished,1721183145,1721284110,A100-SXM4-80GB,8,1,64,896,20,100965
96e4ca62-0c70-4744-8934-c8c75eac7f50,d,1721183266,1721183931,finished,1721183448,1721183931,A100-SXM4-80GB,8,2,64,896,182,483
0cc502a7-28d4-44e0-8e61-7d90c1a71001,linux-env-cp,1721183429,1721184134,finished,1721183448,1721184134,A100-SXM4-80GB,8,1,64,448,19,686
19c15e1d-502e-48e5-a4da-750bc9d67b35,tax,1721183586,1721183946,finished,1721183608,1721183946,A100-SXM4-80GB,8,1,64,896,22,338
5bd0e1af-79a0-47db-b028-516ec66648fc,geogpt-sft-1m-of-3-9m-all-llama3-8b,1721183685,1721194476,finished,1721183936,1721194476,A100-SXM4-80GB,8,4,64,448,251,10540
fb6a1f0a-c8fc-4104-8e9e-50d6da901b4f,tax,1721184013,1721184169,finished,1721184035,1721184169,A100-SXM4-80GB,8,1,64,896,22,134
9dee3d69-515c-4d75-a30d-b2bbd490d220,linux-env-cp,1721184134,1721351741,finished,1721184156,1721351741,A100-SXM4-80GB,8,1,64,448,22,167585
e17cb30c-d7fa-4887-8ad6-3f97b45452a1,tax,1721184232,1721184664,finished,1721184252,1721184664,A100-SXM4-80GB,8,1,64,896,20,412
e1727b06-9757-4027-8525-681f4d32135e,citysora-debug-losses,1721184611,1721184895,finished,1721184695,1721184895,A100-SXM4-80GB,8,4,64,896,84,200
aa7b000e-9036-4a54-b3dc-dfa933cd2b21,lf-sft-32k-2nodes,1721184716,1721194511,finished,1721184911,1721194511,A100-SXM4-80GB,8,2,64,448,195,9600
e293e6db-b495-4cfe-bd24-f34f698817d8,tax,1721184730,1721185358,finished,1721184750,1721185358,A100-SXM4-80GB,8,1,64,896,20,608
d36355a1-af4b-4bb2-ae5b-9c8b153b827f,citysora-cal-losses,1721184849,1721192908,finished,1721184916,1721192908,A100-SXM4-80GB,8,1,64,896,67,7992
69832fa6-0434-472c-b03a-1b69652499c3,train-0715B,1721185037,1721195830,finished,1721185057,1721195830,A100-SXM4-80GB,8,1,64,896,20,10773
37173781-5109-4fc7-826d-01eb1f449146,geogpt-sft-2m-of-3-9m-all-llama3-8b,1721185172,1721226836,finished,1721198678,1721226836,A100-SXM4-80GB,8,16,64,448,13506,28158
6f779713-52a1-492d-b345-0c747a708199,tax,1721185418,1721185501,finished,1721185439,1721185501,A100-SXM4-80GB,8,1,64,896,21,62
6d419117-d868-479f-9c75-788ad8b24aaa,vllm-qwen2,1721185447,1721191759,finished,1721185467,1721191759,A100-SXM4-80GB,8,1,64,896,20,6292
b79b62ee-8a82-4d21-937f-cd997e97f77b,tax,1721185564,1721185647,finished,1721185586,1721185647,A100-SXM4-80GB,8,1,64,896,22,61
3998aa43-58b0-4726-8a5c-188f4d4b3768,citysora-debug-losses,1721185575,1721192931,finished,1721185597,1721192931,A100-SXM4-80GB,8,1,64,896,22,7334
6fb7f56c-7c0b-4545-9682-35f7ec65a68e,tax,1721185711,1721185794,finished,1721185732,1721185794,A100-SXM4-80GB,8,1,64,896,21,62
daa0af39-f323-4ecb-8b5a-2eb0774af4fd,moe-sft,1721185716,1721186166,finished,1721185736,1721186166,A100-SXM4-80GB,8,1,64,896,20,430
2929fb23-44f9-4a80-aa58-9a2787363774,tax,1721185856,1721185937,finished,1721185876,1721185937,A100-SXM4-80GB,8,1,64,896,20,61
435d8a69-13ae-46ea-8c42-ad764f19a84d,tax,1721185999,1721186079,finished,1721186019,1721186079,A100-SXM4-80GB,8,1,64,896,20,60
c290a201-ede8-4c1b-b511-fb7c1090caa0,tax,1721186142,1721186223,finished,1721186162,1721186223,A100-SXM4-80GB,8,1,64,896,20,61
47f3e341-288b-421a-8c12-344a3e9ee096,tax,1721186287,1721186369,finished,1721186309,1721186369,A100-SXM4-80GB,8,1,64,896,22,60
549c0fd1-0f5e-46b0-afab-bc07a2910bf8,tax,1721186431,1721186513,finished,1721186451,1721186513,A100-SXM4-80GB,8,1,64,896,20,62
bace0411-b85f-4bb0-a665-b6e4fd958b3d,tax,1721186575,1721186659,finished,1721186596,1721186659,A100-SXM4-80GB,8,1,64,896,21,63
0d379407-6b0c-49b9-b4cf-f2fd97b02acd,train-7b,1721186615,1721203829,finished,1721186636,1721203829,A100-SXM4-80GB,4,1,32,448,21,17193
81d9043b-4f67-4a91-b387-a462a9c53348,tax,1721186721,1721186802,finished,1721186741,1721186802,A100-SXM4-80GB,8,1,64,896,20,61
0df1d99d-991b-4237-8d91-9afb380a0bf2,geogpt-dairui-model-merge-exp-1,1721186814,1721188506,finished,1721186834,1721188506,A100-SXM4-80GB,8,1,64,896,20,1672
3ccd9b23-0e8d-4d50-96cf-e7541d80944c,tax,1721186865,1721186946,finished,1721186885,1721186946,A100-SXM4-80GB,8,1,64,896,20,61
4195c524-20d7-4b4d-9d8f-0b8ba39c846b,geo-72B-zero3,1721187002,1721193083,finished,1721188569,1721193083,A100-SXM4-80GB,8,8,64,896,1567,4514
3a480d24-89ab-49c1-a199-21861dfb3495,tax,1721187011,1721187096,finished,1721187032,1721187096,A100-SXM4-80GB,8,1,64,896,21,64
370c10d3-9a89-4780-b5ba-a431621d45bb,geogpt-sft-swift-MATH-yxs,1721187048,1721278900,finished,1721190134,1721278900,A100-SXM4-80GB,8,1,64,896,3086,88766
535cb34f-5733-4ca4-b56b-a70e5a6133e7,tax,1721187157,1721187240,finished,1721187177,1721187240,A100-SXM4-80GB,8,1,64,896,20,63
412af9ce-7477-4513-85ac-de16b563ef12,geogpt-sft-swift-MathQA-yxs,1721187213,1721210162,finished,1721192978,1721210162,A100-SXM4-80GB,8,1,64,896,5765,17184
53320a08-4fd0-441a-b838-86c2816c70ed,tax,1721187303,1721187384,finished,1721187323,1721187384,A100-SXM4-80GB,8,1,64,896,20,61
95a570f0-b982-46d9-aad9-e27b827d08fe,tax,1721187447,1721187530,finished,1721187467,1721187530,A100-SXM4-80GB,8,1,64,896,20,63
48cfc4f6-0fe3-41e3-888e-9d48b54376cc,tax,1721187594,1721187675,finished,1721187613,1721187675,A100-SXM4-80GB,8,1,64,896,19,62
1cd63534-2fb7-415f-a00a-fd307741a5be,geogpt-eval-abductive,1721187629,1721188121,finished,1721187650,1721188121,A100-SXM4-80GB,8,1,64,896,21,471
2cf184ac-ebf0-401b-97d5-8e10f95070b7,tax,1721187736,1721187817,finished,1721187757,1721187817,A100-SXM4-80GB,8,1,64,896,21,60
a40f97c3-432c-4c6f-8cb0-da28455413c5,tax,1721187879,1721187959,finished,1721187900,1721187959,A100-SXM4-80GB,8,1,64,896,21,59
c56aa1d3-376f-4142-8e58-6c08136e99ec,tax,1721188022,1721188105,finished,1721188043,1721188105,A100-SXM4-80GB,8,1,64,896,21,62
74f79448-5281-4532-9845-a438c7824ba0,tax,1721188166,1721188247,finished,1721188187,1721188247,A100-SXM4-80GB,8,1,64,896,21,60
c713a0aa-3691-41a7-ac0d-548604c6cb37,tax,1721188308,1721188392,finished,1721188329,1721188392,A100-SXM4-80GB,8,1,64,896,21,63
46903d2d-7701-4718-93be-db94bc56a757,geogpt-eval-abductive,1721188387,1721188702,finished,1721188408,1721188702,A100-SXM4-80GB,8,1,64,896,21,294
f88b0059-361a-4b8a-919e-1d46918e74dd,tax,1721188453,1721188537,finished,1721188474,1721188537,A100-SXM4-80GB,8,1,64,896,21,63
51daa7a1-224c-439b-88a8-d39e97b1c54a,geogpt-dairui-model-merge-exp-1,1721188506,1721198825,finished,1721193104,1721198825,A100-SXM4-80GB,8,1,64,896,4598,5721
6b5a1414-152f-422b-91ef-ec23d76bb91f,tax,1721188601,1721188685,finished,1721188622,1721188685,A100-SXM4-80GB,8,1,64,896,21,63
99287d5b-afbb-4c9f-bd0d-4ce611b820b0,tax,1721188750,1721188836,finished,1721188772,1721188836,A100-SXM4-80GB,8,1,64,896,22,64
6613bcb4-6d12-4836-b1a6-93da328ae488,geogpt-eval-abductive,1721188787,1721189138,finished,1721188809,1721189138,A100-SXM4-80GB,8,1,64,896,22,329
cfb37625-44e8-44e4-82a7-e716262fa684,tax,1721188903,1721188995,finished,1721188927,1721188995,A100-SXM4-80GB,8,1,64,896,24,68
69359c19-a9c1-43a0-abdc-13d2b483c193,sp-q72b-dp-0701-dp-ties-w55-9366e-auto,1721188918,1721214479,finished,1721198239,1721214479,A100-SXM4-80GB,8,1,64,448,9321,16240
76ce4556-ba9e-41c0-88df-4acf0f260527,sp-q72b-dp-0701-dp-linear-w55-d758e-auto,1721188920,1721215221,finished,1721199732,1721215221,A100-SXM4-80GB,8,1,64,448,10812,15489
19df2d0f-12f5-4913-9708-10c24ece7d5a,sp-q72b-dp-0701-dp-linear-w55-8e332-auto,1721188963,1721192953,finished,1721190131,1721192953,A100-SXM4-80GB,8,1,64,448,1168,2822
7742e88f-4b17-4d4a-a54e-4e521eba720e,sp-q72b-dp-0701-dp-ties-w55-7c44e-auto,1721188964,1721205692,finished,1721202658,1721205692,A100-SXM4-80GB,8,1,64,448,13694,3034
0f14302f-67cc-4639-841f-e5afd507c294,llama3-70b-lp84-sft1-8m-1-9ep-3115d-auto,1721188988,1721206664,finished,1721189220,1721206664,A100-SXM4-80GB,8,1,64,448,232,17444
e2ce1adc-f4fd-4a8c-8b48-68e7089459f3,llama3-70b-lp84-sft1-8m-1-9ep-0e96f-auto,1721189053,1721205907,finished,1721202661,1721205907,A100-SXM4-80GB,8,1,64,448,13608,3246
afc1b150-dbe9-4aa2-b3b8-e779255c978d,tax,1721189059,1721189143,finished,1721189080,1721189143,A100-SXM4-80GB,8,1,64,896,21,63
0b57f3cb-cf2c-437e-85fb-7188d988a17d,geo-sae-train,1721189133,1721190833,finished,1721189154,1721190833,A100-SXM4-80GB,8,1,64,896,21,1679
6fbf591b-2c68-425f-9628-6c630936f910,tax,1721189205,1721189288,finished,1721189226,1721189288,A100-SXM4-80GB,8,1,64,896,21,62
0f19f587-5ca1-46f8-b365-11bce2b849fa,tax,1721189352,1721189438,finished,1721189374,1721189438,A100-SXM4-80GB,8,1,64,896,22,64
a9d3b34c-b03e-4e65-a2b6-02b748d8517e,geogpt-eval-abductive,1721189390,1721189926,finished,1721189411,1721189926,A100-SXM4-80GB,8,1,64,896,21,515
686c8dbb-bc4a-45ed-82e5-d30baa3d7012,tax,1721189500,1721189580,finished,1721189520,1721189580,A100-SXM4-80GB,8,1,64,896,20,60
3ff59439-5622-42ce-bd3e-06fcbb1d44f1,tax,1721189643,1721189723,finished,1721189663,1721189723,A100-SXM4-80GB,8,1,64,896,20,60
43d50407-51d0-4acd-bdba-c058b63cee9f,tax,1721189786,1721189867,finished,1721189807,1721189867,A100-SXM4-80GB,8,1,64,896,21,60
2e3dd7e4-eda9-440a-8aec-9d517c84d5e9,tax,1721189930,1721190013,finished,1721189950,1721190013,A100-SXM4-80GB,8,1,64,896,20,63
31594187-852c-4aad-bfec-45a9b4833bca,geogpt-eval-abductive,1721189988,1721190322,finished,1721190008,1721190322,A100-SXM4-80GB,8,1,64,896,20,314
ba6afd0b-15d2-4648-becd-8ef2be614d3e,tax,1721190077,1721190159,finished,1721190098,1721190159,A100-SXM4-80GB,8,1,64,896,21,61
4bb34226-d2f4-4077-b187-8aa518e69280,tax,1721190221,1721190306,finished,1721190242,1721190306,A100-SXM4-80GB,8,1,64,896,21,64
0f8890b0-0b67-4609-9076-27dd4c6813c6,tax,1721190369,1721190451,finished,1721190390,1721190451,A100-SXM4-80GB,8,1,64,896,21,61
b9e5fe41-9996-4340-9bc3-a621f558dc11,tax,1721190515,1721190597,finished,1721190534,1721190597,A100-SXM4-80GB,8,1,64,896,19,63
f60eef5e-22cf-40e7-b6b5-b1f5c275e75b,geogpt-eval-abductive,1721190592,1721190717,finished,1721190613,1721190717,A100-SXM4-80GB,8,1,64,896,21,104
4ddd29d1-8bfa-41dd-a6a8-d28ad4522f0d,tax,1721190660,1721190741,finished,1721190681,1721190741,A100-SXM4-80GB,8,1,64,896,21,60
85ba1a27-a246-4707-bdc5-7ad5006dd3fc,tax,1721190802,1721190883,finished,1721190823,1721190883,A100-SXM4-80GB,8,1,64,896,21,60
5fd9f685-a3cc-4cc8-92e4-3d44fe72a386,tax,1721190945,1721191027,finished,1721190966,1721191027,A100-SXM4-80GB,8,1,64,896,21,61
8d51e63b-cef3-49ac-9d8e-74ecc8520358,tax,1721191089,1721191172,finished,1721191110,1721191172,A100-SXM4-80GB,8,1,64,896,21,62
05590622-a829-44ad-a611-0d54c7995d47,tax,1721191234,1721191315,finished,1721191255,1721191315,A100-SXM4-80GB,8,1,64,896,21,60
2efbb957-d526-4dcd-a645-b7ed1822692f,tax,1721191379,1721191463,finished,1721191400,1721191463,A100-SXM4-80GB,8,1,64,896,21,63
589fe717-f75b-475c-bb02-63b46ba58c84,tax,1721191525,1721191607,finished,1721191545,1721191607,A100-SXM4-80GB,8,1,64,896,20,62
20133de2-9c90-4c65-aff6-42664941631d,tax,1721191669,1721191751,finished,1721191688,1721191751,A100-SXM4-80GB,8,1,64,896,19,63
c34c925e-e13c-4004-959d-c11912482e2c,vllm-qwen2,1721191759,1721265622,finished,1721191781,1721265622,A100-SXM4-80GB,8,1,64,896,22,73841
66774b13-2806-4f99-b32c-5e5d1a3defad,tax,1721191815,1721191897,finished,1721191836,1721191897,A100-SXM4-80GB,8,1,64,896,21,61
4c70c4bb-d2b0-4863-9ec3-26c22d6a81c0,tax,1721191959,1721192042,finished,1721191980,1721192042,A100-SXM4-80GB,8,1,64,896,21,62
2350dc2c-e0a1-419e-9399-095c7314c18e,tax,1721192105,1721192188,finished,1721192125,1721192188,A100-SXM4-80GB,8,1,64,896,20,63
bfd2e4f4-e735-4d25-b6d3-a77c120d2556,tax,1721192249,1721192332,finished,1721192270,1721192332,A100-SXM4-80GB,8,1,64,896,21,62
1f3bd2f1-a52e-42ac-bfb0-8555d495401f,geo-sae-train,1721192281,1721193724,finished,1721192301,1721193724,A100-SXM4-80GB,8,1,64,896,20,1423
660452e0-aff8-416b-b9ac-8478efe78097,tax,1721192394,1721192476,finished,1721192413,1721192476,A100-SXM4-80GB,8,1,64,896,19,63
1c703b29-0d43-4879-be70-e4c8ffa94a46,tax,1721192540,1721192622,finished,1721192561,1721192622,A100-SXM4-80GB,8,1,64,896,21,61
11d735b9-b82e-4ab6-924f-f26d4b0ec53e,eval-llama2-7b-chat-human,1721192589,1721194346,finished,1721192610,1721194346,A100-SXM4-80GB,8,1,64,448,21,1736
0d71a86a-a6d6-47c4-b5e8-99196a2f8a10,tax,1721192686,1721192766,finished,1721192706,1721192766,A100-SXM4-80GB,8,1,64,896,20,60
a8c14857-f670-43c6-8bf1-bd6d3ec678b3,tax,1721192831,1721192920,finished,1721192852,1721192920,A100-SXM4-80GB,8,1,64,896,21,68
62242fb9-e254-4587-a14f-12c7078f31d5,citysora-512-cele-ppm-from-5k512,1721192885,1721201802,finished,1721192995,1721201802,A100-SXM4-80GB,8,4,64,896,110,8807
cc2356ff-23c7-4a0a-a143-a21b434f217d,GeoGPT-0701-v1-f14fd-auto,1721192916,1721217436,finished,1721202665,1721217436,A100-SXM4-80GB,8,1,64,896,9749,14771
7915ffd9-85d8-4376-b5e5-3eca366d5b58,tax,1721192984,1721193343,finished,1721193005,1721193343,A100-SXM4-80GB,8,1,64,896,21,338
984d4ff9-3c6d-4cc1-a110-4e4d76b935a3,llama3-instruct-70b,1721193169,1721376167,finished,1721202658,1721376167,A100-SXM4-80GB,4,1,32,448,9489,173509
a7b802f3-9f2c-4d04-a734-70632f406182,citysora-modelv4-cele-ppm-65-256-fp,1721193189,1721196067,finished,1721193250,1721196067,A100-SXM4-80GB,8,4,64,896,61,2817
9ea2bf9f-baed-4781-97fc-a9df7cb18933,tax,1721193406,1721193488,finished,1721193426,1721193488,A100-SXM4-80GB,8,1,64,896,20,62
31c2c260-056d-4a95-9c97-4a9e84876b6c,eval-llama2-7b-chat-triviaqa,1721193456,1721195876,finished,1721193476,1721195876,A100-SXM4-80GB,8,1,64,448,20,2400
c0f7ec02-7a43-4401-9237-544716b8060a,tax,1721193551,1721193631,finished,1721193571,1721193631,A100-SXM4-80GB,8,1,64,896,20,60
0f2c5807-ea90-48db-acc4-2d8cce20dc16,tax,1721193693,1721193775,finished,1721193713,1721193775,A100-SXM4-80GB,8,1,64,896,20,62
82c67150-39a4-4f1b-9a7d-8203c9e08ed6,tax,1721193837,1721193922,finished,1721193859,1721193922,A100-SXM4-80GB,8,1,64,896,22,63
18133b12-b5f0-4b54-b090-87a98ff2a77b,tax,1721193986,1721194068,finished,1721194007,1721194068,A100-SXM4-80GB,8,1,64,896,21,61
742b37de-2e2e-47ea-a3fb-f176bea59992,tax,1721194130,1721194212,finished,1721194151,1721194212,A100-SXM4-80GB,8,1,64,896,21,61
38decce7-0cc5-48a7-bfee-8eb03600e096,tax,1721194275,1721194337,finished,1721194294,1721194337,A100-SXM4-80GB,8,1,64,896,19,43
0a057098-c034-487d-bc2e-868814cb1be2,geo-sae-train,1721194408,1721195836,finished,1721194430,1721195836,A100-SXM4-80GB,8,1,64,896,22,1406
9f7a3ded-4eca-4cf6-8738-7278c744c35f,geogpt-sft-1m-of-3-9m-all-llama3-8b,1721194476,1721198427,finished,1721194810,1721198427,A100-SXM4-80GB,8,4,64,448,334,3617
2244d7c0-1df0-4e1a-b22e-31b0c1de78ff,lf-sft-32k-2nodes,1721194511,1721197043,finished,1721194576,1721197043,A100-SXM4-80GB,8,2,64,448,65,2467
e6b66cb8-c9e7-4cb1-8fee-6608a8059aa3,geogpt-sft-swift-gsm8k-yxs,1721194563,1721206644,finished,1721202662,1721206644,A100-SXM4-80GB,8,1,64,896,8099,3982
059bae29-e04b-4bb1-8ee5-8669e3c220a7,geogpt-sft-swift-aqua-yxs,1721194627,1721199033,finished,1721198243,1721199033,A100-SXM4-80GB,8,1,64,896,3616,790
db329c1f-6a66-48c0-93cc-7438fef9d729,geogpt-sft-swift-svamp-yxs,1721194711,1721202991,finished,1721202662,1721202991,A100-SXM4-80GB,8,1,64,896,7951,329
fc013803-3ab7-4f68-87e3-ffc7bc16b9d0,geogpt-sft-swift-multiarith-yxs,1721194752,1721202969,finished,1721202662,1721202969,A100-SXM4-80GB,8,1,64,896,7910,307
dce43b26-6cc4-436f-a9f9-3e542e10153d,geo-72B-zero3,1721195359,1721400030,finished,1721197817,1721400030,A100-SXM4-80GB,8,8,64,896,2458,202213
506eae28-8407-4ed0-aff6-9e020efd6274,geogpt-eval-abductive,1721195406,1721196092,finished,1721195573,1721196092,A100-SXM4-80GB,8,1,64,896,167,519
5262d72d-18a9-4635-af87-6214b4a3e233,lf-llamafyqwem-pt-test,1721195810,1721196040,finished,1721195874,1721196040,A100-SXM4-80GB,8,2,64,448,64,166
3e4084c9-219d-4875-83a4-30661f23d646,citysora-modelv4-cele-ppm-65-256-fp,1721196067,1721197299,finished,1721196108,1721197299,A100-SXM4-80GB,8,4,64,896,41,1191
87e5ff85-c5b9-41c7-b1cc-6e14fb097e72,geogpt-eval-abductive,1721196156,1721196507,finished,1721196177,1721196507,A100-SXM4-80GB,8,1,64,896,21,330
700fd58f-4f6e-4209-9d5c-0f2ba039aee4,train-0717B,1721196166,1721213312,finished,1721196187,1721213312,A100-SXM4-80GB,8,1,64,896,21,17125
f5880d0e-b191-4e4f-b911-0d610f0045df,lf-llamafyqwem-pt-test,1721196230,1721203517,finished,1721203369,1721203517,A100-SXM4-80GB,8,2,64,448,7139,148
d4d93e39-3fc0-4b10-ab26-d1fc60c359de,geogpt-ultrafuser-direct-eval,1721196564,1721265768,finished,1721202658,1721265768,A100-SXM4-80GB,8,1,64,448,6094,63110
86f1e79f-ee5e-4160-bc08-839c4f809e24,geogpt-eval-abductive,1721196674,1721199590,finished,1721196694,1721199590,A100-SXM4-80GB,8,1,64,896,20,2896
4e02c5c4-6b29-40cb-be46-2319eaa45d5c,soraGPU1,1721196729,1721200795,finished,1721196750,1721200795,A100-SXM4-80GB,4,1,32,448,21,4045
712ae16d-76a9-4850-8164-6b1a9c9998d9,geogpt-cot-eval-cp-r1,1721196758,1721199716,finished,1721199055,1721199716,A100-SXM4-80GB,8,1,64,896,2297,661
b7aa7c8a-de02-402d-991b-153e15b4573f,geo-sae-train,1721196836,1721198300,finished,1721196858,1721198300,A100-SXM4-80GB,8,1,64,896,22,1442
ba7ad21a-571c-4a79-a891-c009f47b33ad,moe-sft,1721196913,1721197334,finished,1721196935,1721197334,A100-SXM4-80GB,8,1,64,896,22,399
b7d4bc31-7ed9-488c-b379-d83b0b67bde4,eval-llama2-7b-chat-triviaqa-mkl-threading-layer-1,1721197086,1721199395,finished,1721197106,1721199395,A100-SXM4-80GB,8,1,64,448,20,2289
7488f3d6-0063-4abb-a764-1eb1e42ef917,citysora-modelv4-cele-ppm-65-256-fp,1721197299,1721198555,finished,1721197362,1721198555,A100-SXM4-80GB,8,4,64,896,63,1193
30afbf7b-794b-4fca-972a-e1b886a0e98c,eval-llama2-7b-chat-math-gsm,1721197359,1721232127,finished,1721197381,1721232127,A100-SXM4-80GB,8,1,64,448,22,34746
0cc97287-87ff-4534-a3eb-03e23a8d20e8,sfr-ft,1721197563,1721200181,finished,1721197585,1721200181,A100-SXM4-80GB,8,1,64,896,22,2596
6f28afb1-9bd8-40be-8a8a-f63684915850,eval-llama2-7b-chat-human-mkl-threading-layer,1721197669,1721198487,finished,1721197690,1721198487,A100-SXM4-80GB,8,1,64,448,21,797
360967df-637e-4d95-8c14-6fc35c906ab6,d,1721197943,1721198486,finished,1721198009,1721198486,A100-SXM4-80GB,8,2,64,896,66,477
db812e57-059a-4b5b-85fa-4b8b83d78d55,lf-sft-32k-2nodes,1721197988,1721207882,finished,1721202697,1721207882,A100-SXM4-80GB,8,2,64,448,4709,5185
2df52719-2f30-49c2-9b40-b64eab8d9e4f,eval-llama2-7b-chat-mmlu,1721198194,1721212556,finished,1721198214,1721212556,A100-SXM4-80GB,8,1,64,448,20,14342
a4a28bf7-5fde-4e10-bb07-ffe2bbee2b78,sfr-embedding-test,1721198233,1721206717,finished,1721202674,1721206717,A100-SXM4-80GB,8,2,64,448,4441,4043
d8309ae0-55cd-4024-ad67-3a6a840d26e5,geo-mod-05b-test,1721198280,1721199711,finished,1721198844,1721199711,A100-SXM4-80GB,8,1,64,448,564,867
d2c417b7-3ca6-495b-982e-c1bd9382155e,qwen2-72b-lp84-s2gate2b-fe3ff-auto,1721198326,1721262910,finished,1721202661,1721262910,A100-SXM4-80GB,8,1,64,448,4335,60249
3d9b793f-4eb8-4f81-a1aa-102166751b50,moe-sft,1721198377,1721198837,finished,1721198399,1721198837,A100-SXM4-80GB,8,1,64,896,22,438
3924fb48-8fff-48a4-93aa-49b87bf0d553,geogpt-sft-1m-of-3-9m-all-llama3-8b,1721198427,1721203266,finished,1721199649,1721203266,A100-SXM4-80GB,8,4,64,448,1222,3617
3ec480cc-b23b-4ee8-87f6-e652629a9578,d,1721198486,1721199108,finished,1721198550,1721199108,A100-SXM4-80GB,8,2,64,896,64,558
a6c3720d-10a8-4c33-b495-5275410bd076,citysora-debug-losses,1721198511,1721220779,finished,1721198533,1721220779,A100-SXM4-80GB,8,1,64,896,22,22246
2c1a3438-f5d9-4d26-8be1-f2c75c6220e0,qwen-72b-test,1721198702,1721199111,finished,1721198723,1721199111,A100-SXM4-80GB,8,1,64,448,21,388
2f990dad-0f22-4dd1-bf87-1f86af295155,rag-reranker-online,1721199046,1721635980,finished,1721199067,1721635980,A100-SXM4-40GB,1,1,8,32,21,436913
4f231d3a-9bc3-47cc-a37d-8194671e40ec,VAE,1721199084,1721199515,finished,1721199104,1721199515,A100-SXM4-80GB,8,1,64,896,20,411
5912f6a7-bca6-4331-abc7-8fb75fb70d1d,qwen-72b-test,1721199153,1721199689,finished,1721199174,1721199689,A100-SXM4-80GB,8,1,64,448,21,515
86d07dcd-9860-4211-800f-577f1d115006,ds,1721199518,1721202719,finished,1721199580,1721202719,A100-SXM4-80GB,8,2,64,896,62,3139
1242dd83-67c7-4244-ba35-b0ee5da4749a,VAE,1721199577,1721200158,finished,1721199598,1721200158,A100-SXM4-80GB,8,1,64,896,21,560
d7611ef9-bf27-4acb-86cc-25d047d0c2d5,qwen-72b-test,1721199751,1721202786,finished,1721199771,1721202786,A100-SXM4-80GB,8,1,64,448,20,3015
e7ec2ae5-b371-4d27-b180-55f11fd4e111,geogpt-cot-eval-cp-r1,1721199798,1721202858,finished,1721202661,1721202858,A100-SXM4-80GB,8,1,64,896,2863,197
9672b537-9f26-4a44-8292-992196e7e18a,geogpt-eval-abductive,1721199842,1721202640,finished,1721199863,1721202640,A100-SXM4-80GB,8,1,64,896,21,2777
36200fab-6905-4745-ab75-c3a9dc79f589,geo-mod-05b-test,1721200103,1721203458,finished,1721200124,1721203458,A100-SXM4-80GB,8,1,64,448,21,3334
8faaa7aa-b5ad-4c35-a2fb-ca404a0d2589,moe-sft,1721200179,1721200601,finished,1721200201,1721200601,A100-SXM4-80GB,8,1,64,896,22,400
4aa75596-0373-4a6e-b6dc-5f13c7dde0a4,sfr-ft,1721200181,1721205301,finished,1721200203,1721205301,A100-SXM4-80GB,8,1,64,896,22,5098
c79b4a2f-1352-48f3-93a7-1b0f6f5660e5,VAE,1721200199,1721200516,finished,1721200222,1721200516,A100-SXM4-80GB,8,1,64,896,23,294
2158f875-31f1-40cc-8952-8f6e9ef7b62f,geogpt-doc-extract,1721200248,1721284926,finished,1721200268,1721284926,A100-SXM4-40GB,1,1,8,96,20,84658
72256bec-fe4f-49e1-8739-3224d846bc09,Llama2-7b-chat-32k-7b96e-auto,1721200407,1721213218,finished,1721200594,1721213218,A100-SXM4-80GB,8,1,64,896,187,12624
d61af23e-a7f8-41ca-affe-58b37007ff06,anrenxunlian,1721200512,1721200745,finished,1721200532,1721200745,A100-SXM4-80GB,8,1,64,896,20,213
df0ed162-d261-4478-aeb6-601c91a330ac,Meta-llama3-8b-instruct-6583e-auto,1721200594,1721205974,finished,1721203487,1721205974,A100-SXM4-80GB,8,1,64,896,2893,2487
bb99e5de-89c0-4414-8f65-92b8c802e7fb,eval-llama2-7b-chat-human-pip,1721200626,1721201419,finished,1721200649,1721201419,A100-SXM4-80GB,8,1,64,448,23,770
6e74e652-0dea-4a19-a56c-ccc08b6a275f,geo-sae-train,1721200651,1721202352,finished,1721200673,1721202352,A100-SXM4-80GB,8,1,64,896,22,1679
e4996fb4-9aa9-4f67-9fac-d45b33ae5d44,soraGPU1,1721200795,1721201589,finished,1721200816,1721201589,A100-SXM4-80GB,4,1,32,448,21,773
1804670e-ea77-4fce-a59d-6a4d318a12b3,geogpt-lxz-2-9m-mix-data-3ep-llama3-8b,1721200925,1721202636,finished,1721202120,1721202636,A100-SXM4-80GB,8,16,64,448,1195,516
ecf9a938-6abd-422c-9c16-f9bc94e4dd2b,llama-actsave,1721201483,1721201884,finished,1721201505,1721201884,A100-SXM4-80GB,8,1,64,448,22,379
b2dd9203-597e-49f6-a5fd-b04fd4ea1db2,debug,1721201526,1721213609,finished,1721202720,1721213609,A100-SXM4-80GB,8,2,64,896,1194,10889
d781dc36-8d94-4540-a96f-125b2d872e87,moe-sft,1721201543,1721201648,finished,1721201563,1721201648,A100-SXM4-80GB,8,1,64,896,20,85
50269718-d28e-4566-9b67-cdf821036586,citysora-512-cele-ppm-from-5k512,1721201802,1721202918,finished,1721201845,1721202918,A100-SXM4-80GB,8,4,64,896,43,1073
38ef1a51-b993-40c1-9faa-53422eefa63f,moe-sft,1721201922,1721202027,finished,1721201943,1721202027,A100-SXM4-80GB,8,1,64,896,21,84
d58edafb-6431-4a12-8a0b-986a8b86e682,llama-actsave,1721202163,1721202395,finished,1721202184,1721202395,A100-SXM4-80GB,8,1,64,448,21,211
120c9a85-28e5-4f26-815c-4dff0b43ff6d,VAE,1721202343,1721202606,finished,1721202365,1721202606,A100-SXM4-80GB,4,1,32,448,22,241
3439950a-8c6a-4fc1-91cd-5841c97543d4,geogpt-qwen15-moe-alpaca-sft,1721202366,1721225443,finished,1721202391,1721225443,A100-SXM4-80GB,8,1,64,448,25,23052
8bddfafa-6b03-4744-a918-9a9d887e12d2,geogpt-qwen15-moe-alpaca-sft,1721202368,1721202453,finished,1721202391,1721202453,A100-SXM4-80GB,8,1,64,448,23,62
d7de3d3f-54bb-41f8-96b4-efde25ee1a92,llama-actsave,1721202501,1721202851,finished,1721202522,1721202851,A100-SXM4-80GB,8,1,64,448,21,329
a2fe2280-5a7d-4fc7-94ef-d53f5a99925c,geogpt-lxz-2-9m-mix-data-3ep-llama3-8b,1721202636,1721231935,finished,1721227151,1721231935,A100-SXM4-80GB,8,16,64,448,24515,4784
7bb7acc6-2688-4947-a767-098ee0338c0f,geogpt-cot-eval-cp-r1,1721202858,1721214609,finished,1721202882,1721214609,A100-SXM4-80GB,8,1,64,896,24,11727
91e72c35-6a5d-4aa7-b7ae-d6cc30b81ad5,citysora-512-cele-ppm-from-5k512,1721202918,1721203194,finished,1721202985,1721203194,A100-SXM4-80GB,8,4,64,896,67,209
c52f23b6-e1be-4293-919c-d60c2ab75ae7,qwen-72b-test,1721202938,1721203585,finished,1721202963,1721203585,A100-SXM4-80GB,8,1,64,448,25,622
32afd446-ca7b-43d1-9392-cbf590070111,geogpt-eval-abductive,1721202991,1721203313,finished,1721203012,1721203313,A100-SXM4-80GB,8,1,64,896,21,301
94587541-054f-4144-939e-80fd60476064,citysora-512-cele-ppm-from-5k512,1721203264,1721268645,finished,1721203329,1721268645,A100-SXM4-80GB,8,4,64,896,65,65316
33bfaa22-85a9-4f42-bb7c-793b382af79a,geogpt-sft-1m-of-3-9m-all-llama3-8b,1721203266,1721204035,finished,1721203673,1721204035,A100-SXM4-80GB,8,4,64,448,407,362
6ec61aa2-0c2a-4bc8-9325-a7c63fd318aa,geogpt-btx-2x14b-sf4,1721203333,1721225578,finished,1721213653,1721225578,A100-SXM4-80GB,8,8,64,448,10320,11925
07be93d7-ac01-486d-8411-ad432b6fc559,moe-sft-on-nas,1721203557,1721204016,finished,1721203579,1721204016,A100-SXM4-80GB,8,1,64,896,22,437
3a18e074-aa01-46a1-a6b8-409b48ecfd3c,geogpt-eval-abductive,1721203570,1721203893,finished,1721203591,1721203893,A100-SXM4-80GB,8,1,64,896,21,302
956be315-3238-4f72-b5aa-7902702957fb,eval-llama2-7b-chat-human-uncomment,1721203668,1721204503,finished,1721203690,1721204503,A100-SXM4-80GB,8,1,64,448,22,813
572081b5-0155-4b6d-b0f6-72f326da1b1a,ds,1721203839,1721204544,finished,1721203905,1721204544,A100-SXM4-80GB,8,2,64,896,66,639
4caf6d0c-701a-4bbd-8d47-bb8a08882714,train-7b,1721203895,1721207544,finished,1721203917,1721207544,A100-SXM4-80GB,4,1,32,448,22,3627
f3f91696-bc74-458b-9827-191665490469,dss,1721203970,1721204706,finished,1721204611,1721204706,A100-SXM4-80GB,8,2,64,896,641,95
30b421ab-6948-4d0f-ac91-6f65958a6887,geo-mod-05b-test,1721203975,1721208571,finished,1721206118,1721208571,A100-SXM4-80GB,8,1,64,448,2143,2453
6d8c0074-df00-4212-b899-f4062353ee83,geogpt-prompt-tuning-tg-infer2,1721203987,1721207137,finished,1721204064,1721207137,A100-SXM4-80GB,8,1,64,448,77,3073
f4168ead-89ea-41b6-ba64-24b18dc05164,VAE,1721203994,1721204811,finished,1721204016,1721204811,A100-SXM4-80GB,8,1,64,896,22,795
30012e42-1212-4790-9819-a4880946f6ac,soraGPU1,1721204021,1721211548,finished,1721204052,1721211548,A100-SXM4-80GB,4,1,32,448,31,7496
eb454321-cd90-4088-9b9f-8f9806ae0520,geogpt-sft-1m-of-3-9m-all-llama3-8b,1721204035,1721207738,finished,1721204079,1721207738,A100-SXM4-80GB,8,4,64,448,44,3659
4bdedfec-4741-4562-a99d-ed0f7b4f3f65,VAEsdv3,1721204281,1721204519,finished,1721204304,1721204519,A100-SXM4-80GB,4,1,32,448,23,215
987ec72b-9f98-46fc-902d-c94eea0b625c,geogpt-dairui-model-merge-exp-1,1721204312,1721223201,finished,1721212873,1721223201,A100-SXM4-80GB,8,1,64,896,8561,10328
28f3461f-db62-421c-a311-1134a14479ef,txchen-train-task,1721204321,1721206104,finished,1721205996,1721206104,A100-SXM4-80GB,8,1,64,896,1675,108
65a71747-9dfc-4372-a31c-70977f01f19f,m8x7b-10bcpt-1ep-w01-ebf58-auto,1721204400,1721206409,finished,1721204422,1721206409,A100-SXM4-80GB,8,1,64,448,22,1987
b9ec66a4-9689-4dce-9fa7-ee88debc5b58,geogpt-sft-1-8m-2nd-math-llama3-8b,1721204570,1721227405,finished,1721226595,1721227405,A100-SXM4-80GB,8,8,64,448,22025,810
c5252776-3e80-492f-9d97-c36175b4590d,m8x7b-10bcpt-1ep-w01-0bf82-auto,1721204574,1721229786,finished,1721204596,1721229786,A100-SXM4-80GB,8,1,64,448,22,25190
9afa6882-6a72-43ee-98db-b1059f4f5670,geogpt-eval-common-latest,1721204641,1721281847,finished,1721205714,1721281847,A100-SXM4-80GB,8,1,64,896,1073,76133
331fe88f-7518-42bd-98bd-a5773b301e32,geogpt-sft-1-8m-2nd-code-llama3-8b,1721204642,1721227360,finished,1721210574,1721227360,A100-SXM4-80GB,8,8,64,448,5932,16786
2bf5caf4-a0b8-47e9-9ad0-5f010069357a,anrenxunlian,1721204653,1721266225,finished,1721204677,1721266225,A100-SXM4-80GB,8,1,64,896,24,61548
227f337a-71f0-4c27-a9a6-1c02a7788685,geogpt-prompt-tuning-tg-infer3,1721204674,1721210958,finished,1721204697,1721210958,A100-SXM4-80GB,8,1,64,448,23,6261
462c35d6-16f8-429d-81f2-3a11ba841e60,dss,1721204706,1721204948,finished,1721204749,1721204948,A100-SXM4-80GB,8,2,64,896,43,199
58610429-911b-4cd0-8b7e-9bf9775fe5d3,geo-mod-72b-test,1721204885,1721208725,finished,1721208593,1721208725,A100-SXM4-80GB,8,1,64,896,3708,132
e870ded0-a343-42aa-95a3-14674675cfc1,VAE,1721204966,1721205640,finished,1721204989,1721205640,A100-SXM4-80GB,8,1,64,896,23,651
2a3430d3-d81e-4df9-9861-ef6f95043f5a,moe-sft,1721204990,1721205405,finished,1721205011,1721205405,A100-SXM4-80GB,8,1,64,896,21,394
0fa6d890-9e21-4fc8-9703-a3133d91f1ae,dss,1721205079,1721207277,finished,1721205124,1721207277,A100-SXM4-80GB,8,2,64,896,45,2153
1ef65db2-2b52-415b-a1ce-1ed32807d002,geogpt-eval-abductive,1721205135,1721205653,finished,1721205181,1721205653,A100-SXM4-80GB,8,1,64,896,46,472
7cc27d2a-e956-4c3b-9d17-8ec208046bf4,panda,1721205152,1721208527,finished,1721205175,1721208527,A100-SXM4-80GB,8,1,64,896,23,3352
386a3874-0876-4d5b-8630-651cc7cfa58f,sfr-ft,1721205301,1721207636,finished,1721205685,1721207636,A100-SXM4-80GB,8,1,64,896,384,1951
75be2632-de6f-4470-b823-cf7cb34df792,VAE,1721205811,1721206152,finished,1721205833,1721206152,A100-SXM4-80GB,8,1,64,896,22,319
79394b39-0461-4964-babb-d3b0f95bc4bd,geogpt-eval-abductive,1721205971,1721206454,finished,1721205993,1721206454,A100-SXM4-80GB,8,1,64,896,22,461
97988c81-63d0-487b-ac45-2a04da3de05a,citysora-512-cele-ppm-from-5k512-lr2em6,1721206051,1721268021,finished,1721208938,1721268021,A100-SXM4-80GB,8,4,64,896,2887,59083
3d7d2d95-1fc9-4241-82cb-6fe830b1239c,geogpt-eval-abductive,1721206519,1721206855,finished,1721206541,1721206855,A100-SXM4-80GB,8,1,64,896,22,314
869f1dee-53e1-41cd-9b08-beafdfd2a4fb,llama-factory-zj-test,1721206552,1721206996,finished,1721206573,1721206996,A100-SXM4-80GB,8,1,64,896,21,423
d84a5461-57ac-42fe-9ae4-70d3d32685d1,sfr-embedding-test,1721206717,1721821562,finished,1721206739,1721821562,A100-SXM4-80GB,8,1,64,448,22,614823
90ea6d54-a4f3-4ac2-a908-0ad1abc361fa,llama-factory-zj-test,1721206996,1721207488,finished,1721207018,1721207488,A100-SXM4-80GB,8,1,64,896,22,470
3b701440-c0a4-41b8-9de5-f7d20087b37e,geogpt-eval-abductive,1721207134,1721207455,finished,1721207156,1721207455,A100-SXM4-80GB,8,1,64,896,22,299
d6703d21-4ab8-4841-a37c-270ea3ba69ef,q72b-0612-dpo-delta-wanda5-b9f26-auto,1721207176,1721209509,finished,1721207197,1721209509,A100-SXM4-80GB,8,1,64,448,21,2312
bfec1ac5-c4fd-4668-8037-aad43617c011,hmr-sft-test,1721207230,1721207360,finished,1721207253,1721207360,A100-SXM4-80GB,8,1,64,448,23,107
372fad06-3de8-4468-9bfb-105c653d7752,lf-llamafyqwem-pt-test,1721207301,1721207488,finished,1721207363,1721207488,A100-SXM4-80GB,8,2,64,448,62,125
35677794-c3b4-4289-9755-9d7c6b924bc8,hmr-sft-test,1721207401,1721207506,finished,1721207423,1721207506,A100-SXM4-80GB,8,1,64,448,22,83
5bb8c541-ab7d-4244-a8a3-31ece228b797,sfr-ft,1721207636,1721208741,finished,1721207660,1721208741,A100-SXM4-80GB,8,1,64,896,24,1081
5f88a1ba-cd64-44fe-8b22-5ac652341dc9,txchen-train-task,1721207675,1721229792,finished,1721208756,1721229792,A100-SXM4-80GB,8,1,64,896,1081,21036
7b159e1f-0e97-4b38-a103-72c0d562c6da,hmr-sft-test,1721207681,1721207817,finished,1721207707,1721207817,A100-SXM4-80GB,8,1,64,448,26,110
327979a9-4f2e-41e0-aa51-ee25101f9d57,geogpt-sft-1m-of-3-9m-all-llama3-8b,1721207738,1721229162,finished,1721207802,1721229162,A100-SXM4-80GB,8,4,64,448,64,21360
dfcd1810-0b67-4d38-8c21-647fd44b996c,lf-llamafyqwem-pt-test,1721207755,1721211360,finished,1721207820,1721211360,A100-SXM4-80GB,8,2,64,448,65,3540
395d0500-eac4-4112-b528-5097370ef016,llama-factory-zj-test,1721207946,1721209420,finished,1721207988,1721209420,A100-SXM4-80GB,8,2,64,896,42,1432
25b13aa6-7872-47fb-864d-927226d1be2c,VAEsdv3,1721208262,1721208563,finished,1721208283,1721208563,A100-SXM4-80GB,8,1,64,896,21,280
f7de0945-562c-42b3-8a2c-0b5eaba8a602,geogpt-mixtral-test,1721208271,1721227842,finished,1721227664,1721227842,A100-SXM4-80GB,8,16,64,448,19393,178
bfd95258-6bf8-4522-80bb-8f49f78d318e,mixtral-8x22b-sft,1721208294,1721233839,finished,1721232217,1721233839,A100-SXM4-80GB,8,48,64,448,23923,1622
3ee38eed-a427-487c-8fa0-2a9ecfd361c7,fd,1721208435,1721209294,finished,1721208479,1721209294,A100-SXM4-80GB,8,2,64,896,44,815
ed3fd311-9327-44ea-ad00-bddd25de9d7c,panda,1721208504,1721208894,finished,1721208527,1721208894,A100-SXM4-80GB,8,1,64,896,23,367
a713d79e-c044-4c3a-ba04-e1da322b94fc,sfr-ft,1721208742,1721211152,finished,1721208764,1721211152,A100-SXM4-80GB,8,1,64,896,22,2388
76899d94-785c-4ad0-ac81-0fcf71de7a49,panda,1721208915,1721213189,finished,1721211551,1721213189,A100-SXM4-80GB,8,1,64,896,2636,1638
f8905343-a547-46e4-a109-96312f979a60,geogpt-sft-swift-aqua-yxs,1721209701,1721210473,finished,1721209722,1721210473,A100-SXM4-80GB,8,1,64,896,21,751
cad10e81-2208-4c9c-9c6f-fa97a229c541,VAEsdv3,1721209793,1721291574,finished,1721213224,1721291574,A100-SXM4-80GB,8,1,64,896,3431,78350
de840029-334a-4e9e-96c7-d06db4b2bc92,VAEopt,1721209876,1721295000,finished,1721220815,1721295000,A100-SXM4-80GB,8,1,64,896,10939,74185
33b7cb8e-74a0-4331-9a1f-8578be43cf55,VAEtest,1721210022,1721210170,finished,1721210043,1721210170,A100-SXM4-80GB,4,1,32,448,21,127
0b45d695-3b59-4489-834a-d8bd10a3ff4f,txchen-train-task2,1721210391,1721213391,finished,1721212882,1721213391,A100-SXM4-80GB,8,1,64,448,2491,509
4ebcd69d-5d75-425e-a6d4-84616f9d3945,linux-env,1721211319,1721821032,finished,1721211339,1721821032,A100-SXM4-80GB,8,1,64,448,20,609693
bfd47412-5c37-4e08-8377-7e6345bb51be,geogpt-moe-0b5-tag-1-norm-detach-attn-lr-1e-6,1721212663,1721213551,finished,1721213426,1721213551,A100-SXM4-80GB,8,2,64,896,763,125
51b75614-3db0-4951-a3cf-48398f11f4c9,geogpt-moe-1b5-tag-1-norm-detach-attn-lr-1e-6,1721212665,1721213064,finished,1721212896,1721213064,A100-SXM4-80GB,8,2,64,896,231,168
6f027577-4600-43c1-8d98-a91e37d63d57,geogpt-moe-0b5-tag-1-norm-detach-attn-lr-1e-7,1721212708,1721213231,finished,1721213126,1721213231,A100-SXM4-80GB,8,2,64,896,418,105
be1d5078-1dca-4b46-b597-7fa5a68790bc,geogpt-moe-1b5-tag-1-norm-detach-attn-lr-1e-7,1721212729,1721213404,finished,1721213296,1721213404,A100-SXM4-80GB,8,2,64,896,567,108
ccbe54be-adc1-466d-85bd-9162ddf6ffa7,txchen-train-task2,1721213391,1721214755,finished,1721213435,1721214755,A100-SXM4-80GB,8,1,64,448,44,1320
0089c42d-d74b-4ca5-bce3-255ce4cd8303,geogpt-moe-0b5-tag-1-norm-detach-attn-lr-1e-6,1721213721,1721213936,finished,1721213768,1721213936,A100-SXM4-80GB,8,2,64,896,47,168
06e41c01-8698-40c2-acb3-baecc5d45d53,geogpt-moe-0b5-tag-1-norm-detach-attn-lr-1e-7,1721213721,1721214166,finished,1721213978,1721214166,A100-SXM4-80GB,8,2,64,896,257,188
223fb72c-3ecf-47fa-8e58-4b13234fd4b4,geogpt-moe-1b5-tag-1-norm-detach-attn-lr-1e-7,1721213746,1721214417,finished,1721214249,1721214417,A100-SXM4-80GB,8,2,64,896,503,168
e567f771-5848-4e25-baaa-d477cb9c5d58,geogpt-moe-1b5-tag-1-norm-detach-attn-lr-1e-6,1721213768,1721214644,finished,1721214458,1721214644,A100-SXM4-80GB,8,2,64,896,690,186
66a95654-2414-4c5a-82cd-dbb1e7f1c555,train-0715B,1721214159,1721215633,finished,1721214181,1721215633,A100-SXM4-80GB,8,1,64,896,22,1452
346caf2e-fec4-4189-8235-1cd943ed9684,txchen-train-task2,1721215229,1721215730,finished,1721215249,1721215730,A100-SXM4-80GB,8,1,64,448,20,481
f3f86ccd-ca62-499c-b50c-2c9c373fffb2,llamafactory-qwen2-dp-sp,1721215362,1721226785,finished,1721226613,1721226785,A100-SXM4-80GB,8,4,64,896,11251,172
54aa7dc5-080c-4e8a-af96-bb3b3d44814f,train-0715B,1721215633,1721217423,finished,1721215653,1721217423,A100-SXM4-80GB,8,1,64,896,20,1770
2e715a8d-bae2-41ac-9b5a-bc42fc49b52f,txchen-train-task2,1721215730,1721216285,finished,1721215792,1721216285,A100-SXM4-80GB,8,2,64,448,62,493
aa6ac265-30b3-4e10-8ee6-0d9ad3de448e,geogpt-dairui-eval-code-3,1721215829,1721217032,finished,1721216342,1721217032,A100-SXM4-80GB,8,4,64,896,513,690
b491cf54-1b06-4391-baca-22cd3a40af0a,txchen-train-task2,1721216286,1721217416,finished,1721217101,1721217416,A100-SXM4-80GB,8,2,64,448,815,315
091c0908-6c94-44b6-9207-97256c78a5a1,qwen2-72b-instruct-d69a1-auto,1721216303,1721257864,finished,1721216325,1721257864,A100-SXM4-80GB,8,1,64,448,22,41539
6ef7eead-4b5c-48b2-915e-1012bf5ab808,sp-5-dp-geogpt-0701-cpt-f10ce-auto,1721216366,1721218625,finished,1721216391,1721218625,A100-SXM4-80GB,8,1,64,448,25,2234
39847111-3be4-4c64-93bd-55f6f1ea3496,sp-9-dp-geogpt-0701-cpt-cb7cb-auto,1721216367,1721218626,finished,1721216391,1721218626,A100-SXM4-80GB,8,1,64,448,24,2235
8614e337-8e37-4941-8ba7-4a634c27cefd,sp-3-dp-geogpt-0701-cpt-e54fd-auto,1721216369,1721219583,finished,1721217239,1721219583,A100-SXM4-80GB,8,1,64,448,870,2344
bc28ac3d-d632-492d-a350-a49d39852a34,sp-8-dp-geogpt-0701-cpt-99e3c-auto,1721216391,1721220925,finished,1721218647,1721220925,A100-SXM4-80GB,8,1,64,448,2256,2278
8b7067df-e35f-4108-a6f7-edb0fcae45ec,q72b-0612-dpo-delta-wanda5-93040-auto,1721216556,1721228487,finished,1721217452,1721228487,A100-SXM4-80GB,8,1,64,448,896,11035
14764601-8b01-457f-836f-53e43a012e41,geo-mod-05b-test,1721216681,1721217882,finished,1721217053,1721217882,A100-SXM4-80GB,8,1,64,448,372,829
f78418d1-d1b5-4a8a-9a50-8ccb4eddcef6,geogpt-dairui-eval-code-3,1721217323,1721218209,finished,1721217924,1721218209,A100-SXM4-80GB,8,4,64,896,601,285
24241995-3b1b-4e4c-91f0-b6e26af76950,train-0715B,1721217423,1721218953,finished,1721217444,1721218953,A100-SXM4-80GB,8,1,64,896,21,1509
e5490370-79cc-4f1b-8430-df464a89c434,geogpt-sft-swift-aqua-yxs,1721218547,1721269625,finished,1721218651,1721269625,A100-SXM4-80GB,8,1,64,896,104,50974
ed68a8ed-8e42-48ea-8e8c-d8037309bb93,txchen-train-task2,1721218840,1721219278,finished,1721218903,1721219278,A100-SXM4-80GB,8,2,64,448,63,375
4b43c05c-6636-4e2c-9c7a-5397284eedea,train-0715B,1721218953,1721282468,finished,1721218974,1721282468,A100-SXM4-80GB,8,1,64,896,21,63494
5e485a16-c727-4df3-82cc-2ccba8fae881,geogpt-dairui-eval-code-3,1721219081,1721279171,finished,1721219333,1721279171,A100-SXM4-80GB,8,4,64,896,252,59838
b2d46fc5-a3ab-4877-a2a9-33061fe0ab86,geogpt-lp40-s3-sft40w,1721219226,1721259033,finished,1721219607,1721259033,A100-SXM4-80GB,8,1,64,448,381,39426
c251f37d-1b9b-4fa3-a2d7-997a10faa1c6,geogpt-sft-swift-commonsense-yxs,1721220259,1721234746,finished,1721225603,1721234746,A100-SXM4-80GB,8,1,64,896,5344,9143
a70f4c35-f5fc-4aef-8612-d17277e2cb7b,geogpt-sft-swift-commonsenseqa-yxs,1721220392,1721226795,finished,1721225603,1721226795,A100-SXM4-80GB,8,1,64,896,5211,1192
fb1b7def-e978-4ff3-8113-5ba8a2c21fff,geogpt-sft-swift-worldtree-yxs,1721220438,1721226956,finished,1721225992,1721226956,A100-SXM4-80GB,8,1,64,896,5554,964
0cacafd7-c38e-4631-8316-0388caf16999,sp-q72b-dp-0612cpt-dp-ties-w55-b82e7-auto,1721220540,1721228925,finished,1721221934,1721228925,A100-SXM4-80GB,8,1,64,448,1394,6991
5c8f7a1a-1cfe-4550-8e78-6274d2654ad6,sp-q72b-dp-0612cpt-dp-line-w55-c7dfc-auto,1721220563,1721228990,finished,1721225599,1721228990,A100-SXM4-80GB,8,1,64,448,5036,3391
da2603ea-b924-4fde-b8f3-9cde507f5d92,sp-q72b-dp-0612cpt-dp-ties-w55-66cbc-auto,1721220564,1721229874,finished,1721225599,1721229874,A100-SXM4-80GB,8,1,64,448,5035,4275
a4bfa901-5db0-464f-b065-0db0737ba7ed,sp-q72b-dp-0612cpt-dp-line-w55-50d14-auto,1721220587,1721228732,finished,1721225599,1721228732,A100-SXM4-80GB,8,1,64,448,5012,3133
087e442d-1a94-44c3-b91c-d6711c00caf7,geogpt-sft-swift-cose-yxs,1721220632,1721221918,finished,1721220949,1721221918,A100-SXM4-80GB,8,1,64,896,317,969
7e991c15-59b2-4b7b-98aa-e02d43c72299,geogpt-sft-swift-openbookqa-yxs,1721220655,1721226306,finished,1721225603,1721226306,A100-SXM4-80GB,8,1,64,896,4948,703
acf61f33-bce2-43f3-9c2f-dc94497db74b,geogpt-sft-swift-strategyqa-yxs,1721220696,1721225972,finished,1721225603,1721225972,A100-SXM4-80GB,8,1,64,896,4907,369
d6422b21-7654-43b3-9e87-148ded2f380d,geogpt-sft-swift-socialiqa-yxs,1721220741,1721229579,finished,1721225603,1721229579,A100-SXM4-80GB,8,1,64,896,4862,3976
174b8d58-bd51-4979-bad9-13e10b1c596f,txchen-train-task2,1721220787,1721223656,finished,1721223230,1721223656,A100-SXM4-80GB,8,1,64,448,2443,426
49e5cb69-a48c-4617-8d70-bb844827ac21,zjllm-sci-llama-3-7b,1721221017,1721380520,finished,1721221037,1721380520,A100-SXM4-80GB,8,1,64,448,20,159483
1be18fe8-5239-4328-af35-0f5f2fcaf1ce,geo-mod-72b-test,1721223670,1721293539,finished,1721223692,1721293539,A100-SXM4-80GB,8,1,64,896,22,69847
0b759cb2-a977-4fea-b9be-abdfbc170089,citysora-modelv4-cele-ppm-65-512-from256-fuxian,1721224058,1721227061,finished,1721224185,1721227061,A100-SXM4-80GB,8,4,64,896,127,2876
92e47671-b459-4d13-bff7-9770f9fcf6a5,geogpt-btx-2x14b-sf4,1721225644,1721226858,finished,1721226592,1721226858,A100-SXM4-80GB,8,8,64,448,948,266
74248c17-b802-49b9-8b61-ee416a444c93,geogpt-btx-2x14b-sf4,1721226930,1721227228,finished,1721226994,1721227228,A100-SXM4-80GB,8,8,64,448,64,234
c675c1be-a03a-4a85-bf10-d626cc2b8dfe,citysora-modelv4plus-121-256,1721227018,1721268121,finished,1721227128,1721268121,A100-SXM4-80GB,8,4,64,896,110,40993
cb8395d2-902b-4af1-936d-2d8f1b19539b,geogpt-btx-2x14b-sf4,1721227292,1721227598,finished,1721227334,1721227598,A100-SXM4-80GB,8,8,64,448,42,264
180fae0d-e4c8-4f3b-aecb-2d3853b28c51,geogpt-btx-2x14b-sf4,1721227664,1721227975,finished,1721227734,1721227975,A100-SXM4-80GB,8,8,64,448,70,241
0da3a849-21d3-41c2-b696-e94763094ede,geogpt-mixtral-test,1721227910,1721228153,finished,1721227975,1721228153,A100-SXM4-80GB,8,16,64,448,65,178
34b17748-9f31-426e-a770-4d42f83f67ee,geogpt-btx-2x14b-sf4,1721228066,1721228399,finished,1721228130,1721228399,A100-SXM4-80GB,8,8,64,448,64,269
34178a92-432e-4e07-9f42-991744ed6a6d,geogpt-mixtral-test,1721228221,1721228464,finished,1721228287,1721228464,A100-SXM4-80GB,8,16,64,448,66,177
e92826c8-94ae-4214-9888-58825ceb94db,geogpt-btx-2x14b-sf4,1721228464,1721228731,finished,1721228508,1721228731,A100-SXM4-80GB,8,8,64,448,44,223
f4ef6a97-748b-428a-b710-5089fefe8726,geogpt-mixtral-test,1721228538,1721228752,finished,1721228580,1721228752,A100-SXM4-80GB,8,16,64,448,42,172
6d7d3188-18bd-432e-9fde-eebf24e99211,geogpt-btx-2x14b-sf4,1721228799,1721229113,finished,1721228871,1721229113,A100-SXM4-80GB,8,8,64,448,72,242
367c5d10-313a-4d3a-a7ea-385c329db5e1,geogpt-mixtral-test,1721228825,1721229072,finished,1721228874,1721229072,A100-SXM4-80GB,8,16,64,448,49,198
1c564c2d-ce49-43ad-8fe8-4e3a47517c6e,geogpt-mixtral-test,1721229162,1721229417,finished,1721229247,1721229417,A100-SXM4-80GB,8,16,64,448,85,170
d9276e5e-1282-4acf-b332-82987542e057,geogpt-btx-2x14b-sf4,1721229183,1721229438,finished,1721229224,1721229438,A100-SXM4-80GB,8,8,64,448,41,214
8ddfe20b-40ff-4f12-9ede-574e8b23b6a1,geogpt-mixtral-test,1721229483,1721229721,finished,1721229548,1721229721,A100-SXM4-80GB,8,16,64,448,65,173
35339eca-248a-4ab3-9c00-75299b9b7174,geogpt-btx-2x14b-sf4,1721229527,1721229848,finished,1721229596,1721229848,A100-SXM4-80GB,8,8,64,448,69,252
b4d09351-1768-415c-8b2a-ba461a1194c1,geogpt-mixtral-test,1721229786,1721230022,finished,1721229848,1721230022,A100-SXM4-80GB,8,16,64,448,62,174
bd329b53-e2fd-4d4e-a3f4-8659548ac8dc,geogpt-btx-2x14b-sf4,1721229916,1721230168,finished,1721229958,1721230168,A100-SXM4-80GB,8,8,64,448,42,210
5569c1d1-e7f9-40fc-bd1b-61f88a140815,geogpt-mixtral-test,1721230106,1721230342,finished,1721230168,1721230342,A100-SXM4-80GB,8,16,64,448,62,174
f1ddeabf-826f-4a28-8004-409656b5dd6d,geogpt-btx-2x14b-sf4,1721230238,1721230551,finished,1721230298,1721230551,A100-SXM4-80GB,8,8,64,448,60,253
2966a1f2-d126-422f-aecc-fa75b3668717,geogpt-mixtral-test,1721230405,1721230633,finished,1721230465,1721230633,A100-SXM4-80GB,8,16,64,448,60,168
1d549dd0-d5ab-4e61-91c4-09801bc1c01b,geogpt-btx-2x14b-sf4,1721230613,1721230868,finished,1721230654,1721230868,A100-SXM4-80GB,8,8,64,448,41,214
752ddac8-84a5-4759-8278-a86a051a46bc,geogpt-mixtral-test,1721230700,1721230912,finished,1721230741,1721230912,A100-SXM4-80GB,8,16,64,448,41,171
6022d142-7398-48b9-b3b2-0e0aba647d4f,geogpt-btx-2x14b-sf4,1721230933,1721231229,finished,1721230997,1721231229,A100-SXM4-80GB,8,8,64,448,64,232
35b505ae-c126-4441-9227-c9e11f3ee588,geogpt-mixtral-test,1721230977,1721231229,finished,1721231041,1721231229,A100-SXM4-80GB,8,16,64,448,64,188
39c81b1b-65c1-4590-898f-c5b063004edd,geogpt-mixtral-test,1721231297,1721231550,finished,1721231359,1721231550,A100-SXM4-80GB,8,16,64,448,62,191
dac243fb-4b0a-485d-accf-248653e55188,geogpt-btx-2x14b-sf4,1721231317,1721231572,finished,1721231358,1721231572,A100-SXM4-80GB,8,8,64,448,41,214
2ac8486b-6370-443d-ac7b-d5298030c9f5,geogpt-mixtral-test,1721231620,1721231849,finished,1721231660,1721231849,A100-SXM4-80GB,8,16,64,448,40,189
b5ae3f0d-0046-41ec-9c07-77287bb16a74,geogpt-btx-2x14b-sf4,1721231640,1721231956,finished,1721231707,1721231956,A100-SXM4-80GB,8,8,64,448,67,249
8774ecaf-0eda-4916-89af-0b24bb54487d,geogpt-mixtral-test,1721231935,1721232152,finished,1721231976,1721232152,A100-SXM4-80GB,8,16,64,448,41,176
